sex,edad,ynac,year,qobs_2010_15,qx,ex
1,115,1885,2000,1.0000000,1.0000000,0.50
1,114,1886,2000,0.7923424,0.7988253,0.70
1,115,1886,2001,1.0000000,1.0000000,0.50
1,113,1887,2000,0.7481851,0.7558190,0.79
1,114,1887,2001,0.7923424,0.7981499,0.70
1,115,1887,2002,1.0000000,1.0000000,0.50
1,112,1888,2000,0.7050519,0.7137521,0.87
1,113,1888,2001,0.7481851,0.7550231,0.79
1,114,1888,2002,0.7923424,0.7975293,0.70
1,115,1888,2003,1.0000000,1.0000000,0.50
1,111,1889,2000,0.6630882,0.6727605,0.95
1,112,1889,2001,0.7050519,0.7128444,0.87
1,113,1889,2002,0.7481851,0.7542920,0.80
1,114,1889,2003,0.7923424,0.7970403,0.70
1,115,1889,2004,1.0000000,1.0000000,0.50
1,110,1890,2000,0.6224217,0.6329647,1.03
1,111,1890,2001,0.6630882,0.6717507,0.95
1,112,1890,2002,0.7050519,0.7120108,0.87
1,113,1890,2003,0.7481851,0.7537161,0.80
1,114,1890,2004,0.7923424,0.7966742,0.70
1,115,1890,2005,1.0000000,1.0000000,0.50
1,109,1891,2000,0.5831612,0.5944685,1.12
1,110,1891,2001,0.6224217,0.6318631,1.03
1,111,1891,2002,0.6630882,0.6708234,0.95
1,112,1891,2003,0.7050519,0.7113542,0.87
1,113,1891,2004,0.7481851,0.7532848,0.80
1,114,1891,2005,0.7923424,0.7963262,0.70
1,115,1891,2006,1.0000000,1.0000000,0.50
1,108,1892,2000,0.5453968,0.5573590,1.22
1,109,1892,2001,0.5831612,0.5932859,1.12
1,110,1892,2002,0.6224217,0.6308516,1.04
1,111,1892,2003,0.6630882,0.6700931,0.95
1,112,1892,2004,0.7050519,0.7108625,0.88
1,113,1892,2005,0.7481851,0.7528750,0.80
1,114,1892,2006,0.7923424,0.7959700,0.70
1,115,1892,2007,1.0000000,1.0000000,0.50
1,107,1893,2000,0.5091990,0.5217062,1.32
1,108,1893,2001,0.5453968,0.5561067,1.22
1,109,1893,2002,0.5831612,0.5922003,1.13
1,110,1893,2003,0.6224217,0.6300551,1.04
1,111,1893,2004,0.6630882,0.6695463,0.95
1,112,1893,2005,0.7050519,0.7103953,0.88
1,113,1893,2006,0.7481851,0.7524554,0.80
1,114,1893,2007,0.7923424,0.7956198,0.70
1,115,1893,2008,1.0000000,1.0000000,0.50
1,106,1894,2000,0.4746198,0.4875633,1.44
1,107,1894,2001,0.5091990,0.5203955,1.33
1,108,1894,2002,0.5453968,0.5549573,1.23
1,109,1894,2003,0.5831612,0.5913457,1.13
1,110,1894,2004,0.6224217,0.6294589,1.04
1,111,1894,2005,0.6630882,0.6690268,0.96
1,112,1894,2006,0.7050519,0.7099171,0.88
1,113,1894,2007,0.7481851,0.7520431,0.80
1,114,1894,2008,0.7923424,0.7952150,0.70
1,115,1894,2009,1.0000000,1.0000000,0.50
1,105,1895,2000,0.4416930,0.4549671,1.56
1,106,1895,2001,0.4746198,0.4862052,1.44
1,107,1895,2002,0.5091990,0.5191927,1.33
1,108,1895,2003,0.5453968,0.5540527,1.23
1,109,1895,2004,0.5831612,0.5907060,1.13
1,110,1895,2005,0.6224217,0.6288924,1.04
1,111,1895,2006,0.6630882,0.6684951,0.96
1,112,1895,2007,0.7050519,0.7094473,0.88
1,113,1895,2008,0.7481851,0.7515664,0.80
1,114,1895,2009,0.7923424,0.7946735,0.71
1,115,1895,2010,1.0000000,1.0000000,0.50
1,104,1896,2000,0.4104359,0.4239393,1.69
1,105,1896,2001,0.4416930,0.4535728,1.56
1,106,1896,2002,0.4746198,0.4849595,1.44
1,107,1896,2003,0.5091990,0.5182462,1.33
1,108,1896,2004,0.5453968,0.5533755,1.23
1,109,1896,2005,0.5831612,0.5900983,1.13
1,110,1896,2006,0.6224217,0.6283127,1.04
1,111,1896,2007,0.6630882,0.6679726,0.96
1,112,1896,2008,0.7050519,0.7089040,0.88
1,113,1896,2009,0.7481851,0.7509289,0.80
1,114,1896,2010,0.7923424,0.7940362,0.71
1,115,1896,2011,1.0000000,1.0000000,0.50
1,103,1897,2000,0.3808502,0.3944873,1.83
1,104,1897,2001,0.4104359,0.4225191,1.69
1,105,1897,2002,0.4416930,0.4522940,1.57
1,106,1897,2003,0.4746198,0.4839793,1.45
1,107,1897,2004,0.5091990,0.5175380,1.33
1,108,1897,2005,0.5453968,0.5527325,1.23
1,109,1897,2006,0.5831612,0.5894765,1.13
1,110,1897,2007,0.6224217,0.6277432,1.04
1,111,1897,2008,0.6630882,0.6673687,0.96
1,112,1897,2009,0.7050519,0.7081774,0.88
1,113,1897,2010,0.7481851,0.7501787,0.80
1,114,1897,2011,0.7923424,0.7933839,0.71
1,115,1897,2012,1.0000000,1.0000000,0.50
1,102,1898,2000,0.3529236,0.3666054,1.98
1,103,1898,2001,0.3808502,0.3930512,1.83
1,104,1898,2002,0.4104359,0.4212170,1.70
1,105,1898,2003,0.4416930,0.4512881,1.57
1,106,1898,2004,0.4746198,0.4832460,1.45
1,107,1898,2005,0.5091990,0.5168654,1.34
1,108,1898,2006,0.5453968,0.5520745,1.23
1,109,1898,2007,0.5831612,0.5888656,1.14
1,110,1898,2008,0.6224217,0.6270849,1.04
1,111,1898,2009,0.6630882,0.6665611,0.96
1,112,1898,2010,0.7050519,0.7073227,0.88
1,113,1898,2011,0.7481851,0.7494108,0.80
1,114,1898,2012,0.7923424,0.7927698,0.71
1,115,1898,2013,1.0000000,1.0000000,0.50
1,101,1899,2000,0.3266317,0.3402766,2.14
1,102,1899,2001,0.3529236,0.3651627,1.98
1,103,1899,2002,0.3808502,0.3917349,1.84
1,104,1899,2003,0.4104359,0.4201930,1.70
1,105,1899,2004,0.4416930,0.4505356,1.57
1,106,1899,2005,0.4746198,0.4825496,1.45
1,107,1899,2006,0.5091990,0.5161773,1.34
1,108,1899,2007,0.5453968,0.5514283,1.23
1,109,1899,2008,0.5831612,0.5881597,1.14
1,110,1899,2009,0.6224217,0.6262049,1.05
1,111,1899,2010,0.6630882,0.6656111,0.96
1,112,1899,2011,0.7050519,0.7064480,0.88
1,113,1899,2012,0.7481851,0.7486880,0.80
1,114,1899,2013,0.7923424,0.7922019,0.71
1,115,1899,2014,1.0000000,1.0000000,0.50
1,100,1900,2000,0.3019394,0.3154733,2.31
1,101,1900,2001,0.3266317,0.3388358,2.15
1,102,1900,2002,0.3529236,0.3638407,1.99
1,103,1900,2003,0.3808502,0.3907000,1.84
1,104,1900,2004,0.4104359,0.4194271,1.70
1,105,1900,2005,0.4416930,0.4498213,1.58
1,106,1900,2006,0.4746198,0.4818374,1.45
1,107,1900,2007,0.5091990,0.5155016,1.34
1,108,1900,2008,0.5453968,0.5506814,1.24
1,109,1900,2009,0.5831612,0.5872160,1.14
1,110,1900,2010,0.6224217,0.6251698,1.05
1,111,1900,2011,0.6630882,0.6646392,0.96
1,112,1900,2012,0.7050519,0.7056247,0.88
1,113,1900,2013,0.7481851,0.7480198,0.80
1,114,1900,2014,0.7923424,0.7916214,0.71
1,115,1900,2015,1.0000000,1.0000000,0.50
1,99,1901,2000,0.2788028,0.2921599,2.50
1,100,1901,2001,0.3019394,0.3140423,2.32
1,101,1901,2002,0.3266317,0.3375160,2.15
1,102,1901,2003,0.3529236,0.3628016,2.00
1,103,1901,2004,0.3808502,0.3899260,1.85
1,104,1901,2005,0.4104359,0.4187001,1.71
1,105,1901,2006,0.4416930,0.4490906,1.58
1,106,1901,2007,0.4746198,0.4811380,1.46
1,107,1901,2008,0.5091990,0.5147207,1.34
1,108,1901,2009,0.5453968,0.5496833,1.24
1,109,1901,2010,0.5831612,0.5861062,1.14
1,110,1901,2011,0.6224217,0.6241109,1.05
1,111,1901,2012,0.6630882,0.6637245,0.97
1,112,1901,2013,0.7050519,0.7048635,0.89
1,113,1901,2014,0.7481851,0.7473367,0.81
1,114,1901,2015,0.7923424,0.7909899,0.71
1,115,1901,2016,1.0000000,1.0000000,0.50
1,98,1902,2000,0.2571705,0.2702928,2.69
1,99,1902,2001,0.2788028,0.2907455,2.51
1,100,1902,2002,0.3019394,0.3127318,2.33
1,101,1902,2003,0.3266317,0.3364788,2.16
1,102,1902,2004,0.3529236,0.3620247,2.00
1,103,1902,2005,0.3808502,0.3891915,1.85
1,104,1902,2006,0.4104359,0.4179567,1.71
1,105,1902,2007,0.4416930,0.4483733,1.58
1,106,1902,2008,0.4746198,0.4803300,1.46
1,107,1902,2009,0.5091990,0.5136774,1.35
1,108,1902,2010,0.5453968,0.5485098,1.24
1,109,1902,2011,0.5831612,0.5849713,1.14
1,110,1902,2012,0.6224217,0.6231146,1.05
1,111,1902,2013,0.6630882,0.6628790,0.97
1,112,1902,2014,0.7050519,0.7040858,0.89
1,113,1902,2015,0.7481851,0.7465936,0.81
1,114,1902,2016,0.7923424,0.7903434,0.71
1,115,1902,2017,1.0000000,1.0000000,0.50
1,97,1903,2000,0.2369856,0.2498229,2.90
1,98,1903,2001,0.2571705,0.2689013,2.70
1,99,1903,2002,0.2788028,0.2894508,2.51
1,100,1903,2003,0.3019394,0.3117023,2.33
1,101,1903,2004,0.3266317,0.3357036,2.16
1,102,1903,2005,0.3529236,0.3612875,2.00
1,103,1903,2006,0.3808502,0.3884406,1.85
1,104,1903,2007,0.4104359,0.4172270,1.72
1,105,1903,2008,0.4416930,0.4475448,1.58
1,106,1903,2009,0.4746198,0.4792506,1.46
1,107,1903,2010,0.5091990,0.5124510,1.35
1,108,1903,2011,0.5453968,0.5473099,1.25
1,109,1903,2012,0.5831612,0.5839037,1.15
1,110,1903,2013,0.6224217,0.6221939,1.06
1,111,1903,2014,0.6630882,0.6620152,0.97
1,112,1903,2015,0.7050519,0.7032398,0.89
1,113,1903,2016,0.7481851,0.7458331,0.81
1,114,1903,2017,0.7923424,0.7897348,0.71
1,115,1903,2018,1.0000000,1.0000000,0.50
1,96,1904,2000,0.2181866,0.2306966,3.13
1,97,1904,2001,0.2369856,0.2484598,2.91
1,98,1904,2002,0.2571705,0.2676279,2.71
1,99,1904,2003,0.2788028,0.2884338,2.52
1,100,1904,2004,0.3019394,0.3109329,2.34
1,101,1904,2005,0.3266317,0.3349681,2.17
1,102,1904,2006,0.3529236,0.3605339,2.01
1,103,1904,2007,0.3808502,0.3877036,1.86
1,104,1904,2008,0.4104359,0.4163841,1.72
1,105,1904,2009,0.4416930,0.4464380,1.59
1,106,1904,2010,0.4746198,0.4779820,1.47
1,107,1904,2011,0.5091990,0.5111973,1.35
1,108,1904,2012,0.5453968,0.5461814,1.25
1,109,1904,2013,0.5831612,0.5829172,1.15
1,110,1904,2014,0.6224217,0.6212533,1.06
1,111,1904,2015,0.6630882,0.6610757,0.97
1,112,1904,2016,0.7050519,0.7023740,0.89
1,113,1904,2017,0.7481851,0.7451172,0.81
1,114,1904,2018,0.7923424,0.7891716,0.71
1,115,1904,2019,1.0000000,1.0000000,0.50
1,95,1905,2000,0.2007091,0.2128565,3.36
1,96,1905,2001,0.2181866,0.2293663,3.14
1,97,1905,2002,0.2369856,0.2472126,2.92
1,98,1905,2003,0.2571705,0.2666280,2.72
1,99,1905,2004,0.2788028,0.2876740,2.53
1,100,1905,2005,0.3019394,0.3102030,2.34
1,101,1905,2006,0.3266317,0.3342163,2.17
1,102,1905,2007,0.3529236,0.3597943,2.01
1,103,1905,2008,0.3808502,0.3868524,1.86
1,104,1905,2009,0.4104359,0.4152586,1.72
1,105,1905,2010,0.4416930,0.4451377,1.59
1,106,1905,2011,0.4746198,0.4766855,1.47
1,107,1905,2012,0.5091990,0.5100184,1.36
1,108,1905,2013,0.5453968,0.5451389,1.25
1,109,1905,2014,0.5831612,0.5819096,1.15
1,110,1905,2015,0.6224217,0.6202305,1.06
1,111,1905,2016,0.6630882,0.6601145,0.97
1,112,1905,2017,0.7050519,0.7015592,0.89
1,113,1905,2018,0.7481851,0.7444549,0.81
1,114,1905,2019,0.7923424,0.7885956,0.71
1,115,1905,2020,1.0000000,1.0000000,0.50
1,94,1906,2000,0.1844867,0.1962429,3.62
1,95,1906,2001,0.2007091,0.2115628,3.38
1,96,1906,2002,0.2181866,0.2281495,3.15
1,97,1906,2003,0.2369856,0.2462336,2.93
1,98,1906,2004,0.2571705,0.2658812,2.73
1,99,1906,2005,0.2788028,0.2869534,2.53
1,100,1906,2006,0.3019394,0.3094571,2.35
1,101,1906,2007,0.3266317,0.3334787,2.18
1,102,1906,2008,0.3529236,0.3589405,2.02
1,103,1906,2009,0.3808502,0.3857161,1.87
1,104,1906,2010,0.4104359,0.4139365,1.73
1,105,1906,2011,0.4416930,0.4438091,1.60
1,106,1906,2012,0.4746198,0.4754667,1.48
1,107,1906,2013,0.5091990,0.5089297,1.36
1,108,1906,2014,0.5453968,0.5440743,1.25
1,109,1906,2015,0.5831612,0.5808142,1.15
1,110,1906,2016,0.6224217,0.6191843,1.06
1,111,1906,2017,0.6630882,0.6592098,0.97
1,112,1906,2018,0.7050519,0.7008055,0.89
1,113,1906,2019,0.7481851,0.7437775,0.81
1,114,1906,2020,0.7923424,0.7879687,0.71
1,115,1906,2021,1.0000000,1.0000000,0.50
1,93,1907,2000,0.1694519,0.1807949,3.88
1,94,1907,2001,0.1844867,0.1949891,3.63
1,95,1907,2002,0.2007091,0.2103800,3.39
1,96,1907,2003,0.2181866,0.2271947,3.16
1,97,1907,2004,0.2369856,0.2455025,2.94
1,98,1907,2005,0.2571705,0.2651728,2.73
1,99,1907,2006,0.2788028,0.2862171,2.54
1,100,1907,2007,0.3019394,0.3087255,2.36
1,101,1907,2008,0.3266317,0.3326272,2.19
1,102,1907,2009,0.3529236,0.3578008,2.03
1,103,1907,2010,0.3808502,0.3843817,1.88
1,104,1907,2011,0.4104359,0.4125861,1.74
1,105,1907,2012,0.4416930,0.4425606,1.60
1,106,1907,2013,0.4746198,0.4743415,1.48
1,107,1907,2014,0.5091990,0.5078181,1.36
1,108,1907,2015,0.5453968,0.5429172,1.26
1,109,1907,2016,0.5831612,0.5796940,1.16
1,110,1907,2017,0.6224217,0.6181998,1.06
1,111,1907,2018,0.6630882,0.6583733,0.98
1,112,1907,2019,0.7050519,0.7000346,0.89
1,113,1907,2020,0.7481851,0.7430404,0.81
1,114,1907,2021,0.7923424,0.7873271,0.71
1,115,1907,2022,1.0000000,1.0000000,0.50
1,92,1908,2000,0.1555375,0.1664507,4.17
1,93,1908,2001,0.1694519,0.1795833,3.90
1,94,1908,2002,0.1844867,0.1938431,3.64
1,95,1908,2003,0.2007091,0.2094521,3.40
1,96,1908,2004,0.2181866,0.2264818,3.17
1,97,1908,2005,0.2369856,0.2448092,2.95
1,98,1908,2006,0.2571705,0.2644493,2.74
1,99,1908,2007,0.2788028,0.2854949,2.55
1,100,1908,2008,0.3019394,0.3078810,2.36
1,101,1908,2009,0.3266317,0.3314909,2.19
1,102,1908,2010,0.3529236,0.3564627,2.03
1,103,1908,2011,0.3808502,0.3830190,1.88
1,104,1908,2012,0.4104359,0.4113173,1.74
1,105,1908,2013,0.4416930,0.4414080,1.61
1,106,1908,2014,0.4746198,0.4731927,1.48
1,107,1908,2015,0.5091990,0.5066103,1.37
1,108,1908,2016,0.5453968,0.5417341,1.26
1,109,1908,2017,0.5831612,0.5786400,1.16
1,110,1908,2018,0.6224217,0.6172896,1.07
1,111,1908,2019,0.6630882,0.6575179,0.98
1,112,1908,2020,0.7050519,0.6991960,0.89
1,113,1908,2021,0.7481851,0.7422860,0.81
1,114,1908,2022,0.7923424,0.7867225,0.71
1,115,1908,2023,1.0000000,1.0000000,0.50
1,91,1909,2000,0.1426766,0.1531487,4.47
1,92,1909,2001,0.1555375,0.1652833,4.18
1,93,1909,2002,0.1694519,0.1784764,3.91
1,94,1909,2003,0.1844867,0.1929442,3.65
1,95,1909,2004,0.2007091,0.2087594,3.41
1,96,1909,2005,0.2181866,0.2258059,3.18
1,97,1909,2006,0.2369856,0.2441012,2.96
1,98,1909,2007,0.2571705,0.2637397,2.75
1,99,1909,2008,0.2788028,0.2846615,2.56
1,100,1909,2009,0.3019394,0.3067543,2.37
1,101,1909,2010,0.3266317,0.3301573,2.20
1,102,1909,2011,0.3529236,0.3550968,2.04
1,103,1909,2012,0.3808502,0.3817391,1.89
1,104,1909,2013,0.4104359,0.4101464,1.75
1,105,1909,2014,0.4416930,0.4402317,1.61
1,106,1909,2015,0.4746198,0.4719448,1.49
1,107,1909,2016,0.5091990,0.5053755,1.37
1,108,1909,2017,0.5453968,0.5406213,1.26
1,109,1909,2018,0.5831612,0.5776658,1.16
1,110,1909,2019,0.6224217,0.6163590,1.07
1,111,1909,2020,0.6630882,0.6565873,0.98
1,112,1909,2021,0.7050519,0.6983378,0.90
1,113,1909,2022,0.7481851,0.7415754,0.81
1,114,1909,2023,0.7923424,0.7861616,0.71
1,115,1909,2024,1.0000000,1.0000000,0.50
1,90,1910,2000,0.1308036,0.1408281,4.78
1,91,1910,2001,0.1426766,0.1520269,4.48
1,92,1910,2002,0.1555375,0.1642171,4.20
1,93,1910,2003,0.1694519,0.1776084,3.93
1,94,1910,2004,0.1844867,0.1922734,3.67
1,95,1910,2005,0.2007091,0.2081028,3.42
1,96,1910,2006,0.2181866,0.2251157,3.19
1,97,1910,2007,0.2369856,0.2434070,2.97
1,98,1910,2008,0.2571705,0.2629211,2.76
1,99,1910,2009,0.2788028,0.2835499,2.56
1,100,1910,2010,0.3019394,0.3054323,2.38
1,101,1910,2011,0.3266317,0.3287962,2.21
1,102,1910,2012,0.3529236,0.3538142,2.05
1,103,1910,2013,0.3808502,0.3805582,1.89
1,104,1910,2014,0.4104359,0.4089517,1.75
1,105,1910,2015,0.4416930,0.4389542,1.62
1,106,1910,2016,0.4746198,0.4706695,1.49
1,107,1910,2017,0.5091990,0.5042144,1.38
1,108,1910,2018,0.5453968,0.5395928,1.27
1,109,1910,2019,0.5831612,0.5766699,1.16
1,110,1910,2020,0.6224217,0.6153469,1.07
1,111,1910,2021,0.6630882,0.6556352,0.98
1,112,1910,2022,0.7050519,0.6975296,0.90
1,113,1910,2023,0.7481851,0.7409161,0.81
1,114,1910,2024,0.7923424,0.7855852,0.71
1,115,1910,2025,1.0000000,1.0000000,0.50
1,89,1911,2000,0.1198550,0.1294293,5.12
1,90,1911,2001,0.1308036,0.1397527,4.80
1,91,1911,2002,0.1426766,0.1510026,4.50
1,92,1911,2003,0.1555375,0.1633813,4.21
1,93,1911,2004,0.1694519,0.1769608,3.94
1,94,1911,2005,0.1844867,0.1916377,3.68
1,95,1911,2006,0.2007091,0.2074324,3.43
1,96,1911,2007,0.2181866,0.2244392,3.20
1,97,1911,2008,0.2369856,0.2426062,2.98
1,98,1911,2009,0.2571705,0.2618294,2.77
1,99,1911,2010,0.2788028,0.2822459,2.58
1,100,1911,2011,0.3019394,0.3040835,2.39
1,101,1911,2012,0.3266317,0.3275186,2.22
1,102,1911,2013,0.3529236,0.3526311,2.05
1,103,1911,2014,0.3808502,0.3793537,1.90
1,104,1911,2015,0.4104359,0.4076546,1.76
1,105,1911,2016,0.4416930,0.4376490,1.62
1,106,1911,2017,0.4746198,0.4694705,1.50
1,107,1911,2018,0.5091990,0.5031416,1.38
1,108,1911,2019,0.5453968,0.5385417,1.27
1,109,1911,2020,0.5831612,0.5755870,1.17
1,110,1911,2021,0.6224217,0.6143116,1.07
1,111,1911,2022,0.6630882,0.6547388,0.98
1,112,1911,2023,0.7050519,0.6967798,0.90
1,113,1911,2024,0.7481851,0.7402386,0.82
1,114,1911,2025,0.7923424,0.7849569,0.72
1,115,1911,2026,1.0000000,1.0000000,0.50
1,88,1912,2000,0.1097689,0.1188911,5.47
1,89,1912,2001,0.1198550,0.1284007,5.14
1,90,1912,2002,0.1308036,0.1387711,4.82
1,91,1912,2003,0.1426766,0.1501999,4.52
1,92,1912,2004,0.1555375,0.1627578,4.23
1,93,1912,2005,0.1694519,0.1763471,3.95
1,94,1912,2006,0.1844867,0.1909887,3.69
1,95,1912,2007,0.2007091,0.2067754,3.44
1,96,1912,2008,0.2181866,0.2236589,3.21
1,97,1912,2009,0.2369856,0.2415385,2.99
1,98,1912,2010,0.2571705,0.2605491,2.78
1,99,1912,2011,0.2788028,0.2809160,2.59
1,100,1912,2012,0.3019394,0.3028178,2.40
1,101,1912,2013,0.3266317,0.3263405,2.23
1,102,1912,2014,0.3529236,0.3514247,2.06
1,103,1912,2015,0.3808502,0.3780462,1.91
1,104,1912,2016,0.4104359,0.4063296,1.76
1,105,1912,2017,0.4416930,0.4364222,1.63
1,106,1912,2018,0.4746198,0.4683630,1.50
1,107,1912,2019,0.5091990,0.5020453,1.38
1,108,1912,2020,0.5453968,0.5373990,1.27
1,109,1912,2021,0.5831612,0.5744795,1.17
1,110,1912,2022,0.6224217,0.6133369,1.07
1,111,1912,2023,0.6630882,0.6539072,0.98
1,112,1912,2024,0.7050519,0.6960095,0.90
1,113,1912,2025,0.7481851,0.7395003,0.82
1,114,1912,2026,0.7923424,0.7843137,0.72
1,115,1912,2027,1.0000000,1.0000000,0.50
1,87,1913,2000,0.1004863,0.1091503,5.84
1,88,1913,2001,0.1097689,0.1179097,5.49
1,89,1913,2002,0.1198550,0.1274621,5.16
1,90,1913,2003,0.1308036,0.1380021,4.84
1,91,1913,2004,0.1426766,0.1496012,4.53
1,92,1913,2005,0.1555375,0.1621671,4.24
1,93,1913,2006,0.1694519,0.1757208,3.96
1,94,1913,2007,0.1844867,0.1903528,3.70
1,95,1913,2008,0.2007091,0.2060178,3.46
1,96,1913,2009,0.2181866,0.2226188,3.22
1,97,1913,2010,0.2369856,0.2402869,3.00
1,98,1913,2011,0.2571705,0.2592438,2.79
1,99,1913,2012,0.2788028,0.2796684,2.60
1,100,1913,2013,0.3019394,0.3016510,2.41
1,101,1913,2014,0.3266317,0.3251394,2.23
1,102,1913,2015,0.3529236,0.3501155,2.07
1,103,1913,2016,0.3808502,0.3767111,1.91
1,104,1913,2017,0.4104359,0.4050846,1.77
1,105,1913,2018,0.4416930,0.4352893,1.63
1,106,1913,2019,0.4746198,0.4672315,1.50
1,107,1913,2020,0.5091990,0.5008538,1.39
1,108,1913,2021,0.5453968,0.5362306,1.28
1,109,1913,2022,0.5831612,0.5734370,1.17
1,110,1913,2023,0.6224217,0.6124330,1.08
1,111,1913,2024,0.6630882,0.6530530,0.99
1,112,1913,2025,0.7050519,0.6951701,0.90
1,113,1913,2026,0.7481851,0.7387447,0.82
1,114,1913,2027,0.7923424,0.7837082,0.72
1,115,1913,2028,1.0000000,1.0000000,0.50
1,86,1914,2000,0.0919504,0.1001511,6.22
1,87,1914,2001,0.1004863,0.1082168,5.86
1,88,1914,2002,0.1097689,0.1170144,5.51
1,89,1914,2003,0.1198550,0.1267270,5.17
1,90,1914,2004,0.1308036,0.1374286,4.85
1,91,1914,2005,0.1426766,0.1490342,4.55
1,92,1914,2006,0.1555375,0.1615644,4.26
1,93,1914,2007,0.1694519,0.1751072,3.98
1,94,1914,2008,0.1844867,0.1896197,3.72
1,95,1914,2009,0.2007091,0.2050082,3.47
1,96,1914,2010,0.2181866,0.2213998,3.24
1,97,1914,2011,0.2369856,0.2390111,3.01
1,98,1914,2012,0.2571705,0.2580196,2.80
1,99,1914,2013,0.2788028,0.2785186,2.61
1,100,1914,2014,0.3019394,0.3004618,2.42
1,101,1914,2015,0.3266317,0.3238364,2.24
1,102,1914,2016,0.3529236,0.3487790,2.08
1,103,1914,2017,0.3808502,0.3754569,1.92
1,104,1914,2018,0.4104359,0.4039352,1.77
1,105,1914,2019,0.4416930,0.4341321,1.64
1,106,1914,2020,0.4746198,0.4660020,1.51
1,107,1914,2021,0.5091990,0.4996358,1.39
1,108,1914,2022,0.5453968,0.5351311,1.28
1,109,1914,2023,0.5831612,0.5724705,1.17
1,110,1914,2024,0.6224217,0.6115046,1.08
1,111,1914,2025,0.6630882,0.6521224,0.99
1,112,1914,2026,0.7050519,0.6943111,0.90
1,113,1914,2027,0.7481851,0.7380332,0.82
1,114,1914,2028,0.7923424,0.7831476,0.72
1,115,1914,2029,1.0000000,1.0000000,0.50
1,85,1915,2000,0.0841076,0.0918428,6.63
1,86,1915,2001,0.0919504,0.0992664,6.25
1,87,1915,2002,0.1004863,0.1073656,5.88
1,88,1915,2003,0.1097689,0.1163134,5.53
1,89,1915,2004,0.1198550,0.1261789,5.19
1,90,1915,2005,0.1308036,0.1368856,4.87
1,91,1915,2006,0.1426766,0.1484556,4.56
1,92,1915,2007,0.1555375,0.1609740,4.27
1,93,1915,2008,0.1694519,0.1743999,4.00
1,94,1915,2009,0.1844867,0.1886429,3.73
1,95,1915,2010,0.2007091,0.2038253,3.49
1,96,1915,2011,0.2181866,0.2201577,3.25
1,97,1915,2012,0.2369856,0.2378150,3.03
1,98,1915,2013,0.2571705,0.2568918,2.82
1,99,1915,2014,0.2788028,0.2773471,2.62
1,100,1915,2015,0.3019394,0.2991720,2.43
1,101,1915,2016,0.3266317,0.3225066,2.25
1,102,1915,2017,0.3529236,0.3475240,2.08
1,103,1915,2018,0.3808502,0.3742992,1.93
1,104,1915,2019,0.4104359,0.4027615,1.78
1,105,1915,2020,0.4416930,0.4328751,1.64
1,106,1915,2021,0.4746198,0.4647455,1.51
1,107,1915,2022,0.5091990,0.4984899,1.39
1,108,1915,2023,0.5453968,0.5341119,1.28
1,109,1915,2024,0.5831612,0.5714779,1.18
1,110,1915,2025,0.6224217,0.6104933,1.08
1,111,1915,2026,0.6630882,0.6511703,0.99
1,112,1915,2027,0.7050519,0.6935025,0.90
1,113,1915,2028,0.7481851,0.7373747,0.82
1,114,1915,2029,0.7923424,0.7825736,0.72
1,115,1915,2030,1.0000000,1.0000000,0.50
1,84,1916,2000,0.0769067,0.0841778,7.06
1,85,1916,2001,0.0841076,0.0910073,6.66
1,86,1916,2002,0.0919504,0.0984599,6.27
1,87,1916,2003,0.1004863,0.1066993,5.90
1,88,1916,2004,0.1097689,0.1157909,5.55
1,89,1916,2005,0.1198550,0.1256600,5.21
1,90,1916,2006,0.1308036,0.1363316,4.89
1,91,1916,2007,0.1426766,0.1478890,4.58
1,92,1916,2008,0.1555375,0.1602935,4.29
1,93,1916,2009,0.1694519,0.1734578,4.01
1,94,1916,2010,0.1844867,0.1874988,3.75
1,95,1916,2011,0.2007091,0.2026204,3.50
1,96,1916,2012,0.2181866,0.2189937,3.26
1,97,1916,2013,0.2369856,0.2367134,3.04
1,98,1916,2014,0.2571705,0.2557429,2.83
1,99,1916,2015,0.2788028,0.2760768,2.63
1,100,1916,2016,0.3019394,0.2978562,2.44
1,101,1916,2017,0.3266317,0.3212582,2.26
1,102,1916,2018,0.3529236,0.3463658,2.09
1,103,1916,2019,0.3808502,0.3731175,1.93
1,104,1916,2020,0.4104359,0.4014867,1.78
1,105,1916,2021,0.4416930,0.4315907,1.65
1,106,1916,2022,0.4746198,0.4635636,1.52
1,107,1916,2023,0.5091990,0.4974279,1.40
1,108,1916,2024,0.5453968,0.5330654,1.28
1,109,1916,2025,0.5831612,0.5703970,1.18
1,110,1916,2026,0.6224217,0.6094588,1.08
1,111,1916,2027,0.6630882,0.6502741,0.99
1,112,1916,2028,0.7050519,0.6927541,0.91
1,113,1916,2029,0.7481851,0.7367006,0.82
1,114,1916,2030,0.7923424,0.7819488,0.72
1,115,1916,2031,1.0000000,1.0000000,0.50
1,83,1917,2000,0.0702997,0.0771119,7.50
1,84,1917,2001,0.0769067,0.0833915,7.09
1,85,1917,2002,0.0841076,0.0902458,6.68
1,86,1917,2003,0.0919504,0.0978287,6.30
1,87,1917,2004,0.1004863,0.1062028,5.93
1,88,1917,2005,0.1097689,0.1152963,5.57
1,89,1917,2006,0.1198550,0.1251308,5.23
1,90,1917,2007,0.1308036,0.1357892,4.91
1,91,1917,2008,0.1426766,0.1472362,4.60
1,92,1917,2009,0.1555375,0.1593874,4.31
1,93,1917,2010,0.1694519,0.1723546,4.03
1,94,1917,2011,0.1844867,0.1863339,3.77
1,95,1917,2012,0.2007091,0.2014915,3.52
1,96,1917,2013,0.2181866,0.2179218,3.28
1,97,1917,2014,0.2369856,0.2355916,3.05
1,98,1917,2015,0.2571705,0.2544977,2.84
1,99,1917,2016,0.2788028,0.2747813,2.64
1,100,1917,2017,0.3019394,0.2966213,2.45
1,101,1917,2018,0.3266317,0.3201065,2.27
1,102,1917,2019,0.3529236,0.3451838,2.10
1,103,1917,2020,0.3808502,0.3718344,1.94
1,104,1917,2021,0.4104359,0.4001847,1.79
1,105,1917,2022,0.4416930,0.4303830,1.65
1,106,1917,2023,0.4746198,0.4624686,1.52
1,107,1917,2024,0.5091990,0.4963378,1.40
1,108,1917,2025,0.5453968,0.5319260,1.29
1,109,1917,2026,0.5831612,0.5692915,1.18
1,110,1917,2027,0.6224217,0.6084853,1.08
1,111,1917,2028,0.6630882,0.6494449,0.99
1,112,1917,2029,0.7050519,0.6919882,0.91
1,113,1917,2030,0.7481851,0.7359668,0.82
1,114,1917,2031,0.7923424,0.7813092,0.72
1,115,1917,2032,1.0000000,1.0000000,0.50
1,82,1918,2000,0.0642414,0.0705964,7.97
1,83,1918,2001,0.0702997,0.0763745,7.53
1,84,1918,2002,0.0769067,0.0826751,7.11
1,85,1918,2003,0.0841076,0.0896500,6.71
1,86,1918,2004,0.0919504,0.0973585,6.32
1,87,1918,2005,0.1004863,0.1057328,5.95
1,88,1918,2006,0.1097689,0.1147920,5.59
1,89,1918,2007,0.1198550,0.1246127,5.25
1,90,1918,2008,0.1308036,0.1351643,4.93
1,91,1918,2009,0.1426766,0.1463670,4.62
1,92,1918,2010,0.1555375,0.1583268,4.33
1,93,1918,2011,0.1694519,0.1712317,4.05
1,94,1918,2012,0.1844867,0.1852427,3.78
1,95,1918,2013,0.2007091,0.2004524,3.53
1,96,1918,2014,0.2181866,0.2168306,3.29
1,97,1918,2015,0.2369856,0.2343760,3.06
1,98,1918,2016,0.2571705,0.2532281,2.85
1,99,1918,2017,0.2788028,0.2735659,2.65
1,100,1918,2018,0.3019394,0.2954823,2.45
1,101,1918,2019,0.3266317,0.3189315,2.27
1,102,1918,2020,0.3529236,0.3439009,2.10
1,103,1918,2021,0.3808502,0.3705241,1.95
1,104,1918,2022,0.4104359,0.3989607,1.80
1,105,1918,2023,0.4416930,0.4292643,1.66
1,106,1918,2024,0.4746198,0.4613448,1.53
1,107,1918,2025,0.5091990,0.4951511,1.40
1,108,1918,2026,0.5453968,0.5307610,1.29
1,109,1918,2027,0.5831612,0.5682514,1.19
1,110,1918,2028,0.6224217,0.6075847,1.09
1,111,1918,2029,0.6630882,0.6485962,0.99
1,112,1918,2030,0.7050519,0.6911545,0.91
1,113,1918,2031,0.7481851,0.7352158,0.82
1,114,1918,2032,0.7923424,0.7807072,0.72
1,115,1918,2033,1.0000000,1.0000000,0.50
1,81,1919,2000,0.0586892,0.0646033,8.45
1,82,1919,2001,0.0642414,0.0699078,8.00
1,83,1919,2002,0.0702997,0.0757027,7.56
1,84,1919,2003,0.0769067,0.0821147,7.14
1,85,1919,2004,0.0841076,0.0892062,6.74
1,86,1919,2005,0.0919504,0.0969134,6.35
1,87,1919,2006,0.1004863,0.1052537,5.97
1,88,1919,2007,0.1097689,0.1142983,5.62
1,89,1919,2008,0.1198550,0.1240159,5.28
1,90,1919,2009,0.1308036,0.1343325,4.95
1,91,1919,2010,0.1426766,0.1453498,4.65
1,92,1919,2011,0.1555375,0.1572474,4.35
1,93,1919,2012,0.1694519,0.1701803,4.07
1,94,1919,2013,0.1844867,0.1842386,3.80
1,95,1919,2014,0.2007091,0.1993948,3.55
1,96,1919,2015,0.2181866,0.2156486,3.31
1,97,1919,2016,0.2369856,0.2331370,3.08
1,98,1919,2017,0.2571705,0.2520373,2.86
1,99,1919,2018,0.2788028,0.2724452,2.66
1,100,1919,2019,0.3019394,0.2943206,2.46
1,101,1919,2020,0.3266317,0.3176564,2.28
1,102,1919,2021,0.3529236,0.3425911,2.11
1,103,1919,2022,0.3808502,0.3692927,1.95
1,104,1919,2023,0.4104359,0.3978271,1.80
1,105,1919,2024,0.4416930,0.4281165,1.66
1,106,1919,2025,0.4746198,0.4601218,1.53
1,107,1919,2026,0.5091990,0.4939381,1.41
1,108,1919,2027,0.5453968,0.5296652,1.29
1,109,1919,2028,0.5831612,0.5672894,1.19
1,110,1919,2029,0.6224217,0.6066632,1.09
1,111,1919,2030,0.6630882,0.6476728,1.00
1,112,1919,2031,0.7050519,0.6903015,0.91
1,113,1919,2032,0.7481851,0.7345091,0.82
1,114,1919,2033,0.7923424,0.7801511,0.72
1,115,1919,2034,1.0000000,1.0000000,0.50
1,80,1920,2000,0.0536037,0.0591062,8.96
1,81,1920,2001,0.0586892,0.0639619,8.49
1,82,1920,2002,0.0642414,0.0692807,8.03
1,83,1920,2003,0.0702997,0.0751774,7.59
1,84,1920,2004,0.0769067,0.0816973,7.17
1,85,1920,2005,0.0841076,0.0887863,6.76
1,86,1920,2006,0.0919504,0.0964598,6.37
1,87,1920,2007,0.1004863,0.1047847,6.00
1,88,1920,2008,0.1097689,0.1137297,5.64
1,89,1920,2009,0.1198550,0.1232218,5.30
1,90,1920,2010,0.1308036,0.1333595,4.98
1,91,1920,2011,0.1426766,0.1443151,4.67
1,92,1920,2012,0.1555375,0.1562371,4.37
1,93,1920,2013,0.1694519,0.1692130,4.09
1,94,1920,2014,0.1844867,0.1832170,3.82
1,95,1920,2015,0.2007091,0.1982496,3.56
1,96,1920,2016,0.2181866,0.2144442,3.32
1,97,1920,2017,0.2369856,0.2319753,3.09
1,98,1920,2018,0.2571705,0.2509396,2.87
1,99,1920,2019,0.2788028,0.2713024,2.67
1,100,1920,2020,0.3019394,0.2930603,2.47
1,101,1920,2021,0.3266317,0.3163551,2.29
1,102,1920,2022,0.3529236,0.3413606,2.12
1,103,1920,2023,0.3808502,0.3681527,1.96
1,104,1920,2024,0.4104359,0.3966645,1.81
1,105,1920,2025,0.4416930,0.4268676,1.67
1,106,1920,2026,0.4746198,0.4588719,1.53
1,107,1920,2027,0.5091990,0.4927973,1.41
1,108,1920,2028,0.5453968,0.5286518,1.30
1,109,1920,2029,0.5831612,0.5663052,1.19
1,110,1920,2030,0.6224217,0.6056607,1.09
1,111,1920,2031,0.6630882,0.6467280,1.00
1,112,1920,2032,0.7050519,0.6894987,0.91
1,113,1920,2033,0.7481851,0.7338562,0.82
1,114,1920,2034,0.7923424,0.7795835,0.72
1,115,1920,2035,1.0000000,1.0000000,0.50
1,79,1921,2000,0.0480027,0.0532966,9.49
1,80,1921,2001,0.0536037,0.0585090,8.99
1,81,1921,2002,0.0586892,0.0633779,8.52
1,82,1921,2003,0.0642414,0.0687903,8.06
1,83,1921,2004,0.0702997,0.0747862,7.62
1,84,1921,2005,0.0769067,0.0813025,7.20
1,85,1921,2006,0.0841076,0.0883583,6.79
1,86,1921,2007,0.0919504,0.0960159,6.40
1,87,1921,2008,0.1004863,0.1042448,6.03
1,88,1921,2009,0.1097689,0.1129734,5.67
1,89,1921,2010,0.1198550,0.1222930,5.33
1,90,1921,2011,0.1308036,0.1323700,5.00
1,91,1921,2012,0.1426766,0.1433469,4.69
1,92,1921,2013,0.1555375,0.1553080,4.39
1,93,1921,2014,0.1694519,0.1682292,4.11
1,94,1921,2015,0.1844867,0.1821111,3.84
1,95,1921,2016,0.2007091,0.1970830,3.58
1,96,1921,2017,0.2181866,0.2133153,3.33
1,97,1921,2018,0.2369856,0.2309048,3.10
1,98,1921,2019,0.2571705,0.2498207,2.88
1,99,1921,2020,0.2788028,0.2700630,2.68
1,100,1921,2021,0.3019394,0.2917746,2.48
1,101,1921,2022,0.3266317,0.3151329,2.30
1,102,1921,2023,0.3529236,0.3402216,2.13
1,103,1921,2024,0.3808502,0.3669836,1.96
1,104,1921,2025,0.4104359,0.3953997,1.81
1,105,1921,2026,0.4416930,0.4255917,1.67
1,106,1921,2027,0.4746198,0.4576968,1.54
1,107,1921,2028,0.5091990,0.4917426,1.41
1,108,1921,2029,0.5453968,0.5276153,1.30
1,109,1921,2030,0.5831612,0.5652347,1.19
1,110,1921,2031,0.6224217,0.6046351,1.09
1,111,1921,2032,0.6630882,0.6458390,1.00
1,112,1921,2033,0.7050519,0.6887574,0.91
1,113,1921,2034,0.7481851,0.7331899,0.83
1,114,1921,2035,0.7923424,0.7789662,0.72
1,115,1921,2036,1.0000000,1.0000000,0.50
1,78,1922,2000,0.0440886,0.0489860,10.04
1,79,1922,2001,0.0480027,0.0527202,9.53
1,80,1922,2002,0.0536037,0.0579653,9.03
1,81,1922,2003,0.0586892,0.0629214,8.56
1,82,1922,2004,0.0642414,0.0684252,8.10
1,83,1922,2005,0.0702997,0.0744161,7.65
1,84,1922,2006,0.0769067,0.0809001,7.23
1,85,1922,2007,0.0841076,0.0879396,6.82
1,86,1922,2008,0.0919504,0.0955049,6.43
1,87,1922,2009,0.1004863,0.1035267,6.06
1,88,1922,2010,0.1097689,0.1120890,5.70
1,89,1922,2011,0.1198550,0.1213489,5.36
1,90,1922,2012,0.1308036,0.1314443,5.03
1,91,1922,2013,0.1426766,0.1424567,4.71
1,92,1922,2014,0.1555375,0.1543633,4.41
1,93,1922,2015,0.1694519,0.1671645,4.12
1,94,1922,2016,0.1844867,0.1809849,3.85
1,95,1922,2017,0.2007091,0.1959900,3.59
1,96,1922,2018,0.2181866,0.2122753,3.35
1,97,1922,2019,0.2369856,0.2298138,3.11
1,98,1922,2020,0.2571705,0.2486075,2.89
1,99,1922,2021,0.2788028,0.2687990,2.69
1,100,1922,2022,0.3019394,0.2905673,2.49
1,101,1922,2023,0.3266317,0.3140019,2.31
1,102,1922,2024,0.3529236,0.3390540,2.13
1,103,1922,2025,0.3808502,0.3657123,1.97
1,104,1922,2026,0.4104359,0.3941079,1.82
1,105,1922,2027,0.4416930,0.4243924,1.68
1,106,1922,2028,0.4746198,0.4566106,1.54
1,107,1922,2029,0.5091990,0.4906641,1.42
1,108,1922,2030,0.5453968,0.5264881,1.30
1,109,1922,2031,0.5831612,0.5641398,1.20
1,110,1922,2032,0.6224217,0.6036704,1.10
1,111,1922,2033,0.6630882,0.6450182,1.00
1,112,1922,2034,0.7050519,0.6880009,0.91
1,113,1922,2035,0.7481851,0.7324654,0.83
1,114,1922,2036,0.7923424,0.7783344,0.72
1,115,1922,2037,1.0000000,1.0000000,0.50
1,77,1923,2000,0.0405123,0.0450532,10.60
1,78,1923,2001,0.0440886,0.0484526,10.08
1,79,1923,2002,0.0480027,0.0521959,9.57
1,80,1923,2003,0.0536037,0.0575403,9.07
1,81,1923,2004,0.0586892,0.0625815,8.59
1,82,1923,2005,0.0642414,0.0680799,8.13
1,83,1923,2006,0.0702997,0.0740390,7.69
1,84,1923,2007,0.0769067,0.0805065,7.26
1,85,1923,2008,0.0841076,0.0874577,6.85
1,86,1923,2009,0.0919504,0.0948254,6.46
1,87,1923,2010,0.1004863,0.1026872,6.09
1,88,1923,2011,0.1097689,0.1111903,5.73
1,89,1923,2012,0.1198550,0.1204659,5.38
1,90,1923,2013,0.1308036,0.1305936,5.05
1,91,1923,2014,0.1426766,0.1415519,4.73
1,92,1923,2015,0.1555375,0.1533411,4.43
1,93,1923,2016,0.1694519,0.1660806,4.14
1,94,1923,2017,0.1844867,0.1799300,3.87
1,95,1923,2018,0.2007091,0.1949833,3.61
1,96,1923,2019,0.2181866,0.2112158,3.36
1,97,1923,2020,0.2369856,0.2286314,3.13
1,98,1923,2021,0.2571705,0.2473706,2.91
1,99,1923,2022,0.2788028,0.2676125,2.70
1,100,1923,2023,0.3019394,0.2894505,2.50
1,101,1923,2024,0.3266317,0.3128428,2.31
1,102,1923,2025,0.3529236,0.3377846,2.14
1,103,1923,2026,0.3808502,0.3644141,1.98
1,104,1923,2027,0.4104359,0.3928941,1.82
1,105,1923,2028,0.4416930,0.4232842,1.68
1,106,1923,2029,0.4746198,0.4555002,1.55
1,107,1923,2030,0.5091990,0.4894915,1.42
1,108,1923,2031,0.5453968,0.5253356,1.31
1,109,1923,2032,0.5831612,0.5631101,1.20
1,110,1923,2033,0.6224217,0.6027797,1.10
1,111,1923,2034,0.6630882,0.6441807,1.00
1,112,1923,2035,0.7050519,0.6871784,0.92
1,113,1923,2036,0.7481851,0.7317240,0.83
1,114,1923,2037,0.7923424,0.7777393,0.72
1,115,1923,2038,1.0000000,1.0000000,0.50
1,76,1924,2000,0.0371478,0.0413822,11.19
1,77,1924,2001,0.0405123,0.0445583,10.65
1,78,1924,2002,0.0440886,0.0479674,10.12
1,79,1924,2003,0.0480027,0.0517863,9.61
1,80,1924,2004,0.0536037,0.0572239,9.10
1,81,1924,2005,0.0586892,0.0622601,8.63
1,82,1924,2006,0.0642414,0.0677281,8.17
1,83,1924,2007,0.0702997,0.0736702,7.72
1,84,1924,2008,0.0769067,0.0800535,7.30
1,85,1924,2009,0.0841076,0.0868169,6.89
1,86,1924,2010,0.0919504,0.0940314,6.50
1,87,1924,2011,0.1004863,0.1018345,6.12
1,88,1924,2012,0.1097689,0.1103501,5.76
1,89,1924,2013,0.1198550,0.1196547,5.41
1,90,1924,2014,0.1308036,0.1297290,5.07
1,91,1924,2015,0.1426766,0.1405731,4.76
1,92,1924,2016,0.1555375,0.1523010,4.45
1,93,1924,2017,0.1694519,0.1650657,4.16
1,94,1924,2018,0.1844867,0.1789588,3.89
1,95,1924,2019,0.2007091,0.1939580,3.62
1,96,1924,2020,0.2181866,0.2100677,3.38
1,97,1924,2021,0.2369856,0.2274261,3.14
1,98,1924,2022,0.2571705,0.2462100,2.92
1,99,1924,2023,0.2788028,0.2665153,2.71
1,100,1924,2024,0.3019394,0.2883062,2.51
1,101,1924,2025,0.3266317,0.3115830,2.32
1,102,1924,2026,0.3529236,0.3364888,2.15
1,103,1924,2027,0.3808502,0.3631947,1.98
1,104,1924,2028,0.4104359,0.3917727,1.83
1,105,1924,2029,0.4416930,0.4221514,1.69
1,106,1924,2030,0.4746198,0.4542931,1.55
1,107,1924,2031,0.5091990,0.4882929,1.43
1,108,1924,2032,0.5453968,0.5242519,1.31
1,109,1924,2033,0.5831612,0.5621597,1.20
1,110,1924,2034,0.6224217,0.6018712,1.10
1,111,1924,2035,0.6630882,0.6432704,1.01
1,112,1924,2036,0.7050519,0.6863368,0.92
1,113,1924,2037,0.7481851,0.7310258,0.83
1,114,1924,2038,0.7923424,0.7771878,0.72
1,115,1924,2039,1.0000000,1.0000000,0.50
1,75,1925,2000,0.0339099,0.0378878,11.79
1,76,1925,2001,0.0371478,0.0409204,11.23
1,77,1925,2002,0.0405123,0.0441083,10.69
1,78,1925,2003,0.0440886,0.0475884,10.16
1,79,1925,2004,0.0480027,0.0514815,9.65
1,80,1925,2005,0.0536037,0.0569248,9.14
1,81,1925,2006,0.0586892,0.0619326,8.66
1,82,1925,2007,0.0642414,0.0673840,8.20
1,83,1925,2008,0.0702997,0.0732459,7.76
1,84,1925,2009,0.0769067,0.0794513,7.33
1,85,1925,2010,0.0841076,0.0860683,6.92
1,86,1925,2011,0.0919504,0.0932249,6.53
1,87,1925,2012,0.1004863,0.1010375,6.15
1,88,1925,2013,0.1097689,0.1095784,5.78
1,89,1925,2014,0.1198550,0.1188305,5.43
1,90,1925,2015,0.1308036,0.1287942,5.10
1,91,1925,2016,0.1426766,0.1395776,4.78
1,92,1925,2017,0.1555375,0.1513273,4.47
1,93,1925,2018,0.1694519,0.1641316,4.18
1,94,1925,2019,0.1844867,0.1779699,3.90
1,95,1925,2020,0.2007091,0.1928473,3.64
1,96,1925,2021,0.2181866,0.2088980,3.39
1,97,1925,2022,0.2369856,0.2262956,3.15
1,98,1925,2023,0.2571705,0.2451369,2.93
1,99,1925,2024,0.2788028,0.2653913,2.72
1,100,1925,2025,0.3019394,0.2870629,2.52
1,101,1925,2026,0.3266317,0.3102974,2.33
1,102,1925,2027,0.3529236,0.3352719,2.15
1,103,1925,2028,0.3808502,0.3620684,1.99
1,104,1925,2029,0.4104359,0.3906268,1.83
1,105,1925,2030,0.4416930,0.4209205,1.69
1,106,1925,2031,0.4746198,0.4530596,1.56
1,107,1925,2032,0.5091990,0.4871661,1.43
1,108,1925,2033,0.5453968,0.5232518,1.31
1,109,1925,2034,0.5831612,0.5611903,1.20
1,110,1925,2035,0.6224217,0.6008838,1.10
1,111,1925,2036,0.6630882,0.6423391,1.01
1,112,1925,2037,0.7050519,0.6855444,0.92
1,113,1925,2038,0.7481851,0.7303788,0.83
1,114,1925,2039,0.7923424,0.7766220,0.72
1,115,1925,2040,1.0000000,1.0000000,0.50
1,74,1926,2000,0.0307579,0.0345167,12.41
1,75,1926,2001,0.0339099,0.0374534,11.84
1,76,1926,2002,0.0371478,0.0405005,11.28
1,77,1926,2003,0.0405123,0.0437568,10.74
1,78,1926,2004,0.0440886,0.0473064,10.21
1,79,1926,2005,0.0480027,0.0511935,9.69
1,80,1926,2006,0.0536037,0.0566201,9.18
1,81,1926,2007,0.0586892,0.0616124,8.70
1,82,1926,2008,0.0642414,0.0669881,8.24
1,83,1926,2009,0.0702997,0.0726818,7.80
1,84,1926,2010,0.0769067,0.0787480,7.37
1,85,1926,2011,0.0841076,0.0853083,6.96
1,86,1926,2012,0.0919504,0.0924714,6.56
1,87,1926,2013,0.1004863,0.1003056,6.18
1,88,1926,2014,0.1097689,0.1087946,5.81
1,89,1926,2015,0.1198550,0.1179396,5.46
1,90,1926,2016,0.1308036,0.1278435,5.12
1,91,1926,2017,0.1426766,0.1386459,4.80
1,92,1926,2018,0.1555375,0.1504313,4.49
1,93,1926,2019,0.1694519,0.1631807,4.20
1,94,1926,2020,0.1844867,0.1768990,3.92
1,95,1926,2021,0.2007091,0.1917160,3.66
1,96,1926,2022,0.2181866,0.2078010,3.40
1,97,1926,2023,0.2369856,0.2252506,3.17
1,98,1926,2024,0.2571705,0.2440380,2.94
1,99,1926,2025,0.2788028,0.2641705,2.73
1,100,1926,2026,0.3019394,0.2857945,2.53
1,101,1926,2027,0.3266317,0.3090905,2.34
1,102,1926,2028,0.3529236,0.3341483,2.16
1,103,1926,2029,0.3808502,0.3609177,2.00
1,104,1926,2030,0.4104359,0.3893819,1.84
1,105,1926,2031,0.4416930,0.4196628,1.70
1,106,1926,2032,0.4746198,0.4519003,1.56
1,107,1926,2033,0.5091990,0.4861264,1.43
1,108,1926,2034,0.5453968,0.5222321,1.31
1,109,1926,2035,0.5831612,0.5601372,1.21
1,110,1926,2036,0.6224217,0.5998738,1.10
1,111,1926,2037,0.6630882,0.6414623,1.01
1,112,1926,2038,0.7050519,0.6848102,0.92
1,113,1926,2039,0.7481851,0.7297150,0.83
1,114,1926,2040,0.7923424,0.7760056,0.72
1,115,1926,2041,1.0000000,1.0000000,0.50
1,73,1927,2000,0.0277519,0.0313075,13.06
1,74,1927,2001,0.0307579,0.0341054,12.47
1,75,1927,2002,0.0339099,0.0370584,11.89
1,76,1927,2003,0.0371478,0.0401725,11.33
1,77,1927,2004,0.0405123,0.0434953,10.78
1,78,1927,2005,0.0440886,0.0470399,10.25
1,79,1927,2006,0.0480027,0.0509001,9.73
1,80,1927,2007,0.0536037,0.0563221,9.23
1,81,1927,2008,0.0586892,0.0612440,8.75
1,82,1927,2009,0.0642414,0.0664621,8.28
1,83,1927,2010,0.0702997,0.0720232,7.84
1,84,1927,2011,0.0769067,0.0780341,7.41
1,85,1927,2012,0.0841076,0.0845983,6.99
1,86,1927,2013,0.0919504,0.0917797,6.59
1,87,1927,2014,0.1004863,0.0995625,6.21
1,88,1927,2015,0.1097689,0.1079476,5.84
1,89,1927,2016,0.1198550,0.1170339,5.49
1,90,1927,2017,0.1308036,0.1269542,5.15
1,91,1927,2018,0.1426766,0.1377888,4.82
1,92,1927,2019,0.1555375,0.1495196,4.51
1,93,1927,2020,0.1694519,0.1621513,4.22
1,94,1927,2021,0.1844867,0.1758086,3.94
1,95,1927,2022,0.2007091,0.1906555,3.67
1,96,1927,2023,0.2181866,0.2067874,3.42
1,97,1927,2024,0.2369856,0.2241808,3.18
1,98,1927,2025,0.2571705,0.2428448,2.95
1,99,1927,2026,0.2788028,0.2629254,2.74
1,100,1927,2027,0.3019394,0.2846041,2.54
1,101,1927,2028,0.3266317,0.3079764,2.35
1,102,1927,2029,0.3529236,0.3330007,2.17
1,103,1927,2030,0.3808502,0.3596681,2.00
1,104,1927,2031,0.4104359,0.3881103,1.85
1,105,1927,2032,0.4416930,0.4184812,1.70
1,106,1927,2033,0.4746198,0.4508309,1.56
1,107,1927,2034,0.5091990,0.4850666,1.44
1,108,1927,2035,0.5453968,0.5211243,1.32
1,109,1927,2036,0.5831612,0.5590600,1.21
1,110,1927,2037,0.6224217,0.5989233,1.11
1,111,1927,2038,0.6630882,0.6406501,1.01
1,112,1927,2039,0.7050519,0.6840571,0.92
1,113,1927,2040,0.7481851,0.7289922,0.83
1,114,1927,2041,0.7923424,0.7753748,0.72
1,115,1927,2042,1.0000000,1.0000000,0.50
1,72,1928,2000,0.0250119,0.0283531,13.73
1,73,1928,2001,0.0277519,0.0309176,13.12
1,74,1928,2002,0.0307579,0.0337316,12.52
1,75,1928,2003,0.0339099,0.0367501,11.94
1,76,1928,2004,0.0371478,0.0399286,11.38
1,77,1928,2005,0.0405123,0.0432481,10.83
1,78,1928,2006,0.0440886,0.0467685,10.29
1,79,1928,2007,0.0480027,0.0506134,9.78
1,80,1928,2008,0.0536037,0.0559794,9.27
1,81,1928,2009,0.0586892,0.0607546,8.79
1,82,1928,2010,0.0642414,0.0658479,8.33
1,83,1928,2011,0.0702997,0.0713549,7.88
1,84,1928,2012,0.0769067,0.0773675,7.44
1,85,1928,2013,0.0841076,0.0839468,7.03
1,86,1928,2014,0.0919504,0.0910776,6.62
1,87,1928,2015,0.1004863,0.0987598,6.24
1,88,1928,2016,0.1097689,0.1070868,5.87
1,89,1928,2017,0.1198550,0.1161869,5.51
1,90,1928,2018,0.1308036,0.1261363,5.17
1,91,1928,2019,0.1426766,0.1369169,4.84
1,92,1928,2020,0.1555375,0.1485329,4.53
1,93,1928,2021,0.1694519,0.1611035,4.24
1,94,1928,2022,0.1844867,0.1747867,3.95
1,95,1928,2023,0.2007091,0.1896759,3.69
1,96,1928,2024,0.2181866,0.2057500,3.43
1,97,1928,2025,0.2369856,0.2230196,3.19
1,98,1928,2026,0.2571705,0.2416283,2.96
1,99,1928,2027,0.2788028,0.2617572,2.75
1,100,1928,2028,0.3019394,0.2835055,2.55
1,101,1928,2029,0.3266317,0.3068388,2.36
1,102,1928,2030,0.3529236,0.3317547,2.18
1,103,1928,2031,0.3808502,0.3583920,2.01
1,104,1928,2032,0.4104359,0.3869159,1.85
1,105,1928,2033,0.4416930,0.4173915,1.70
1,106,1928,2034,0.4746198,0.4497410,1.57
1,107,1928,2035,0.5091990,0.4839155,1.44
1,108,1928,2036,0.5453968,0.5199917,1.32
1,109,1928,2037,0.5831612,0.5580464,1.21
1,110,1928,2038,0.6224217,0.5980427,1.11
1,111,1928,2039,0.6630882,0.6398171,1.01
1,112,1928,2040,0.7050519,0.6832371,0.92
1,113,1928,2041,0.7481851,0.7282523,0.83
1,114,1928,2042,0.7923424,0.7747809,0.73
1,115,1928,2043,1.0000000,1.0000000,0.50
1,71,1929,2000,0.0226142,0.0257283,14.42
1,72,1929,2001,0.0250119,0.0279858,13.79
1,73,1929,2002,0.0277519,0.0305634,13.17
1,74,1929,2003,0.0307579,0.0334400,12.57
1,75,1929,2004,0.0339099,0.0365208,11.99
1,76,1929,2005,0.0371478,0.0396980,11.42
1,77,1929,2006,0.0405123,0.0429965,10.88
1,78,1929,2007,0.0440886,0.0465033,10.34
1,79,1929,2008,0.0480027,0.0502838,9.82
1,80,1929,2009,0.0536037,0.0555241,9.32
1,81,1929,2010,0.0586892,0.0601833,8.83
1,82,1929,2011,0.0642414,0.0652248,8.37
1,83,1929,2012,0.0702997,0.0707309,7.92
1,84,1929,2013,0.0769067,0.0767557,7.48
1,85,1929,2014,0.0841076,0.0832855,7.06
1,86,1929,2015,0.0919504,0.0903192,6.66
1,87,1929,2016,0.1004863,0.0979442,6.27
1,88,1929,2017,0.1097689,0.1062821,5.90
1,89,1929,2018,0.1198550,0.1154082,5.54
1,90,1929,2019,0.1308036,0.1253046,5.19
1,91,1929,2020,0.1426766,0.1359737,4.87
1,92,1929,2021,0.1555375,0.1475289,4.55
1,93,1929,2022,0.1694519,0.1601218,4.26
1,94,1929,2023,0.1844867,0.1738430,3.97
1,95,1929,2024,0.2007091,0.1886735,3.70
1,96,1929,2025,0.2181866,0.2046243,3.45
1,97,1929,2026,0.2369856,0.2218360,3.20
1,98,1929,2027,0.2571705,0.2404872,2.97
1,99,1929,2028,0.2788028,0.2606795,2.76
1,100,1929,2029,0.3019394,0.2823842,2.56
1,101,1929,2030,0.3266317,0.3056040,2.36
1,102,1929,2031,0.3529236,0.3304828,2.18
1,103,1929,2032,0.3808502,0.3571938,2.02
1,104,1929,2033,0.4104359,0.3858148,1.86
1,105,1929,2034,0.4416930,0.4162812,1.71
1,106,1929,2035,0.4746198,0.4485577,1.57
1,107,1929,2036,0.5091990,0.4827389,1.44
1,108,1929,2037,0.5453968,0.5189261,1.32
1,109,1929,2038,0.5831612,0.5571077,1.21
1,110,1929,2039,0.6224217,0.5971400,1.11
1,111,1929,2040,0.6630882,0.6389102,1.01
1,112,1929,2041,0.7050519,0.6823979,0.92
1,113,1929,2042,0.7481851,0.7275560,0.83
1,114,1929,2043,0.7923424,0.7742326,0.73
1,115,1929,2044,1.0000000,1.0000000,0.50
1,70,1930,2000,0.0205786,0.0234509,15.13
1,71,1930,2001,0.0226142,0.0253855,14.48
1,72,1930,2002,0.0250119,0.0276524,13.85
1,73,1930,2003,0.0277519,0.0302871,13.23
1,74,1930,2004,0.0307579,0.0332231,12.62
1,75,1930,2005,0.0339099,0.0363041,12.04
1,76,1930,2006,0.0371478,0.0394633,11.48
1,77,1930,2007,0.0405123,0.0427505,10.93
1,78,1930,2008,0.0440886,0.0461983,10.39
1,79,1930,2009,0.0480027,0.0498461,9.87
1,80,1930,2010,0.0536037,0.0549927,9.36
1,81,1930,2011,0.0586892,0.0596037,8.88
1,82,1930,2012,0.0642414,0.0646432,8.41
1,83,1930,2013,0.0702997,0.0701585,7.96
1,84,1930,2014,0.0769067,0.0761351,7.52
1,85,1930,2015,0.0841076,0.0825716,7.10
1,86,1930,2016,0.0919504,0.0895490,6.69
1,87,1930,2017,0.1004863,0.0971819,6.30
1,88,1930,2018,0.1097689,0.1055425,5.92
1,89,1930,2019,0.1198550,0.1146165,5.56
1,90,1930,2020,0.1308036,0.1244050,5.22
1,91,1930,2021,0.1426766,0.1350141,4.89
1,92,1930,2022,0.1555375,0.1465885,4.57
1,93,1930,2023,0.1694519,0.1592155,4.27
1,94,1930,2024,0.1844867,0.1728778,3.99
1,95,1930,2025,0.2007091,0.1875861,3.72
1,96,1930,2026,0.2181866,0.2034773,3.46
1,97,1930,2027,0.2369856,0.2207262,3.22
1,98,1930,2028,0.2571705,0.2394349,2.99
1,99,1930,2029,0.2788028,0.2595797,2.77
1,100,1930,2030,0.3019394,0.2811673,2.56
1,101,1930,2031,0.3266317,0.3043440,2.37
1,102,1930,2032,0.3529236,0.3292887,2.19
1,103,1930,2033,0.3808502,0.3560893,2.02
1,104,1930,2034,0.4104359,0.3846930,1.86
1,105,1930,2035,0.4416930,0.4150759,1.71
1,106,1930,2036,0.4746198,0.4473483,1.58
1,107,1930,2037,0.5091990,0.4816322,1.45
1,108,1930,2038,0.5453968,0.5179394,1.33
1,109,1930,2039,0.5831612,0.5561455,1.22
1,110,1930,2040,0.6224217,0.5961571,1.11
1,111,1930,2041,0.6630882,0.6379824,1.02
1,112,1930,2042,0.7050519,0.6816083,0.93
1,113,1930,2043,0.7481851,0.7269132,0.83
1,114,1930,2044,0.7923424,0.7736733,0.73
1,115,1930,2045,1.0000000,1.0000000,0.50
1,69,1931,2000,0.0188954,0.0215223,15.86
1,70,1931,2001,0.0205786,0.0231344,15.19
1,71,1931,2002,0.0226142,0.0250743,14.54
1,72,1931,2003,0.0250119,0.0273925,13.90
1,73,1931,2004,0.0277519,0.0300817,13.28
1,74,1931,2005,0.0307579,0.0330182,12.68
1,75,1931,2006,0.0339099,0.0360836,12.09
1,76,1931,2007,0.0371478,0.0392340,11.53
1,77,1931,2008,0.0405123,0.0424678,10.98
1,78,1931,2009,0.0440886,0.0457934,10.44
1,79,1931,2010,0.0480027,0.0493356,9.92
1,80,1931,2011,0.0536037,0.0544538,9.41
1,81,1931,2012,0.0586892,0.0590628,8.92
1,82,1931,2013,0.0642414,0.0641097,8.45
1,83,1931,2014,0.0702997,0.0695778,7.99
1,84,1931,2015,0.0769067,0.0754652,7.56
1,85,1931,2016,0.0841076,0.0818467,7.13
1,86,1931,2017,0.0919504,0.0888294,6.72
1,87,1931,2018,0.1004863,0.0964815,6.33
1,88,1931,2019,0.1097689,0.1047907,5.95
1,89,1931,2020,0.1198550,0.1137605,5.59
1,90,1931,2021,0.1308036,0.1234901,5.24
1,91,1931,2022,0.1426766,0.1341157,4.91
1,92,1931,2023,0.1555375,0.1457207,4.59
1,93,1931,2024,0.1694519,0.1582888,4.29
1,94,1931,2025,0.1844867,0.1718309,4.01
1,95,1931,2026,0.2007091,0.1864786,3.73
1,96,1931,2027,0.2181866,0.2024021,3.47
1,97,1931,2028,0.2369856,0.2197030,3.23
1,98,1931,2029,0.2571705,0.2383613,3.00
1,99,1931,2030,0.2788028,0.2583866,2.78
1,100,1931,2031,0.3019394,0.2799259,2.57
1,101,1931,2032,0.3266317,0.3031614,2.38
1,102,1931,2033,0.3529236,0.3281884,2.20
1,103,1931,2034,0.3808502,0.3549645,2.03
1,104,1931,2035,0.4104359,0.3834757,1.87
1,105,1931,2036,0.4416930,0.4138445,1.72
1,106,1931,2037,0.4746198,0.4462111,1.58
1,107,1931,2038,0.5091990,0.4806078,1.45
1,108,1931,2039,0.5453968,0.5169283,1.33
1,109,1931,2040,0.5831612,0.5550982,1.22
1,110,1931,2041,0.6224217,0.5951519,1.11
1,111,1931,2042,0.6630882,0.6371094,1.02
1,112,1931,2043,0.7050519,0.6808793,0.93
1,113,1931,2044,0.7481851,0.7262574,0.84
1,114,1931,2045,0.7923424,0.7730653,0.73
1,115,1931,2046,1.0000000,1.0000000,0.50
1,68,1932,2000,0.0174919,0.0198909,16.60
1,69,1932,2001,0.0188954,0.0212329,15.92
1,70,1932,2002,0.0205786,0.0228473,15.26
1,71,1932,2003,0.0226142,0.0248318,14.60
1,72,1932,2004,0.0250119,0.0271994,13.96
1,73,1932,2005,0.0277519,0.0298878,13.34
1,74,1932,2006,0.0307579,0.0328098,12.73
1,75,1932,2007,0.0339099,0.0358681,12.15
1,76,1932,2008,0.0371478,0.0389703,11.58
1,77,1932,2009,0.0405123,0.0420924,11.03
1,78,1932,2010,0.0440886,0.0453213,10.49
1,79,1932,2011,0.0480027,0.0488181,9.97
1,80,1932,2012,0.0536037,0.0539510,9.45
1,81,1932,2013,0.0586892,0.0585668,8.97
1,82,1932,2014,0.0642414,0.0635687,8.49
1,83,1932,2015,0.0702997,0.0689511,8.03
1,84,1932,2016,0.0769067,0.0747851,7.59
1,85,1932,2017,0.0841076,0.0811695,7.17
1,86,1932,2018,0.0919504,0.0881683,6.75
1,87,1932,2019,0.1004863,0.0957698,6.36
1,88,1932,2020,0.1097689,0.1039781,5.98
1,89,1932,2021,0.1198550,0.1128903,5.62
1,90,1932,2022,0.1308036,0.1226339,5.27
1,91,1932,2023,0.1426766,0.1332868,4.93
1,92,1932,2024,0.1555375,0.1448335,4.61
1,93,1932,2025,0.1694519,0.1572841,4.31
1,94,1932,2026,0.1844867,0.1707650,4.02
1,95,1932,2027,0.2007091,0.1854407,3.75
1,96,1932,2028,0.2181866,0.2014111,3.49
1,97,1932,2029,0.2369856,0.2186594,3.24
1,98,1932,2030,0.2571705,0.2371969,3.01
1,99,1932,2031,0.2788028,0.2571699,2.79
1,100,1932,2032,0.3019394,0.2787613,2.58
1,101,1932,2033,0.3266317,0.3020720,2.39
1,102,1932,2034,0.3529236,0.3270682,2.21
1,103,1932,2035,0.3808502,0.3537442,2.03
1,104,1932,2036,0.4104359,0.3822323,1.87
1,105,1932,2037,0.4416930,0.4126869,1.72
1,106,1932,2038,0.4746198,0.4451587,1.58
1,107,1932,2039,0.5091990,0.4795581,1.45
1,108,1932,2040,0.5453968,0.5158280,1.33
1,109,1932,2041,0.5831612,0.5540272,1.22
1,110,1932,2042,0.6224217,0.5942063,1.12
1,111,1932,2043,0.6630882,0.6363037,1.02
1,112,1932,2044,0.7050519,0.6801359,0.93
1,113,1932,2045,0.7481851,0.7255448,0.84
1,114,1932,2046,0.7923424,0.7724428,0.73
1,115,1932,2047,1.0000000,1.0000000,0.50
1,67,1933,2000,0.0162315,0.0184221,17.35
1,68,1933,2001,0.0174919,0.0196268,16.67
1,69,1933,2002,0.0188954,0.0209703,15.99
1,70,1933,2003,0.0205786,0.0226235,15.32
1,71,1933,2004,0.0226142,0.0246517,14.66
1,72,1933,2005,0.0250119,0.0270170,14.02
1,73,1933,2006,0.0277519,0.0296905,13.40
1,74,1933,2007,0.0307579,0.0326062,12.79
1,75,1933,2008,0.0339099,0.0356205,12.21
1,76,1933,2009,0.0371478,0.0386204,11.64
1,77,1933,2010,0.0405123,0.0416547,11.09
1,78,1933,2011,0.0440886,0.0448427,10.55
1,79,1933,2012,0.0480027,0.0483357,10.02
1,80,1933,2013,0.0536037,0.0534899,9.50
1,81,1933,2014,0.0586892,0.0580639,9.01
1,82,1933,2015,0.0642414,0.0629849,8.53
1,83,1933,2016,0.0702997,0.0683151,8.07
1,84,1933,2017,0.0769067,0.0741500,7.63
1,85,1933,2018,0.0841076,0.0805476,7.20
1,86,1933,2019,0.0919504,0.0874968,6.79
1,87,1933,2020,0.1004863,0.0950008,6.39
1,88,1933,2021,0.1097689,0.1031522,6.01
1,89,1933,2022,0.1198550,0.1120760,5.64
1,90,1933,2023,0.1308036,0.1218441,5.29
1,91,1933,2024,0.1426766,0.1324396,4.96
1,92,1933,2025,0.1555375,0.1438719,4.64
1,93,1933,2026,0.1694519,0.1562614,4.33
1,94,1933,2027,0.1844867,0.1697665,4.04
1,95,1933,2028,0.2007091,0.1844844,3.76
1,96,1933,2029,0.2181866,0.2004007,3.50
1,97,1933,2030,0.2369856,0.2175280,3.26
1,98,1933,2031,0.2571705,0.2360099,3.02
1,99,1933,2032,0.2788028,0.2560287,2.80
1,100,1933,2033,0.3019394,0.2776887,2.59
1,101,1933,2034,0.3266317,0.3009632,2.40
1,102,1933,2035,0.3529236,0.3258532,2.21
1,103,1933,2036,0.3808502,0.3524982,2.04
1,104,1933,2037,0.4104359,0.3810638,1.88
1,105,1933,2038,0.4416930,0.4116159,1.73
1,106,1933,2039,0.4746198,0.4440806,1.59
1,107,1933,2040,0.5091990,0.4784162,1.46
1,108,1933,2041,0.5453968,0.5147030,1.34
1,109,1933,2042,0.5831612,0.5530199,1.22
1,110,1933,2043,0.6224217,0.5933336,1.12
1,111,1933,2044,0.6630882,0.6354821,1.02
1,112,1933,2045,0.7050519,0.6793280,0.93
1,113,1933,2046,0.7481851,0.7248152,0.84
1,114,1933,2047,0.7923424,0.7718565,0.73
1,115,1933,2048,1.0000000,1.0000000,0.50
1,66,1934,2000,0.0150054,0.0170165,18.11
1,67,1934,2001,0.0162315,0.0181811,17.42
1,68,1934,2002,0.0174919,0.0193871,16.73
1,69,1934,2003,0.0188954,0.0207657,16.05
1,70,1934,2004,0.0205786,0.0224573,15.38
1,71,1934,2005,0.0226142,0.0244817,14.73
1,72,1934,2006,0.0250119,0.0268316,14.08
1,73,1934,2007,0.0277519,0.0294979,13.46
1,74,1934,2008,0.0307579,0.0323722,12.85
1,75,1934,2009,0.0339099,0.0352918,12.26
1,76,1934,2010,0.0371478,0.0382124,11.69
1,77,1934,2011,0.0405123,0.0412112,11.14
1,78,1934,2012,0.0440886,0.0443966,10.60
1,79,1934,2013,0.0480027,0.0478937,10.07
1,80,1934,2014,0.0536037,0.0530225,9.55
1,81,1934,2015,0.0586892,0.0575213,9.05
1,82,1934,2016,0.0642414,0.0623925,8.58
1,83,1934,2017,0.0702997,0.0677213,8.11
1,84,1934,2018,0.0769067,0.0735669,7.67
1,85,1934,2019,0.0841076,0.0799160,7.24
1,86,1934,2020,0.0919504,0.0867713,6.82
1,87,1934,2021,0.1004863,0.0942194,6.42
1,88,1934,2022,0.1097689,0.1023798,6.04
1,89,1934,2023,0.1198550,0.1113252,5.67
1,90,1934,2024,0.1308036,0.1210372,5.32
1,91,1934,2025,0.1426766,0.1315217,4.98
1,92,1934,2026,0.1555375,0.1428934,4.66
1,93,1934,2027,0.1694519,0.1553037,4.35
1,94,1934,2028,0.1844867,0.1688467,4.06
1,95,1934,2029,0.2007091,0.1835096,3.78
1,96,1934,2030,0.2181866,0.1993055,3.52
1,97,1934,2031,0.2369856,0.2163748,3.27
1,98,1934,2032,0.2571705,0.2348969,3.03
1,99,1934,2033,0.2788028,0.2549780,2.81
1,100,1934,2034,0.3019394,0.2765972,2.60
1,101,1934,2035,0.3266317,0.2997609,2.40
1,102,1934,2036,0.3529236,0.3246129,2.22
1,103,1934,2037,0.3808502,0.3513274,2.05
1,104,1934,2038,0.4104359,0.3799829,1.88
1,105,1934,2039,0.4416930,0.4105189,1.73
1,106,1934,2040,0.4746198,0.4429080,1.59
1,107,1934,2041,0.5091990,0.4772488,1.46
1,108,1934,2042,0.5453968,0.5136453,1.34
1,109,1934,2043,0.5831612,0.5520906,1.23
1,110,1934,2044,0.6224217,0.5924440,1.12
1,111,1934,2045,0.6630882,0.6345893,1.02
1,112,1934,2046,0.7050519,0.6785012,0.93
1,113,1934,2047,0.7481851,0.7241282,0.84
1,114,1934,2048,0.7923424,0.7713127,0.73
1,115,1934,2049,1.0000000,1.0000000,0.50
1,65,1935,2000,0.0138071,0.0156637,18.90
1,66,1935,2001,0.0150054,0.0167953,18.19
1,67,1935,2002,0.0162315,0.0179624,17.49
1,68,1935,2003,0.0174919,0.0192003,16.80
1,69,1935,2004,0.0188954,0.0206137,16.12
1,70,1935,2005,0.0205786,0.0223005,15.45
1,71,1935,2006,0.0226142,0.0243088,14.79
1,72,1935,2007,0.0250119,0.0266505,14.15
1,73,1935,2008,0.0277519,0.0292766,13.52
1,74,1935,2009,0.0307579,0.0320618,12.91
1,75,1935,2010,0.0339099,0.0349088,12.32
1,76,1935,2011,0.0371478,0.0377990,11.75
1,77,1935,2012,0.0405123,0.0407977,11.19
1,78,1935,2013,0.0440886,0.0439878,10.65
1,79,1935,2014,0.0480027,0.0474457,10.11
1,80,1935,2015,0.0536037,0.0525183,9.59
1,81,1935,2016,0.0586892,0.0569708,9.10
1,82,1935,2017,0.0642414,0.0618396,8.62
1,83,1935,2018,0.0702997,0.0671763,8.15
1,84,1935,2019,0.0769067,0.0729748,7.70
1,85,1935,2020,0.0841076,0.0792339,7.27
1,86,1935,2021,0.0919504,0.0860345,6.85
1,87,1935,2022,0.1004863,0.0934888,6.45
1,88,1935,2023,0.1097689,0.1016677,6.06
1,89,1935,2024,0.1198550,0.1105583,5.69
1,90,1935,2025,0.1308036,0.1201631,5.34
1,91,1935,2026,0.1426766,0.1305881,5.00
1,92,1935,2027,0.1555375,0.1419774,4.68
1,93,1935,2028,0.1694519,0.1544217,4.37
1,94,1935,2029,0.1844867,0.1679094,4.07
1,95,1935,2030,0.2007091,0.1824534,3.80
1,96,1935,2031,0.2181866,0.1981898,3.53
1,97,1935,2032,0.2369856,0.2152940,3.28
1,98,1935,2033,0.2571705,0.2338725,3.04
1,99,1935,2034,0.2788028,0.2539092,2.82
1,100,1935,2035,0.3019394,0.2754141,2.61
1,101,1935,2036,0.3266317,0.2985339,2.41
1,102,1935,2037,0.3529236,0.3234480,2.23
1,103,1935,2038,0.3808502,0.3502448,2.05
1,104,1935,2039,0.4104359,0.3788761,1.89
1,105,1935,2040,0.4416930,0.4093262,1.74
1,106,1935,2041,0.4746198,0.4417096,1.60
1,107,1935,2042,0.5091990,0.4761516,1.47
1,108,1935,2043,0.5453968,0.5126696,1.34
1,109,1935,2044,0.5831612,0.5511434,1.23
1,110,1935,2045,0.6224217,0.5914775,1.12
1,111,1935,2046,0.6630882,0.6336759,1.02
1,112,1935,2047,0.7050519,0.6777226,0.93
1,113,1935,2048,0.7481851,0.7234910,0.84
1,114,1935,2049,0.7923424,0.7707539,0.73
1,115,1935,2050,1.0000000,1.0000000,0.50
1,64,1936,2000,0.0126957,0.0144067,19.69
1,65,1936,2001,0.0138071,0.0154595,18.97
1,66,1936,2002,0.0150054,0.0165946,18.26
1,67,1936,2003,0.0162315,0.0177919,17.56
1,68,1936,2004,0.0174919,0.0190616,16.87
1,69,1936,2005,0.0188954,0.0204702,16.19
1,70,1936,2006,0.0205786,0.0221410,15.52
1,71,1936,2007,0.0226142,0.0241400,14.86
1,72,1936,2008,0.0250119,0.0264426,14.21
1,73,1936,2009,0.0277519,0.0289832,13.58
1,74,1936,2010,0.0307579,0.0317002,12.97
1,75,1936,2011,0.0339099,0.0345208,12.38
1,76,1936,2012,0.0371478,0.0374137,11.81
1,77,1936,2013,0.0405123,0.0404189,11.25
1,78,1936,2014,0.0440886,0.0435737,10.70
1,79,1936,2015,0.0480027,0.0469629,10.16
1,80,1936,2016,0.0536037,0.0520069,9.64
1,81,1936,2017,0.0586892,0.0564571,9.14
1,82,1936,2018,0.0642414,0.0613321,8.66
1,83,1936,2019,0.0702997,0.0666229,8.19
1,84,1936,2020,0.0769067,0.0723355,7.74
1,85,1936,2021,0.0841076,0.0785413,7.31
1,86,1936,2022,0.0919504,0.0853457,6.89
1,87,1936,2023,0.1004863,0.0928155,6.48
1,88,1936,2024,0.1097689,0.1009406,6.09
1,89,1936,2025,0.1198550,0.1097279,5.72
1,90,1936,2026,0.1308036,0.1192743,5.36
1,91,1936,2027,0.1426766,0.1297143,5.02
1,92,1936,2028,0.1555375,0.1411341,4.70
1,93,1936,2029,0.1694519,0.1535232,4.39
1,94,1936,2030,0.1844867,0.1668941,4.09
1,95,1936,2031,0.2007091,0.1813776,3.81
1,96,1936,2032,0.2181866,0.1971442,3.55
1,97,1936,2033,0.2369856,0.2142995,3.29
1,98,1936,2034,0.2571705,0.2328306,3.06
1,99,1936,2035,0.2788028,0.2527509,2.83
1,100,1936,2036,0.3019394,0.2742072,2.62
1,101,1936,2037,0.3266317,0.2973818,2.42
1,102,1936,2038,0.3529236,0.3223710,2.23
1,103,1936,2039,0.3808502,0.3491366,2.06
1,104,1936,2040,0.4104359,0.3776731,1.90
1,105,1936,2041,0.4416930,0.4081076,1.74
1,106,1936,2042,0.4746198,0.4405835,1.60
1,107,1936,2043,0.5091990,0.4751397,1.47
1,108,1936,2044,0.5453968,0.5116753,1.35
1,109,1936,2045,0.5831612,0.5501145,1.23
1,110,1936,2046,0.6224217,0.5904888,1.13
1,111,1936,2047,0.6630882,0.6328160,1.03
1,112,1936,2048,0.7050519,0.6770005,0.93
1,113,1936,2049,0.7481851,0.7228364,0.84
1,114,1936,2050,0.7923424,0.7701451,0.73
1,115,1936,2051,1.0000000,1.0000000,0.50
1,63,1937,2000,0.0116995,0.0132743,20.50
1,64,1937,2001,0.0126957,0.0142185,19.77
1,65,1937,2002,0.0138071,0.0152741,19.05
1,66,1937,2003,0.0150054,0.0164381,18.33
1,67,1937,2004,0.0162315,0.0176652,17.63
1,68,1937,2005,0.0174919,0.0189306,16.94
1,69,1937,2006,0.0188954,0.0203244,16.26
1,70,1937,2007,0.0205786,0.0219853,15.58
1,71,1937,2008,0.0226142,0.0239463,14.92
1,72,1937,2009,0.0250119,0.0261670,14.28
1,73,1937,2010,0.0277519,0.0286415,13.65
1,74,1937,2011,0.0307579,0.0313340,13.04
1,75,1937,2012,0.0339099,0.0341593,12.44
1,76,1937,2013,0.0371478,0.0370608,11.86
1,77,1937,2014,0.0405123,0.0400352,11.30
1,78,1937,2015,0.0440886,0.0431273,10.75
1,79,1937,2016,0.0480027,0.0464736,10.21
1,80,1937,2017,0.0536037,0.0515297,9.69
1,81,1937,2018,0.0586892,0.0559857,9.19
1,82,1937,2019,0.0642414,0.0608170,8.70
1,83,1937,2020,0.0702997,0.0660256,8.23
1,84,1937,2021,0.0769067,0.0716865,7.78
1,85,1937,2022,0.0841076,0.0778940,7.34
1,86,1937,2023,0.0919504,0.0847110,6.92
1,87,1937,2024,0.1004863,0.0921281,6.51
1,88,1937,2025,0.1097689,0.1001534,6.12
1,89,1937,2026,0.1198550,0.1088837,5.75
1,90,1937,2027,0.1308036,0.1184428,5.39
1,91,1937,2028,0.1426766,0.1289101,5.05
1,92,1937,2029,0.1555375,0.1402753,4.72
1,93,1937,2030,0.1694519,0.1525503,4.41
1,94,1937,2031,0.1844867,0.1658604,4.11
1,95,1937,2032,0.2007091,0.1803699,3.83
1,96,1937,2033,0.2181866,0.1961825,3.56
1,97,1937,2034,0.2369856,0.2132883,3.31
1,98,1937,2035,0.2571705,0.2317020,3.07
1,99,1937,2036,0.2788028,0.2515697,2.84
1,100,1937,2037,0.3019394,0.2730742,2.63
1,101,1937,2038,0.3266317,0.2963170,2.43
1,102,1937,2039,0.3529236,0.3212688,2.24
1,103,1937,2040,0.3808502,0.3479322,2.07
1,104,1937,2041,0.4104359,0.3764443,1.90
1,105,1937,2042,0.4416930,0.4069628,1.75
1,106,1937,2043,0.4746198,0.4395452,1.61
1,107,1937,2044,0.5091990,0.4741087,1.47
1,108,1937,2045,0.5453968,0.5105954,1.35
1,109,1937,2046,0.5831612,0.5490623,1.23
1,110,1937,2047,0.6224217,0.5895581,1.13
1,111,1937,2048,0.6630882,0.6320185,1.03
1,112,1937,2049,0.7050519,0.6762590,0.93
1,113,1937,2050,0.7481851,0.7221231,0.84
1,114,1937,2051,0.7923424,0.7695218,0.73
1,115,1937,2052,1.0000000,1.0000000,0.50
1,62,1938,2000,0.0107829,0.0122250,21.32
1,63,1938,2001,0.0116995,0.0131010,20.58
1,64,1938,2002,0.0126957,0.0140476,19.85
1,65,1938,2003,0.0138071,0.0151296,19.12
1,66,1938,2004,0.0150054,0.0163218,18.41
1,67,1938,2005,0.0162315,0.0175457,17.71
1,68,1938,2006,0.0174919,0.0187974,17.01
1,69,1938,2007,0.0188954,0.0201820,16.33
1,70,1938,2008,0.0205786,0.0218066,15.65
1,71,1938,2009,0.0226142,0.0236895,14.99
1,72,1938,2010,0.0250119,0.0258462,14.34
1,73,1938,2011,0.0277519,0.0282957,13.71
1,74,1938,2012,0.0307579,0.0309930,13.10
1,75,1938,2013,0.0339099,0.0338282,12.50
1,76,1938,2014,0.0371478,0.0367033,11.92
1,77,1938,2015,0.0405123,0.0396216,11.35
1,78,1938,2016,0.0440886,0.0426749,10.80
1,79,1938,2017,0.0480027,0.0460172,10.26
1,80,1938,2018,0.0536037,0.0510919,9.73
1,81,1938,2019,0.0586892,0.0555073,9.23
1,82,1938,2020,0.0642414,0.0602611,8.74
1,83,1938,2021,0.0702997,0.0654194,8.27
1,84,1938,2022,0.0769067,0.0710801,7.82
1,85,1938,2023,0.0841076,0.0772977,7.37
1,86,1938,2024,0.0919504,0.0840634,6.95
1,87,1938,2025,0.1004863,0.0913843,6.54
1,88,1938,2026,0.1097689,0.0993535,6.15
1,89,1938,2027,0.1198550,0.1080941,5.77
1,90,1938,2028,0.1308036,0.1176777,5.41
1,91,1938,2029,0.1426766,0.1280913,5.07
1,92,1938,2030,0.1555375,0.1393456,4.74
1,93,1938,2031,0.1694519,0.1515600,4.43
1,94,1938,2032,0.1844867,0.1648923,4.13
1,95,1938,2033,0.2007091,0.1794433,3.84
1,96,1938,2034,0.2181866,0.1952049,3.57
1,97,1938,2035,0.2369856,0.2121932,3.32
1,98,1938,2036,0.2571705,0.2305513,3.08
1,99,1938,2037,0.2788028,0.2504611,2.85
1,100,1938,2038,0.3019394,0.2720273,2.64
1,101,1938,2039,0.3266317,0.2952276,2.44
1,102,1938,2040,0.3529236,0.3200714,2.25
1,103,1938,2041,0.3808502,0.3467025,2.07
1,104,1938,2042,0.4104359,0.3752902,1.91
1,105,1938,2043,0.4416930,0.4059075,1.75
1,106,1938,2044,0.4746198,0.4384876,1.61
1,107,1938,2045,0.5091990,0.4729894,1.48
1,108,1938,2046,0.5453968,0.5094914,1.35
1,109,1938,2047,0.5831612,0.5480719,1.24
1,110,1938,2048,0.6224217,0.5886953,1.13
1,111,1938,2049,0.6630882,0.6311997,1.03
1,112,1938,2050,0.7050519,0.6754510,0.94
1,113,1938,2051,0.7481851,0.7213931,0.84
1,114,1938,2052,0.7923424,0.7689339,0.73
1,115,1938,2053,1.0000000,1.0000000,0.50
1,61,1939,2000,0.0099105,0.0112300,22.16
1,62,1939,2001,0.0107829,0.0120664,21.40
1,63,1939,2002,0.0116995,0.0129438,20.66
1,64,1939,2003,0.0126957,0.0139145,19.92
1,65,1939,2004,0.0138071,0.0150223,19.20
1,66,1939,2005,0.0150054,0.0162121,18.48
1,67,1939,2006,0.0162315,0.0174241,17.78
1,68,1939,2007,0.0174919,0.0186674,17.09
1,69,1939,2008,0.0188954,0.0200186,16.40
1,70,1939,2009,0.0205786,0.0215699,15.73
1,71,1939,2010,0.0226142,0.0233907,15.06
1,72,1939,2011,0.0250119,0.0255218,14.41
1,73,1939,2012,0.0277519,0.0279738,13.78
1,74,1939,2013,0.0307579,0.0306809,13.16
1,75,1939,2014,0.0339099,0.0334930,12.56
1,76,1939,2015,0.0371478,0.0363181,11.98
1,77,1939,2016,0.0405123,0.0392025,11.41
1,78,1939,2017,0.0440886,0.0422531,10.85
1,79,1939,2018,0.0480027,0.0455988,10.31
1,80,1939,2019,0.0536037,0.0506476,9.78
1,81,1939,2020,0.0586892,0.0549911,9.27
1,82,1939,2021,0.0642414,0.0596970,8.78
1,83,1939,2022,0.0702997,0.0648530,8.31
1,84,1939,2023,0.0769067,0.0705217,7.85
1,85,1939,2024,0.0841076,0.0766894,7.41
1,86,1939,2025,0.0919504,0.0833626,6.98
1,87,1939,2026,0.1004863,0.0906286,6.57
1,88,1939,2027,0.1097689,0.0986056,6.18
1,89,1939,2028,0.1198550,0.1073679,5.80
1,90,1939,2029,0.1308036,0.1168990,5.44
1,91,1939,2030,0.1426766,0.1272052,5.09
1,92,1939,2031,0.1555375,0.1383996,4.76
1,93,1939,2032,0.1694519,0.1506330,4.44
1,94,1939,2033,0.1844867,0.1640025,4.14
1,95,1939,2034,0.2007091,0.1785016,3.86
1,96,1939,2035,0.2181866,0.1941466,3.59
1,97,1939,2036,0.2369856,0.2110771,3.33
1,98,1939,2037,0.2571705,0.2294718,3.09
1,99,1939,2038,0.2788028,0.2494372,2.86
1,100,1939,2039,0.3019394,0.2709566,2.65
1,101,1939,2040,0.3266317,0.2940444,2.45
1,102,1939,2041,0.3529236,0.3188491,2.26
1,103,1939,2042,0.3808502,0.3455478,2.08
1,104,1939,2043,0.4104359,0.3742266,1.91
1,105,1939,2044,0.4416930,0.4048328,1.76
1,106,1939,2045,0.4746198,0.4373396,1.61
1,107,1939,2046,0.5091990,0.4718451,1.48
1,108,1939,2047,0.5453968,0.5084526,1.35
1,109,1939,2048,0.5831612,0.5471539,1.24
1,110,1939,2049,0.6224217,0.5878094,1.13
1,111,1939,2050,0.6630882,0.6303076,1.03
1,112,1939,2051,0.7050519,0.6746243,0.94
1,113,1939,2052,0.7481851,0.7207047,0.84
1,114,1939,2053,0.7923424,0.7683845,0.73
1,115,1939,2054,1.0000000,1.0000000,0.50
1,60,1940,2000,0.0090849,0.0102973,23.01
1,61,1940,2001,0.0099105,0.0110849,22.24
1,62,1940,2002,0.0107829,0.0119225,21.49
1,63,1940,2003,0.0116995,0.0128213,20.74
1,64,1940,2004,0.0126957,0.0138155,20.00
1,65,1940,2005,0.0138071,0.0149209,19.28
1,66,1940,2006,0.0150054,0.0161004,18.56
1,67,1940,2007,0.0162315,0.0173054,17.86
1,68,1940,2008,0.0174919,0.0185181,17.16
1,69,1940,2009,0.0188954,0.0198020,16.48
1,70,1940,2010,0.0205786,0.0212944,15.80
1,71,1940,2011,0.0226142,0.0230886,15.13
1,72,1940,2012,0.0250119,0.0252199,14.48
1,73,1940,2013,0.0277519,0.0276793,13.84
1,74,1940,2014,0.0307579,0.0303650,13.22
1,75,1940,2015,0.0339099,0.0331319,12.62
1,76,1940,2016,0.0371478,0.0359278,12.03
1,77,1940,2017,0.0405123,0.0388117,11.46
1,78,1940,2018,0.0440886,0.0418664,10.90
1,79,1940,2019,0.0480027,0.0451746,10.36
1,80,1940,2020,0.0536037,0.0501684,9.83
1,81,1940,2021,0.0586892,0.0544673,9.32
1,82,1940,2022,0.0642414,0.0591701,8.83
1,83,1940,2023,0.0702997,0.0643316,8.35
1,84,1940,2024,0.0769067,0.0699521,7.89
1,85,1940,2025,0.0841076,0.0760314,7.45
1,86,1940,2026,0.0919504,0.0826510,7.02
1,87,1940,2027,0.1004863,0.0899222,6.60
1,88,1940,2028,0.1097689,0.0979179,6.21
1,89,1940,2029,0.1198550,0.1066289,5.83
1,90,1940,2030,0.1308036,0.1160565,5.46
1,91,1940,2031,0.1426766,0.1263038,5.11
1,92,1940,2032,0.1555375,0.1375143,4.78
1,93,1940,2033,0.1694519,0.1497810,4.46
1,94,1940,2034,0.1844867,0.1630984,4.16
1,95,1940,2035,0.2007091,0.1774825,3.88
1,96,1940,2036,0.2181866,0.1930683,3.60
1,97,1940,2037,0.2369856,0.2100303,3.35
1,98,1940,2038,0.2571705,0.2284750,3.10
1,99,1940,2039,0.2788028,0.2483902,2.87
1,100,1940,2040,0.3019394,0.2697940,2.66
1,101,1940,2041,0.3266317,0.2928370,2.45
1,102,1940,2042,0.3529236,0.3177017,2.26
1,103,1940,2043,0.3808502,0.3444840,2.09
1,104,1940,2044,0.4104359,0.3731438,1.92
1,105,1940,2045,0.4416930,0.4036666,1.76
1,106,1940,2046,0.4746198,0.4361664,1.62
1,107,1940,2047,0.5091990,0.4707687,1.48
1,108,1940,2048,0.5453968,0.5074899,1.36
1,109,1940,2049,0.5831612,0.5462117,1.24
1,110,1940,2050,0.6224217,0.5868446,1.13
1,111,1940,2051,0.6630882,0.6293949,1.03
1,112,1940,2052,0.7050519,0.6738447,0.94
1,113,1940,2053,0.7481851,0.7200613,0.84
1,114,1940,2054,0.7923424,0.7678136,0.73
1,115,1940,2055,1.0000000,1.0000000,0.50
1,59,1941,2000,0.0083035,0.0094244,23.87
1,60,1941,2001,0.0090849,0.0101639,23.10
1,61,1941,2002,0.0099105,0.0109532,22.33
1,62,1941,2003,0.0107829,0.0118102,21.57
1,63,1941,2004,0.0116995,0.0127302,20.82
1,64,1941,2005,0.0126957,0.0137221,20.08
1,65,1941,2006,0.0138071,0.0148179,19.36
1,66,1941,2007,0.0150054,0.0159915,18.64
1,67,1941,2008,0.0162315,0.0171691,17.93
1,68,1941,2009,0.0174919,0.0183203,17.24
1,69,1941,2010,0.0188954,0.0195501,16.55
1,70,1941,2011,0.0205786,0.0210159,15.87
1,71,1941,2012,0.0226142,0.0228077,15.20
1,72,1941,2013,0.0250119,0.0249438,14.54
1,73,1941,2014,0.0277519,0.0273814,13.90
1,74,1941,2015,0.0307579,0.0300248,13.28
1,75,1941,2016,0.0339099,0.0327661,12.68
1,76,1941,2017,0.0371478,0.0355640,12.09
1,77,1941,2018,0.0405123,0.0384535,11.52
1,78,1941,2019,0.0440886,0.0414743,10.96
1,79,1941,2020,0.0480027,0.0447171,10.41
1,80,1941,2021,0.0536037,0.0496822,9.87
1,81,1941,2022,0.0586892,0.0539782,9.36
1,82,1941,2023,0.0642414,0.0586851,8.87
1,83,1941,2024,0.0702997,0.0637999,8.39
1,84,1941,2025,0.0769067,0.0693361,7.93
1,85,1941,2026,0.0841076,0.0753632,7.48
1,86,1941,2027,0.0919504,0.0819859,7.05
1,87,1941,2028,0.1004863,0.0892729,6.63
1,88,1941,2029,0.1097689,0.0972183,6.24
1,89,1941,2030,0.1198550,0.1058297,5.85
1,90,1941,2031,0.1308036,0.1151998,5.49
1,91,1941,2032,0.1426766,0.1254606,5.14
1,92,1941,2033,0.1555375,0.1367009,4.80
1,93,1941,2034,0.1694519,0.1489157,4.48
1,94,1941,2035,0.1844867,0.1621203,4.18
1,95,1941,2036,0.2007091,0.1764444,3.89
1,96,1941,2037,0.2181866,0.1920573,3.62
1,97,1941,2038,0.2369856,0.2090640,3.36
1,98,1941,2039,0.2571705,0.2274560,3.11
1,99,1941,2040,0.2788028,0.2472537,2.88
1,100,1941,2041,0.3019394,0.2686080,2.67
1,101,1941,2042,0.3266317,0.2917040,2.46
1,102,1941,2043,0.3529236,0.3166449,2.27
1,103,1941,2044,0.3808502,0.3434013,2.09
1,104,1941,2045,0.4104359,0.3719690,1.92
1,105,1941,2046,0.4416930,0.4024751,1.77
1,106,1941,2047,0.4746198,0.4350631,1.62
1,107,1941,2048,0.5091990,0.4697714,1.49
1,108,1941,2049,0.5453968,0.5065019,1.36
1,109,1941,2050,0.5831612,0.5451856,1.24
1,110,1941,2051,0.6224217,0.5858576,1.14
1,111,1941,2052,0.6630882,0.6285346,1.03
1,112,1941,2053,0.7050519,0.6731163,0.94
1,113,1941,2054,0.7481851,0.7193929,0.85
1,114,1941,2055,0.7923424,0.7671890,0.73
1,115,1941,2056,1.0000000,1.0000000,0.50
1,58,1942,2000,0.0075521,0.0085972,24.75
1,59,1942,2001,0.0083035,0.0093011,23.96
1,60,1942,2002,0.0090849,0.0100429,23.18
1,61,1942,2003,0.0099105,0.0108506,22.41
1,62,1942,2004,0.0107829,0.0117269,21.65
1,63,1942,2005,0.0116995,0.0126442,20.90
1,64,1942,2006,0.0126957,0.0136272,20.16
1,65,1942,2007,0.0138071,0.0147173,19.44
1,66,1942,2008,0.0150054,0.0158663,18.72
1,67,1942,2009,0.0162315,0.0169884,18.01
1,68,1942,2010,0.0174919,0.0180902,17.31
1,69,1942,2011,0.0188954,0.0192954,16.62
1,70,1942,2012,0.0205786,0.0207570,15.94
1,71,1942,2013,0.0226142,0.0225509,15.27
1,72,1942,2014,0.0250119,0.0246647,14.61
1,73,1942,2015,0.0277519,0.0270607,13.97
1,74,1942,2016,0.0307579,0.0296804,13.34
1,75,1942,2017,0.0339099,0.0324253,12.73
1,76,1942,2018,0.0371478,0.0352306,12.14
1,77,1942,2019,0.0405123,0.0380904,11.57
1,78,1942,2020,0.0440886,0.0410515,11.01
1,79,1942,2021,0.0480027,0.0442534,10.46
1,80,1942,2022,0.0536037,0.0492283,9.92
1,81,1942,2023,0.0586892,0.0535281,9.41
1,82,1942,2024,0.0642414,0.0581906,8.91
1,83,1942,2025,0.0702997,0.0632250,8.43
1,84,1942,2026,0.0769067,0.0687108,7.96
1,85,1942,2027,0.0841076,0.0747391,7.52
1,86,1942,2028,0.0919504,0.0813748,7.08
1,87,1942,2029,0.1004863,0.0886125,6.67
1,88,1942,2030,0.1097689,0.0964619,6.26
1,89,1942,2031,0.1198550,0.1050173,5.88
1,90,1942,2032,0.1308036,0.1143986,5.51
1,91,1942,2033,0.1426766,0.1246861,5.16
1,92,1942,2034,0.1555375,0.1358751,4.82
1,93,1942,2035,0.1694519,0.1479798,4.50
1,94,1942,2036,0.1844867,0.1611243,4.20
1,95,1942,2037,0.2007091,0.1754715,3.91
1,96,1942,2038,0.2181866,0.1911242,3.63
1,97,1942,2039,0.2369856,0.2080765,3.37
1,98,1942,2040,0.2571705,0.2263501,3.13
1,99,1942,2041,0.2788028,0.2460946,2.89
1,100,1942,2042,0.3019394,0.2674953,2.68
1,101,1942,2043,0.3266317,0.2906606,2.47
1,102,1942,2044,0.3529236,0.3155696,2.28
1,103,1942,2045,0.3808502,0.3422269,2.10
1,104,1942,2046,0.4104359,0.3707691,1.93
1,105,1942,2047,0.4416930,0.4013548,1.77
1,106,1942,2048,0.4746198,0.4340411,1.63
1,107,1942,2049,0.5091990,0.4687482,1.49
1,108,1942,2050,0.5453968,0.5054262,1.36
1,109,1942,2051,0.5831612,0.5441363,1.25
1,110,1942,2052,0.6224217,0.5849274,1.14
1,111,1942,2053,0.6630882,0.6277308,1.04
1,112,1942,2054,0.7050519,0.6723596,0.94
1,113,1942,2055,0.7481851,0.7186617,0.85
1,114,1942,2056,0.7923424,0.7665497,0.73
1,115,1942,2057,1.0000000,1.0000000,0.50
1,57,1943,2000,0.0068502,0.0078274,25.64
1,58,1943,2001,0.0075521,0.0084820,24.84
1,59,1943,2002,0.0083035,0.0091891,24.05
1,60,1943,2003,0.0090849,0.0099486,23.27
1,61,1943,2004,0.0099105,0.0107743,22.50
1,62,1943,2005,0.0107829,0.0116481,21.74
1,63,1943,2006,0.0116995,0.0125568,20.99
1,64,1943,2007,0.0126957,0.0135345,20.25
1,65,1943,2008,0.0138071,0.0146018,19.52
1,66,1943,2009,0.0150054,0.0157005,18.80
1,67,1943,2010,0.0162315,0.0167782,18.09
1,68,1943,2011,0.0174919,0.0178574,17.39
1,69,1943,2012,0.0188954,0.0190585,16.70
1,70,1943,2013,0.0205786,0.0205203,16.01
1,71,1943,2014,0.0226142,0.0222912,15.34
1,72,1943,2015,0.0250119,0.0243643,14.68
1,73,1943,2016,0.0277519,0.0267363,14.03
1,74,1943,2017,0.0307579,0.0293595,13.40
1,75,1943,2018,0.0339099,0.0321130,12.79
1,76,1943,2019,0.0371478,0.0348926,12.20
1,77,1943,2020,0.0405123,0.0376989,11.62
1,78,1943,2021,0.0440886,0.0406230,11.06
1,79,1943,2022,0.0480027,0.0438208,10.51
1,80,1943,2023,0.0536037,0.0488106,9.96
1,81,1943,2024,0.0586892,0.0530692,9.45
1,82,1943,2025,0.0642414,0.0576561,8.95
1,83,1943,2026,0.0702997,0.0626415,8.47
1,84,1943,2027,0.0769067,0.0681269,8.00
1,85,1943,2028,0.0841076,0.0741656,7.55
1,86,1943,2029,0.0919504,0.0807533,7.11
1,87,1943,2030,0.1004863,0.0878987,6.70
1,88,1943,2031,0.1097689,0.0956932,6.29
1,89,1943,2032,0.1198550,0.1042577,5.91
1,90,1943,2033,0.1308036,0.1136629,5.54
1,91,1943,2034,0.1426766,0.1239000,5.18
1,92,1943,2035,0.1555375,0.1349821,4.84
1,93,1943,2036,0.1694519,0.1470271,4.52
1,94,1943,2037,0.1844867,0.1601911,4.21
1,95,1943,2038,0.2007091,0.1745738,3.92
1,96,1943,2039,0.2181866,0.1901710,3.65
1,97,1943,2040,0.2369856,0.2070052,3.38
1,98,1943,2041,0.2571705,0.2252228,3.14
1,99,1943,2042,0.2788028,0.2450077,2.90
1,100,1943,2043,0.3019394,0.2664711,2.69
1,101,1943,2044,0.3266317,0.2895993,2.48
1,102,1943,2045,0.3529236,0.3144036,2.29
1,103,1943,2046,0.3808502,0.3410278,2.11
1,104,1943,2047,0.4104359,0.3696413,1.94
1,105,1943,2048,0.4416930,0.4003174,1.78
1,106,1943,2049,0.4746198,0.4329927,1.63
1,107,1943,2050,0.5091990,0.4676344,1.49
1,108,1943,2051,0.5453968,0.5043265,1.37
1,109,1943,2052,0.5831612,0.5431475,1.25
1,110,1943,2053,0.6224217,0.5840585,1.14
1,111,1943,2054,0.6630882,0.6268960,1.04
1,112,1943,2055,0.7050519,0.6715320,0.94
1,113,1943,2056,0.7481851,0.7179134,0.85
1,114,1943,2057,0.7923424,0.7659478,0.73
1,115,1943,2058,1.0000000,1.0000000,0.50
1,56,1944,2000,0.0062406,0.0071482,26.55
1,57,1944,2001,0.0068502,0.0077196,25.73
1,58,1944,2002,0.0075521,0.0083776,24.93
1,59,1944,2003,0.0083035,0.0091019,24.14
1,60,1944,2004,0.0090849,0.0098785,23.35
1,61,1944,2005,0.0099105,0.0107023,22.58
1,62,1944,2006,0.0107829,0.0115681,21.82
1,63,1944,2007,0.0116995,0.0124715,21.07
1,64,1944,2008,0.0126957,0.0134280,20.33
1,65,1944,2009,0.0138071,0.0144487,19.60
1,66,1944,2010,0.0150054,0.0155074,18.88
1,67,1944,2011,0.0162315,0.0165656,18.17
1,68,1944,2012,0.0174919,0.0176410,17.47
1,69,1944,2013,0.0188954,0.0188420,16.77
1,70,1944,2014,0.0205786,0.0202811,16.08
1,71,1944,2015,0.0226142,0.0220120,15.41
1,72,1944,2016,0.0250119,0.0240606,14.74
1,73,1944,2017,0.0277519,0.0264342,14.09
1,74,1944,2018,0.0307579,0.0290657,13.46
1,75,1944,2019,0.0339099,0.0317965,12.85
1,76,1944,2020,0.0371478,0.0345283,12.26
1,77,1944,2021,0.0405123,0.0373021,11.68
1,78,1944,2022,0.0440886,0.0402233,11.11
1,79,1944,2023,0.0480027,0.0434230,10.55
1,80,1944,2024,0.0536037,0.0483849,10.01
1,81,1944,2025,0.0586892,0.0525733,9.49
1,82,1944,2026,0.0642414,0.0571137,8.99
1,83,1944,2027,0.0702997,0.0620968,8.51
1,84,1944,2028,0.0769067,0.0675904,8.04
1,85,1944,2029,0.0841076,0.0735827,7.59
1,86,1944,2030,0.0919504,0.0800819,7.15
1,87,1944,2031,0.1004863,0.0871735,6.73
1,88,1944,2032,0.1097689,0.0949747,6.32
1,89,1944,2033,0.1198550,0.1035604,5.93
1,90,1944,2034,0.1308036,0.1129164,5.56
1,91,1944,2035,0.1426766,0.1230502,5.20
1,92,1944,2036,0.1555375,0.1340734,4.86
1,93,1944,2037,0.1694519,0.1461347,4.54
1,94,1944,2038,0.1844867,0.1593303,4.23
1,95,1944,2039,0.2007091,0.1736570,3.94
1,96,1944,2040,0.2181866,0.1891372,3.66
1,97,1944,2041,0.2369856,0.2059133,3.40
1,98,1944,2042,0.2571705,0.2241659,3.15
1,99,1944,2043,0.2788028,0.2440073,2.92
1,100,1944,2044,0.3019394,0.2654295,2.69
1,101,1944,2045,0.3266317,0.2884488,2.49
1,102,1944,2046,0.3529236,0.3132134,2.29
1,103,1944,2047,0.3808502,0.3399009,2.11
1,104,1944,2048,0.4104359,0.3685972,1.94
1,105,1944,2049,0.4416930,0.3992534,1.78
1,106,1944,2050,0.4746198,0.4318519,1.63
1,107,1944,2051,0.5091990,0.4664960,1.50
1,108,1944,2052,0.5453968,0.5032904,1.37
1,109,1944,2053,0.5831612,0.5422240,1.25
1,110,1944,2054,0.6224217,0.5831563,1.14
1,111,1944,2055,0.6630882,0.6259831,1.04
1,112,1944,2056,0.7050519,0.6706852,0.94
1,113,1944,2057,0.7481851,0.7172090,0.85
1,114,1944,2058,0.7923424,0.7653915,0.73
1,115,1944,2059,1.0000000,1.0000000,0.50
1,55,1945,2000,0.0057365,0.0065752,27.46
1,56,1945,2001,0.0062406,0.0070479,26.64
1,57,1945,2002,0.0068502,0.0076218,25.83
1,58,1945,2003,0.0075521,0.0082961,25.02
1,59,1945,2004,0.0083035,0.0090370,24.23
1,60,1945,2005,0.0090849,0.0098123,23.44
1,61,1945,2006,0.0099105,0.0106290,22.67
1,62,1945,2007,0.0107829,0.0114899,21.91
1,63,1945,2008,0.0116995,0.0123735,21.16
1,64,1945,2009,0.0126957,0.0132869,20.42
1,65,1945,2010,0.0138071,0.0142704,19.68
1,66,1945,2011,0.0150054,0.0153122,18.96
1,67,1945,2012,0.0162315,0.0163678,18.25
1,68,1945,2013,0.0174919,0.0174431,17.54
1,69,1945,2014,0.0188954,0.0186232,16.85
1,70,1945,2015,0.0205786,0.0200239,16.16
1,71,1945,2016,0.0226142,0.0217297,15.48
1,72,1945,2017,0.0250119,0.0237780,14.81
1,73,1945,2018,0.0277519,0.0261577,14.16
1,74,1945,2019,0.0307579,0.0287680,13.52
1,75,1945,2020,0.0339099,0.0314555,12.91
1,76,1945,2021,0.0371478,0.0341591,12.31
1,77,1945,2022,0.0405123,0.0369320,11.73
1,78,1945,2023,0.0440886,0.0398557,11.16
1,79,1945,2024,0.0480027,0.0430177,10.60
1,80,1945,2025,0.0536037,0.0479249,10.06
1,81,1945,2026,0.0586892,0.0520702,9.54
1,82,1945,2027,0.0642414,0.0566073,9.04
1,83,1945,2028,0.0702997,0.0615964,8.55
1,84,1945,2029,0.0769067,0.0670453,8.08
1,85,1945,2030,0.0841076,0.0729530,7.62
1,86,1945,2031,0.0919504,0.0793999,7.18
1,87,1945,2032,0.1004863,0.0864960,6.76
1,88,1945,2033,0.1097689,0.0943154,6.35
1,89,1945,2034,0.1198550,0.1028531,5.96
1,90,1945,2035,0.1308036,0.1121096,5.58
1,91,1945,2036,0.1426766,0.1221857,5.23
1,92,1945,2037,0.1555375,0.1332226,4.88
1,93,1945,2038,0.1694519,0.1453119,4.56
1,94,1945,2039,0.1844867,0.1584515,4.25
1,95,1945,2040,0.2007091,0.1726630,3.95
1,96,1945,2041,0.2181866,0.1880839,3.68
1,97,1945,2042,0.2369856,0.2048900,3.41
1,98,1945,2043,0.2571705,0.2231935,3.16
1,99,1945,2044,0.2788028,0.2429903,2.93
1,100,1945,2045,0.3019394,0.2643007,2.70
1,101,1945,2046,0.3266317,0.2872748,2.50
1,102,1945,2047,0.3529236,0.3120953,2.30
1,103,1945,2048,0.3808502,0.3388580,2.12
1,104,1945,2049,0.4104359,0.3675266,1.95
1,105,1945,2050,0.4416930,0.3980960,1.79
1,106,1945,2051,0.4746198,0.4306861,1.64
1,107,1945,2052,0.5091990,0.4654238,1.50
1,108,1945,2053,0.5453968,0.5023230,1.37
1,109,1945,2054,0.5831612,0.5412654,1.25
1,110,1945,2055,0.6224217,0.5821698,1.14
1,111,1945,2056,0.6630882,0.6250491,1.04
1,112,1945,2057,0.7050519,0.6698881,0.95
1,113,1945,2058,0.7481851,0.7165580,0.85
1,114,1945,2059,0.7923424,0.7648230,0.74
1,115,1945,2060,1.0000000,1.0000000,0.50
1,54,1946,2000,0.0053157,0.0060836,28.39
1,55,1946,2001,0.0057365,0.0064825,27.56
1,56,1946,2002,0.0062406,0.0069570,26.73
1,57,1946,2003,0.0068502,0.0075456,25.92
1,58,1946,2004,0.0075521,0.0082357,25.11
1,59,1946,2005,0.0083035,0.0089758,24.32
1,60,1946,2006,0.0090849,0.0097450,23.53
1,61,1946,2007,0.0099105,0.0105575,22.76
1,62,1946,2008,0.0107829,0.0114002,22.00
1,63,1946,2009,0.0116995,0.0122436,21.24
1,64,1946,2010,0.0126957,0.0131227,20.50
1,65,1946,2011,0.0138071,0.0140902,19.77
1,66,1946,2012,0.0150054,0.0151306,19.04
1,67,1946,2013,0.0162315,0.0161870,18.33
1,68,1946,2014,0.0174919,0.0172431,17.62
1,69,1946,2015,0.0188954,0.0183879,16.92
1,70,1946,2016,0.0205786,0.0197638,16.23
1,71,1946,2017,0.0226142,0.0214671,15.54
1,72,1946,2018,0.0250119,0.0235193,14.87
1,73,1946,2019,0.0277519,0.0258777,14.22
1,74,1946,2020,0.0307579,0.0284474,13.59
1,75,1946,2021,0.0339099,0.0311100,12.97
1,76,1946,2022,0.0371478,0.0338149,12.37
1,77,1946,2023,0.0405123,0.0365917,11.78
1,78,1946,2024,0.0440886,0.0394813,11.21
1,79,1946,2025,0.0480027,0.0425801,10.65
1,80,1946,2026,0.0536037,0.0474583,10.10
1,81,1946,2027,0.0586892,0.0516005,9.58
1,82,1946,2028,0.0642414,0.0561424,9.08
1,83,1946,2029,0.0702997,0.0610881,8.59
1,84,1946,2030,0.0769067,0.0664565,8.11
1,85,1946,2031,0.0841076,0.0723136,7.66
1,86,1946,2032,0.0919504,0.0787628,7.21
1,87,1946,2033,0.1004863,0.0858743,6.79
1,88,1946,2034,0.1097689,0.0936468,6.38
1,89,1946,2035,0.1198550,0.1020889,5.99
1,90,1946,2036,0.1308036,0.1112892,5.61
1,91,1946,2037,0.1426766,0.1213765,5.25
1,92,1946,2038,0.1555375,0.1324382,4.91
1,93,1946,2039,0.1694519,0.1444720,4.58
1,94,1946,2040,0.1844867,0.1574989,4.27
1,95,1946,2041,0.2007091,0.1716505,3.97
1,96,1946,2042,0.2181866,0.1870970,3.69
1,97,1946,2043,0.2369856,0.2039488,3.42
1,98,1946,2044,0.2571705,0.2222051,3.17
1,99,1946,2045,0.2788028,0.2418885,2.94
1,100,1946,2046,0.3019394,0.2631492,2.71
1,101,1946,2047,0.3266317,0.2861722,2.50
1,102,1946,2048,0.3529236,0.3110607,2.31
1,103,1946,2049,0.3808502,0.3377889,2.12
1,104,1946,2050,0.4104359,0.3663623,1.95
1,105,1946,2051,0.4416930,0.3969136,1.79
1,106,1946,2052,0.4746198,0.4295883,1.64
1,107,1946,2053,0.5091990,0.4644228,1.50
1,108,1946,2054,0.5453968,0.5013189,1.38
1,109,1946,2055,0.5831612,0.5402174,1.26
1,110,1946,2056,0.6224217,0.5811608,1.15
1,111,1946,2057,0.6630882,0.6241704,1.04
1,112,1946,2058,0.7050519,0.6691517,0.95
1,113,1946,2059,0.7481851,0.7158929,0.85
1,114,1946,2060,0.7923424,0.7642046,0.74
1,115,1946,2061,1.0000000,1.0000000,0.50
1,53,1947,2000,0.0049489,0.0056530,29.32
1,54,1947,2001,0.0053157,0.0059988,28.48
1,55,1947,2002,0.0057365,0.0063985,27.65
1,56,1947,2003,0.0062406,0.0068862,26.83
1,57,1947,2004,0.0068502,0.0074890,26.01
1,58,1947,2005,0.0075521,0.0081786,25.20
1,59,1947,2006,0.0083035,0.0089136,24.41
1,60,1947,2007,0.0090849,0.0096793,23.62
1,61,1947,2008,0.0099105,0.0104754,22.85
1,62,1947,2009,0.0107829,0.0112813,22.08
1,63,1947,2010,0.0116995,0.0120925,21.33
1,64,1947,2011,0.0126957,0.0129566,20.58
1,65,1947,2012,0.0138071,0.0139226,19.85
1,66,1947,2013,0.0150054,0.0149645,19.12
1,67,1947,2014,0.0162315,0.0160041,18.40
1,68,1947,2015,0.0174919,0.0170280,17.70
1,69,1947,2016,0.0188954,0.0181500,16.99
1,70,1947,2017,0.0205786,0.0195220,16.30
1,71,1947,2018,0.0226142,0.0212269,15.61
1,72,1947,2019,0.0250119,0.0232576,14.94
1,73,1947,2020,0.0277519,0.0255762,14.28
1,74,1947,2021,0.0307579,0.0281228,13.65
1,75,1947,2022,0.0339099,0.0307879,13.03
1,76,1947,2023,0.0371478,0.0334984,12.42
1,77,1947,2024,0.0405123,0.0362452,11.84
1,78,1947,2025,0.0440886,0.0390770,11.26
1,79,1947,2026,0.0480027,0.0421365,10.70
1,80,1947,2027,0.0536037,0.0470228,10.15
1,81,1947,2028,0.0586892,0.0511694,9.63
1,82,1947,2029,0.0642414,0.0556701,9.12
1,83,1947,2030,0.0702997,0.0605391,8.63
1,84,1947,2031,0.0769067,0.0658588,8.15
1,85,1947,2032,0.0841076,0.0717165,7.69
1,86,1947,2033,0.0919504,0.0781786,7.25
1,87,1947,2034,0.1004863,0.0852441,6.82
1,88,1947,2035,0.1097689,0.0929246,6.41
1,89,1947,2036,0.1198550,0.1013120,6.01
1,90,1947,2037,0.1308036,0.1105215,5.63
1,91,1947,2038,0.1426766,0.1206308,5.27
1,92,1947,2039,0.1555375,0.1316378,4.93
1,93,1947,2040,0.1694519,0.1435620,4.60
1,94,1947,2041,0.1844867,0.1565290,4.28
1,95,1947,2042,0.2007091,0.1707022,3.99
1,96,1947,2043,0.2181866,0.1861896,3.70
1,97,1947,2044,0.2369856,0.2029924,3.44
1,98,1947,2045,0.2571705,0.2211347,3.18
1,99,1947,2046,0.2788028,0.2407648,2.95
1,100,1947,2047,0.3019394,0.2620680,2.72
1,101,1947,2048,0.3266317,0.2851523,2.51
1,102,1947,2049,0.3529236,0.3100005,2.32
1,103,1947,2050,0.3808502,0.3366266,2.13
1,104,1947,2051,0.4104359,0.3651731,1.96
1,105,1947,2052,0.4416930,0.3958004,1.80
1,106,1947,2053,0.4746198,0.4285639,1.65
1,107,1947,2054,0.5091990,0.4633841,1.51
1,108,1947,2055,0.5453968,0.5002216,1.38
1,109,1947,2056,0.5831612,0.5391457,1.26
1,110,1947,2057,0.6224217,0.5802115,1.15
1,111,1947,2058,0.6630882,0.6233583,1.05
1,112,1947,2059,0.7050519,0.6683993,0.95
1,113,1947,2060,0.7481851,0.7151695,0.85
1,114,1947,2061,0.7923424,0.7635716,0.74
1,115,1947,2062,1.0000000,1.0000000,0.50
1,52,1948,2000,0.0046082,0.0052515,30.26
1,53,1948,2001,0.0049489,0.0055753,29.42
1,54,1948,2002,0.0053157,0.0059219,28.58
1,55,1948,2003,0.0057365,0.0063330,27.75
1,56,1948,2004,0.0062406,0.0068336,26.92
1,57,1948,2005,0.0068502,0.0074356,26.10
1,58,1948,2006,0.0075521,0.0081206,25.29
1,59,1948,2007,0.0083035,0.0088529,24.50
1,60,1948,2008,0.0090849,0.0096039,23.71
1,61,1948,2009,0.0099105,0.0103666,22.94
1,62,1948,2010,0.0107829,0.0111428,22.17
1,63,1948,2011,0.0116995,0.0119397,21.42
1,64,1948,2012,0.0126957,0.0128022,20.67
1,65,1948,2013,0.0138071,0.0137693,19.93
1,66,1948,2014,0.0150054,0.0147966,19.20
1,67,1948,2015,0.0162315,0.0158075,18.48
1,68,1948,2016,0.0174919,0.0168105,17.77
1,69,1948,2017,0.0188954,0.0179288,17.07
1,70,1948,2018,0.0205786,0.0193009,16.37
1,71,1948,2019,0.0226142,0.0209839,15.68
1,72,1948,2020,0.0250119,0.0229759,15.01
1,73,1948,2021,0.0277519,0.0252712,14.35
1,74,1948,2022,0.0307579,0.0278203,13.71
1,75,1948,2023,0.0339099,0.0304919,13.09
1,76,1948,2024,0.0371478,0.0331761,12.48
1,77,1948,2025,0.0405123,0.0358709,11.89
1,78,1948,2026,0.0440886,0.0386673,11.32
1,79,1948,2027,0.0480027,0.0417228,10.75
1,80,1948,2028,0.0536037,0.0466231,10.20
1,81,1948,2029,0.0586892,0.0507315,9.67
1,82,1948,2030,0.0642414,0.0551602,9.16
1,83,1948,2031,0.0702997,0.0599821,8.67
1,84,1948,2032,0.0769067,0.0653008,8.19
1,85,1948,2033,0.0841076,0.0711690,7.73
1,86,1948,2034,0.0919504,0.0775863,7.28
1,87,1948,2035,0.1004863,0.0845636,6.85
1,88,1948,2036,0.1097689,0.0921907,6.44
1,89,1948,2037,0.1198550,0.1005852,6.04
1,90,1948,2038,0.1308036,0.1098142,5.66
1,91,1948,2039,0.1426766,0.1198700,5.29
1,92,1948,2040,0.1555375,0.1307708,4.95
1,93,1948,2041,0.1694519,0.1426357,4.62
1,94,1948,2042,0.1844867,0.1556208,4.30
1,95,1948,2043,0.2007091,0.1698306,4.00
1,96,1948,2044,0.2181866,0.1852678,3.72
1,97,1948,2045,0.2369856,0.2019570,3.45
1,98,1948,2046,0.2571705,0.2200433,3.20
1,99,1948,2047,0.2788028,0.2397102,2.96
1,100,1948,2048,0.3019394,0.2610682,2.73
1,101,1948,2049,0.3266317,0.2841073,2.52
1,102,1948,2050,0.3529236,0.3088481,2.32
1,103,1948,2051,0.3808502,0.3354398,2.14
1,104,1948,2052,0.4104359,0.3640540,1.96
1,105,1948,2053,0.4416930,0.3947619,1.80
1,106,1948,2054,0.4746198,0.4275010,1.65
1,107,1948,2055,0.5091990,0.4622492,1.51
1,108,1948,2056,0.5453968,0.4990996,1.38
1,109,1948,2057,0.5831612,0.5381377,1.26
1,110,1948,2058,0.6224217,0.5793346,1.15
1,111,1948,2059,0.6630882,0.6225290,1.05
1,112,1948,2060,0.7050519,0.6675810,0.95
1,113,1948,2061,0.7481851,0.7144291,0.85
1,114,1948,2062,0.7923424,0.7629755,0.74
1,115,1948,2063,1.0000000,1.0000000,0.50
1,51,1949,2000,0.0042708,0.0048621,31.21
1,52,1949,2001,0.0046082,0.0051805,30.36
1,53,1949,2002,0.0049489,0.0055048,29.52
1,54,1949,2003,0.0053157,0.0058620,28.68
1,55,1949,2004,0.0057365,0.0062844,27.84
1,56,1949,2005,0.0062406,0.0067840,27.02
1,57,1949,2006,0.0068502,0.0073813,26.20
1,58,1949,2007,0.0075521,0.0080639,25.39
1,59,1949,2008,0.0083035,0.0087831,24.59
1,60,1949,2009,0.0090849,0.0095039,23.80
1,61,1949,2010,0.0099105,0.0102399,23.03
1,62,1949,2011,0.0107829,0.0110028,22.26
1,63,1949,2012,0.0116995,0.0117975,21.50
1,64,1949,2013,0.0126957,0.0126609,20.75
1,65,1949,2014,0.0138071,0.0136143,20.01
1,66,1949,2015,0.0150054,0.0146159,19.28
1,67,1949,2016,0.0162315,0.0156086,18.56
1,68,1949,2017,0.0174919,0.0166082,17.85
1,69,1949,2018,0.0188954,0.0177264,17.14
1,70,1949,2019,0.0205786,0.0190771,16.44
1,71,1949,2020,0.0226142,0.0207225,15.75
1,72,1949,2021,0.0250119,0.0226910,15.07
1,73,1949,2022,0.0277519,0.0249870,14.41
1,74,1949,2023,0.0307579,0.0275423,13.77
1,75,1949,2024,0.0339099,0.0301905,13.14
1,76,1949,2025,0.0371478,0.0328281,12.54
1,77,1949,2026,0.0405123,0.0354917,11.95
1,78,1949,2027,0.0440886,0.0382852,11.37
1,79,1949,2028,0.0480027,0.0413433,10.80
1,80,1949,2029,0.0536037,0.0462172,10.24
1,81,1949,2030,0.0586892,0.0502588,9.72
1,82,1949,2031,0.0642414,0.0546428,9.20
1,83,1949,2032,0.0702997,0.0594621,8.71
1,84,1949,2033,0.0769067,0.0647892,8.23
1,85,1949,2034,0.0841076,0.0706141,7.76
1,86,1949,2035,0.0919504,0.0769470,7.31
1,87,1949,2036,0.1004863,0.0838722,6.88
1,88,1949,2037,0.1097689,0.0915043,6.46
1,89,1949,2038,0.1198550,0.0999159,6.07
1,90,1949,2039,0.1308036,0.1090928,5.68
1,91,1949,2040,0.1426766,0.1190462,5.32
1,92,1949,2041,0.1555375,0.1298886,4.97
1,93,1949,2042,0.1694519,0.1417686,4.64
1,94,1949,2043,0.1844867,0.1547863,4.32
1,95,1949,2044,0.2007091,0.1689454,4.02
1,96,1949,2045,0.2181866,0.1842701,3.73
1,97,1949,2046,0.2369856,0.2009016,3.46
1,98,1949,2047,0.2571705,0.2190193,3.21
1,99,1949,2048,0.2788028,0.2387351,2.97
1,100,1949,2049,0.3019394,0.2600442,2.74
1,101,1949,2050,0.3266317,0.2829719,2.53
1,102,1949,2051,0.3529236,0.3076718,2.33
1,103,1949,2052,0.3808502,0.3343232,2.14
1,104,1949,2053,0.4104359,0.3630101,1.97
1,105,1949,2054,0.4416930,0.3936846,1.81
1,106,1949,2055,0.4746198,0.4263400,1.66
1,107,1949,2056,0.5091990,0.4610892,1.52
1,108,1949,2057,0.5453968,0.4980446,1.39
1,109,1949,2058,0.5831612,0.5372068,1.27
1,110,1949,2059,0.6224217,0.5784392,1.15
1,111,1949,2060,0.6630882,0.6216272,1.05
1,112,1949,2061,0.7050519,0.6667439,0.95
1,113,1949,2062,0.7481851,0.7137319,0.85
1,114,1949,2063,0.7923424,0.7624234,0.74
1,115,1949,2064,1.0000000,1.0000000,0.50
1,50,1950,2000,0.0039379,0.0044804,32.17
1,51,1950,2001,0.0042708,0.0047969,31.31
1,52,1950,2002,0.0046082,0.0051162,30.46
1,53,1950,2003,0.0049489,0.0054499,29.61
1,54,1950,2004,0.0053157,0.0058175,28.77
1,55,1950,2005,0.0057365,0.0062386,27.94
1,56,1950,2006,0.0062406,0.0067336,27.11
1,57,1950,2007,0.0068502,0.0073283,26.29
1,58,1950,2008,0.0075521,0.0079989,25.48
1,59,1950,2009,0.0083035,0.0086907,24.68
1,60,1950,2010,0.0090849,0.0093875,23.90
1,61,1950,2011,0.0099105,0.0101118,23.12
1,62,1950,2012,0.0107829,0.0108726,22.35
1,63,1950,2013,0.0116995,0.0116675,21.59
1,64,1950,2014,0.0126957,0.0125181,20.84
1,65,1950,2015,0.0138071,0.0134476,20.09
1,66,1950,2016,0.0150054,0.0144333,19.36
1,67,1950,2017,0.0162315,0.0154236,18.64
1,68,1950,2018,0.0174919,0.0164231,17.92
1,69,1950,2019,0.0188954,0.0175217,17.21
1,70,1950,2020,0.0205786,0.0188365,16.51
1,71,1950,2021,0.0226142,0.0204582,15.82
1,72,1950,2022,0.0250119,0.0224257,15.14
1,73,1950,2023,0.0277519,0.0247261,14.47
1,74,1950,2024,0.0307579,0.0272595,13.83
1,75,1950,2025,0.0339099,0.0298653,13.20
1,76,1950,2026,0.0371478,0.0324756,12.59
1,77,1950,2027,0.0405123,0.0351381,12.00
1,78,1950,2028,0.0440886,0.0379347,11.42
1,79,1950,2029,0.0480027,0.0409582,10.85
1,80,1950,2030,0.0536037,0.0457791,10.29
1,81,1950,2031,0.0586892,0.0497793,9.76
1,82,1950,2032,0.0642414,0.0541599,9.25
1,83,1950,2033,0.0702997,0.0589854,8.75
1,84,1950,2034,0.0769067,0.0642709,8.26
1,85,1950,2035,0.0841076,0.0700153,7.80
1,86,1950,2036,0.0919504,0.0762977,7.35
1,87,1950,2037,0.1004863,0.0832258,6.91
1,88,1950,2038,0.1097689,0.0908723,6.49
1,89,1950,2039,0.1198550,0.0992334,6.09
1,90,1950,2040,0.1308036,0.1083119,5.71
1,91,1950,2041,0.1426766,0.1182082,5.34
1,92,1950,2042,0.1555375,0.1290630,4.99
1,93,1950,2043,0.1694519,0.1409720,4.65
1,94,1950,2044,0.1844867,0.1539390,4.34
1,95,1950,2045,0.2007091,0.1679875,4.03
1,96,1950,2046,0.2181866,0.1832535,3.75
1,97,1950,2047,0.2369856,0.1999116,3.48
1,98,1950,2048,0.2571705,0.2180729,3.22
1,99,1950,2049,0.2788028,0.2377367,2.98
1,100,1950,2050,0.3019394,0.2589318,2.75
1,101,1950,2051,0.3266317,0.2818132,2.54
1,102,1950,2052,0.3529236,0.3065653,2.34
1,103,1950,2053,0.3808502,0.3332819,2.15
1,104,1950,2054,0.4104359,0.3619276,1.98
1,105,1950,2055,0.4416930,0.3925083,1.81
1,106,1950,2056,0.4746198,0.4251536,1.66
1,107,1950,2057,0.5091990,0.4599988,1.52
1,108,1950,2058,0.5453968,0.4970705,1.39
1,109,1950,2059,0.5831612,0.5362563,1.27
1,110,1950,2060,0.6224217,0.5774657,1.16
1,111,1950,2061,0.6630882,0.6207047,1.05
1,112,1950,2062,0.7050519,0.6659557,0.95
1,113,1950,2063,0.7481851,0.7130863,0.86
1,114,1950,2064,0.7923424,0.7618575,0.74
1,115,1950,2065,1.0000000,1.0000000,0.50
1,49,1951,2000,0.0036304,0.0041304,33.14
1,50,1951,2001,0.0039379,0.0044206,32.27
1,51,1951,2002,0.0042708,0.0047378,31.41
1,52,1951,2003,0.0046082,0.0050661,30.56
1,53,1951,2004,0.0049489,0.0054092,29.71
1,54,1951,2005,0.0053157,0.0057755,28.87
1,55,1951,2006,0.0057365,0.0061920,28.04
1,56,1951,2007,0.0062406,0.0066844,27.21
1,57,1951,2008,0.0068502,0.0072676,26.39
1,58,1951,2009,0.0075521,0.0079128,25.58
1,59,1951,2010,0.0083035,0.0085831,24.78
1,60,1951,2011,0.0090849,0.0092699,23.99
1,61,1951,2012,0.0099105,0.0099927,23.21
1,62,1951,2013,0.0107829,0.0107535,22.44
1,63,1951,2014,0.0116995,0.0115361,21.67
1,64,1951,2015,0.0126957,0.0123645,20.92
1,65,1951,2016,0.0138071,0.0132791,20.18
1,66,1951,2017,0.0150054,0.0142633,19.44
1,67,1951,2018,0.0162315,0.0152543,18.72
1,68,1951,2019,0.0174919,0.0162359,18.00
1,69,1951,2020,0.0188954,0.0173015,17.29
1,70,1951,2021,0.0205786,0.0185932,16.58
1,71,1951,2022,0.0226142,0.0202122,15.89
1,72,1951,2023,0.0250119,0.0221822,15.20
1,73,1951,2024,0.0277519,0.0244607,14.54
1,74,1951,2025,0.0307579,0.0269544,13.89
1,75,1951,2026,0.0339099,0.0295359,13.26
1,76,1951,2027,0.0371478,0.0321470,12.65
1,77,1951,2028,0.0405123,0.0348138,12.05
1,78,1951,2029,0.0440886,0.0375791,11.47
1,79,1951,2030,0.0480027,0.0405428,10.90
1,80,1951,2031,0.0536037,0.0453348,10.34
1,81,1951,2032,0.0586892,0.0493318,9.80
1,82,1951,2033,0.0642414,0.0537174,9.29
1,83,1951,2034,0.0702997,0.0585027,8.79
1,84,1951,2035,0.0769067,0.0637117,8.30
1,85,1951,2036,0.0841076,0.0694073,7.83
1,86,1951,2037,0.0919504,0.0756908,7.38
1,87,1951,2038,0.1004863,0.0826308,6.94
1,88,1951,2039,0.1097689,0.0902281,6.52
1,89,1951,2040,0.1198550,0.0984948,6.12
1,90,1951,2041,0.1308036,0.1075178,5.73
1,91,1951,2042,0.1426766,0.1174243,5.36
1,92,1951,2043,0.1555375,0.1283049,5.01
1,93,1951,2044,0.1694519,0.1401635,4.67
1,94,1951,2045,0.1844867,0.1530225,4.35
1,95,1951,2046,0.2007091,0.1670119,4.05
1,96,1951,2047,0.2181866,0.1823003,3.76
1,97,1951,2048,0.2369856,0.1989970,3.49
1,98,1951,2049,0.2571705,0.2171041,3.23
1,99,1951,2050,0.2788028,0.2366525,2.99
1,100,1951,2051,0.3019394,0.2577970,2.76
1,101,1951,2052,0.3266317,0.2807238,2.55
1,102,1951,2053,0.3529236,0.3055339,2.35
1,103,1951,2054,0.3808502,0.3322024,2.16
1,104,1951,2055,0.4104359,0.3607458,1.98
1,105,1951,2056,0.4416930,0.3913065,1.82
1,106,1951,2057,0.4746198,0.4240386,1.67
1,107,1951,2058,0.5091990,0.4589920,1.52
1,108,1951,2059,0.5453968,0.4960761,1.39
1,109,1951,2060,0.5831612,0.5352233,1.27
1,110,1951,2061,0.6224217,0.5764700,1.16
1,111,1951,2062,0.6630882,0.6198363,1.05
1,112,1951,2063,0.7050519,0.6652257,0.95
1,113,1951,2064,0.7481851,0.7124246,0.86
1,114,1951,2065,0.7923424,0.7612412,0.74
1,115,1951,2066,1.0000000,1.0000000,0.50
1,48,1952,2000,0.0033571,0.0038255,34.11
1,49,1952,2001,0.0036304,0.0040754,33.24
1,50,1952,2002,0.0039379,0.0043664,32.37
1,51,1952,2003,0.0042708,0.0046918,31.51
1,52,1952,2004,0.0046082,0.0050289,30.66
1,53,1952,2005,0.0049489,0.0053707,29.81
1,54,1952,2006,0.0053157,0.0057329,28.97
1,55,1952,2007,0.0057365,0.0061466,28.13
1,56,1952,2008,0.0062406,0.0066280,27.30
1,57,1952,2009,0.0068502,0.0071870,26.48
1,58,1952,2010,0.0075521,0.0078125,25.67
1,59,1952,2011,0.0083035,0.0084743,24.87
1,60,1952,2012,0.0090849,0.0091604,24.08
1,61,1952,2013,0.0099105,0.0098837,23.30
1,62,1952,2014,0.0107829,0.0106331,22.52
1,63,1952,2015,0.0116995,0.0113947,21.76
1,64,1952,2016,0.0126957,0.0122092,21.00
1,65,1952,2017,0.0138071,0.0131222,20.26
1,66,1952,2018,0.0150054,0.0141078,19.52
1,67,1952,2019,0.0162315,0.0150830,18.79
1,68,1952,2020,0.0174919,0.0160345,18.07
1,69,1952,2021,0.0188954,0.0170789,17.36
1,70,1952,2022,0.0205786,0.0183668,16.65
1,71,1952,2023,0.0226142,0.0199864,15.95
1,72,1952,2024,0.0250119,0.0219347,15.27
1,73,1952,2025,0.0277519,0.0241746,14.60
1,74,1952,2026,0.0307579,0.0266454,13.95
1,75,1952,2027,0.0339099,0.0292288,13.32
1,76,1952,2028,0.0371478,0.0318456,12.70
1,77,1952,2029,0.0405123,0.0344848,12.11
1,78,1952,2030,0.0440886,0.0371955,11.52
1,79,1952,2031,0.0480027,0.0401217,10.95
1,80,1952,2032,0.0536037,0.0449202,10.38
1,81,1952,2033,0.0586892,0.0489219,9.85
1,82,1952,2034,0.0642414,0.0532693,9.33
1,83,1952,2035,0.0702997,0.0579819,8.83
1,84,1952,2036,0.0769067,0.0631441,8.34
1,85,1952,2037,0.0841076,0.0688392,7.87
1,86,1952,2038,0.0919504,0.0751323,7.41
1,87,1952,2039,0.1004863,0.0820245,6.97
1,88,1952,2040,0.1097689,0.0895312,6.55
1,89,1952,2041,0.1198550,0.0977440,6.15
1,90,1952,2042,0.1308036,0.1067751,5.76
1,91,1952,2043,0.1426766,0.1167045,5.39
1,92,1952,2044,0.1555375,0.1275356,5.03
1,93,1952,2045,0.1694519,0.1392892,4.69
1,94,1952,2046,0.1844867,0.1520892,4.37
1,95,1952,2047,0.2007091,0.1660973,4.07
1,96,1952,2048,0.2181866,0.1814198,3.78
1,97,1952,2049,0.2369856,0.1980609,3.50
1,98,1952,2050,0.2571705,0.2160523,3.24
1,99,1952,2051,0.2788028,0.2355468,3.00
1,100,1952,2052,0.3019394,0.2567303,2.77
1,101,1952,2053,0.3266317,0.2797084,2.56
1,102,1952,2054,0.3529236,0.3044648,2.35
1,103,1952,2055,0.3808502,0.3310243,2.16
1,104,1952,2056,0.4104359,0.3595389,1.99
1,105,1952,2057,0.4416930,0.3901774,1.82
1,106,1952,2058,0.4746198,0.4230095,1.67
1,107,1952,2059,0.5091990,0.4579647,1.53
1,108,1952,2060,0.5453968,0.4949957,1.40
1,109,1952,2061,0.5831612,0.5341669,1.27
1,110,1952,2062,0.6224217,0.5755330,1.16
1,111,1952,2063,0.6630882,0.6190324,1.05
1,112,1952,2064,0.7050519,0.6644778,0.96
1,113,1952,2065,0.7481851,0.7117041,0.86
1,114,1952,2066,0.7923424,0.7606103,0.74
1,115,1952,2067,1.0000000,1.0000000,0.50
1,47,1953,2000,0.0031101,0.0035509,35.09
1,48,1953,2001,0.0033571,0.0037739,34.21
1,49,1953,2002,0.0036304,0.0040254,33.34
1,50,1953,2003,0.0039379,0.0043241,32.47
1,51,1953,2004,0.0042708,0.0046575,31.61
1,52,1953,2005,0.0046082,0.0049937,30.76
1,53,1953,2006,0.0049489,0.0053316,29.91
1,54,1953,2007,0.0053157,0.0056913,29.07
1,55,1953,2008,0.0057365,0.0060944,28.23
1,56,1953,2009,0.0062406,0.0065532,27.40
1,57,1953,2010,0.0068502,0.0070934,26.58
1,58,1953,2011,0.0075521,0.0077112,25.77
1,59,1953,2012,0.0083035,0.0083732,24.96
1,60,1953,2013,0.0090849,0.0090602,24.17
1,61,1953,2014,0.0099105,0.0097735,23.38
1,62,1953,2015,0.0107829,0.0105036,22.61
1,63,1953,2016,0.0116995,0.0112517,21.85
1,64,1953,2017,0.0126957,0.0120647,21.09
1,65,1953,2018,0.0138071,0.0129787,20.34
1,66,1953,2019,0.0150054,0.0139504,19.60
1,67,1953,2020,0.0162315,0.0148987,18.87
1,68,1953,2021,0.0174919,0.0158308,18.15
1,69,1953,2022,0.0188954,0.0168718,17.43
1,70,1953,2023,0.0205786,0.0181592,16.72
1,71,1953,2024,0.0226142,0.0197570,16.02
1,72,1953,2025,0.0250119,0.0216679,15.34
1,73,1953,2026,0.0277519,0.0238850,14.66
1,74,1953,2027,0.0307579,0.0263577,14.01
1,75,1953,2028,0.0339099,0.0289474,13.38
1,76,1953,2029,0.0371478,0.0315398,12.76
1,77,1953,2030,0.0405123,0.0341299,12.16
1,78,1953,2031,0.0440886,0.0368068,11.57
1,79,1953,2032,0.0480027,0.0397292,10.99
1,80,1953,2033,0.0536037,0.0445405,10.43
1,81,1953,2034,0.0586892,0.0485067,9.89
1,82,1953,2035,0.0642414,0.0527860,9.37
1,83,1953,2036,0.0702997,0.0574534,8.87
1,84,1953,2037,0.0769067,0.0626138,8.37
1,85,1953,2038,0.0841076,0.0683165,7.90
1,86,1953,2039,0.0919504,0.0745633,7.44
1,87,1953,2040,0.1004863,0.0813687,7.00
1,88,1953,2041,0.1097689,0.0888229,6.58
1,89,1953,2042,0.1198550,0.0970420,6.17
1,90,1953,2043,0.1308036,0.1060935,5.78
1,91,1953,2044,0.1426766,0.1159744,5.41
1,92,1953,2045,0.1555375,0.1267039,5.05
1,93,1953,2046,0.1694519,0.1383992,4.71
1,94,1953,2047,0.1844867,0.1512146,4.39
1,95,1953,2048,0.2007091,0.1652527,4.08
1,96,1953,2049,0.2181866,0.1805189,3.79
1,97,1953,2050,0.2369856,0.1970450,3.52
1,98,1953,2051,0.2571705,0.2149801,3.26
1,99,1953,2052,0.2788028,0.2345078,3.01
1,100,1953,2053,0.3019394,0.2557364,2.78
1,101,1953,2054,0.3266317,0.2786563,2.56
1,102,1953,2055,0.3529236,0.3032985,2.36
1,103,1953,2056,0.3808502,0.3298215,2.17
1,104,1953,2057,0.4104359,0.3584053,1.99
1,105,1953,2058,0.4416930,0.3891356,1.83
1,106,1953,2059,0.4746198,0.4219596,1.67
1,107,1953,2060,0.5091990,0.4568487,1.53
1,108,1953,2061,0.5453968,0.4938910,1.40
1,109,1953,2062,0.5831612,0.5331730,1.28
1,110,1953,2063,0.6224217,0.5746656,1.16
1,111,1953,2064,0.6630882,0.6182086,1.06
1,112,1953,2065,0.7050519,0.6636636,0.96
1,113,1953,2066,0.7481851,0.7109668,0.86
1,114,1953,2067,0.7923424,0.7600158,0.74
1,115,1953,2068,1.0000000,1.0000000,0.50
1,46,1954,2000,0.0028925,0.0033033,36.08
1,47,1954,2001,0.0031101,0.0035022,35.20
1,48,1954,2002,0.0033571,0.0037270,34.32
1,49,1954,2003,0.0036304,0.0039864,33.44
1,50,1954,2004,0.0039379,0.0042928,32.58
1,51,1954,2005,0.0042708,0.0046252,31.71
1,52,1954,2006,0.0046082,0.0049580,30.86
1,53,1954,2007,0.0049489,0.0052934,30.01
1,54,1954,2008,0.0053157,0.0056435,29.17
1,55,1954,2009,0.0057365,0.0060253,28.33
1,56,1954,2010,0.0062406,0.0064663,27.50
1,57,1954,2011,0.0068502,0.0069987,26.67
1,58,1954,2012,0.0075521,0.0076170,25.86
1,59,1954,2013,0.0083035,0.0082807,25.05
1,60,1954,2014,0.0090849,0.0089590,24.26
1,61,1954,2015,0.0099105,0.0096549,23.47
1,62,1954,2016,0.0107829,0.0103726,22.70
1,63,1954,2017,0.0116995,0.0111187,21.93
1,64,1954,2018,0.0126957,0.0119325,21.17
1,65,1954,2019,0.0138071,0.0128335,20.42
1,66,1954,2020,0.0150054,0.0137810,19.68
1,67,1954,2021,0.0162315,0.0147123,18.95
1,68,1954,2022,0.0174919,0.0156412,18.22
1,69,1954,2023,0.0188954,0.0166818,17.50
1,70,1954,2024,0.0205786,0.0179481,16.79
1,71,1954,2025,0.0226142,0.0195099,16.09
1,72,1954,2026,0.0250119,0.0213981,15.40
1,73,1954,2027,0.0277519,0.0236154,14.73
1,74,1954,2028,0.0307579,0.0260940,14.07
1,75,1954,2029,0.0339099,0.0286619,13.43
1,76,1954,2030,0.0371478,0.0312102,12.82
1,77,1954,2031,0.0405123,0.0337703,12.21
1,78,1954,2032,0.0440886,0.0364444,11.62
1,79,1954,2033,0.0480027,0.0393699,11.04
1,80,1954,2034,0.0536037,0.0441560,10.48
1,81,1954,2035,0.0586892,0.0480591,9.94
1,82,1954,2036,0.0642414,0.0522956,9.41
1,83,1954,2037,0.0702997,0.0569597,8.90
1,84,1954,2038,0.0769067,0.0621260,8.41
1,85,1954,2039,0.0841076,0.0677841,7.94
1,86,1954,2040,0.0919504,0.0739480,7.48
1,87,1954,2041,0.1004863,0.0807024,7.03
1,88,1954,2042,0.1097689,0.0881609,6.61
1,89,1954,2043,0.1198550,0.0963979,6.20
1,90,1954,2044,0.1308036,0.1054023,5.81
1,91,1954,2045,0.1426766,0.1151853,5.43
1,92,1954,2046,0.1555375,0.1258575,5.07
1,93,1954,2047,0.1694519,0.1375654,4.73
1,94,1954,2048,0.1844867,0.1504072,4.41
1,95,1954,2049,0.2007091,0.1643889,4.10
1,96,1954,2050,0.2181866,0.1795415,3.81
1,97,1954,2051,0.2369856,0.1960096,3.53
1,98,1954,2052,0.2571705,0.2139727,3.27
1,99,1954,2053,0.2788028,0.2335399,3.02
1,100,1954,2054,0.3019394,0.2547069,2.79
1,101,1954,2055,0.3266317,0.2775087,2.57
1,102,1954,2056,0.3529236,0.3021080,2.37
1,103,1954,2057,0.3808502,0.3286920,2.18
1,104,1954,2058,0.4104359,0.3573595,2.00
1,105,1954,2059,0.4416930,0.3880729,1.83
1,106,1954,2060,0.4746198,0.4208194,1.68
1,107,1954,2061,0.5091990,0.4557079,1.54
1,108,1954,2062,0.5453968,0.4928520,1.40
1,109,1954,2063,0.5831612,0.5322531,1.28
1,110,1954,2064,0.6224217,0.5737771,1.16
1,111,1954,2065,0.6630882,0.6173121,1.06
1,112,1954,2066,0.7050519,0.6628305,0.96
1,113,1954,2067,0.7481851,0.7102718,0.86
1,114,1954,2068,0.7923424,0.7594619,0.74
1,115,1954,2069,1.0000000,1.0000000,0.50
1,45,1955,2000,0.0027191,0.0031008,37.07
1,46,1955,2001,0.0028925,0.0032579,36.18
1,47,1955,2002,0.0031101,0.0034581,35.30
1,48,1955,2003,0.0033571,0.0036905,34.42
1,49,1955,2004,0.0036304,0.0039575,33.55
1,50,1955,2005,0.0039379,0.0042631,32.68
1,51,1955,2006,0.0042708,0.0045924,31.82
1,52,1955,2007,0.0046082,0.0049231,30.96
1,53,1955,2008,0.0049489,0.0052496,30.11
1,54,1955,2009,0.0053157,0.0055802,29.27
1,55,1955,2010,0.0057365,0.0059450,28.43
1,56,1955,2011,0.0062406,0.0063784,27.60
1,57,1955,2012,0.0068502,0.0069108,26.77
1,58,1955,2013,0.0075521,0.0075308,25.95
1,59,1955,2014,0.0083035,0.0081871,25.15
1,60,1955,2015,0.0090849,0.0088501,24.35
1,61,1955,2016,0.0099105,0.0095350,23.56
1,62,1955,2017,0.0107829,0.0102507,22.78
1,63,1955,2018,0.0116995,0.0109970,22.01
1,64,1955,2019,0.0126957,0.0117987,21.25
1,65,1955,2020,0.0138071,0.0126772,20.50
1,66,1955,2021,0.0150054,0.0136097,19.76
1,67,1955,2022,0.0162315,0.0145388,19.02
1,68,1955,2023,0.0174919,0.0154673,18.30
1,69,1955,2024,0.0188954,0.0164886,17.58
1,70,1955,2025,0.0205786,0.0177208,16.86
1,71,1955,2026,0.0226142,0.0192600,16.16
1,72,1955,2027,0.0250119,0.0211470,15.47
1,73,1955,2028,0.0277519,0.0233684,14.79
1,74,1955,2029,0.0307579,0.0258266,14.13
1,75,1955,2030,0.0339099,0.0283542,13.49
1,76,1955,2031,0.0371478,0.0308762,12.87
1,77,1955,2032,0.0405123,0.0334351,12.27
1,78,1955,2033,0.0440886,0.0361126,11.67
1,79,1955,2034,0.0480027,0.0390063,11.09
1,80,1955,2035,0.0536037,0.0437415,10.52
1,81,1955,2036,0.0586892,0.0476049,9.98
1,82,1955,2037,0.0642414,0.0518376,9.45
1,83,1955,2038,0.0702997,0.0565057,8.94
1,84,1955,2039,0.0769067,0.0616292,8.45
1,85,1955,2040,0.0841076,0.0672085,7.97
1,86,1955,2041,0.0919504,0.0733231,7.51
1,87,1955,2042,0.1004863,0.0800798,7.06
1,88,1955,2043,0.1097689,0.0875536,6.64
1,89,1955,2044,0.1198550,0.0957449,6.22
1,90,1955,2045,0.1308036,0.1046554,5.83
1,91,1955,2046,0.1426766,0.1143826,5.45
1,92,1955,2047,0.1555375,0.1250649,5.09
1,93,1955,2048,0.1694519,0.1367959,4.75
1,94,1955,2049,0.1844867,0.1495817,4.42
1,95,1955,2050,0.2007091,0.1634519,4.11
1,96,1955,2051,0.2181866,0.1785457,3.82
1,97,1955,2052,0.2369856,0.1950372,3.54
1,98,1955,2053,0.2571705,0.2130347,3.28
1,99,1955,2054,0.2788028,0.2325377,3.03
1,100,1955,2055,0.3019394,0.2535842,2.80
1,101,1955,2056,0.3266317,0.2763379,2.58
1,102,1955,2057,0.3529236,0.3009905,2.38
1,103,1955,2058,0.3808502,0.3276504,2.18
1,104,1955,2059,0.4104359,0.3562931,2.01
1,105,1955,2060,0.4416930,0.3869191,1.84
1,106,1955,2061,0.4746198,0.4196542,1.68
1,107,1955,2062,0.5091990,0.4546352,1.54
1,108,1955,2063,0.5453968,0.4918905,1.40
1,109,1955,2064,0.5831612,0.5313110,1.28
1,110,1955,2065,0.6224217,0.5728102,1.17
1,111,1955,2066,0.6630882,0.6163949,1.06
1,112,1955,2067,0.7050519,0.6620454,0.96
1,113,1955,2068,0.7481851,0.7096246,0.86
1,114,1955,2069,0.7923424,0.7588895,0.74
1,115,1955,2070,1.0000000,1.0000000,0.50
1,44,1956,2000,0.0025867,0.0029399,38.07
1,45,1956,2001,0.0027191,0.0030587,37.18
1,46,1956,2002,0.0028925,0.0032168,36.29
1,47,1956,2003,0.0031101,0.0034237,35.41
1,48,1956,2004,0.0033571,0.0036634,34.53
1,49,1956,2005,0.0036304,0.0039302,33.65
1,50,1956,2006,0.0039379,0.0042330,32.78
1,51,1956,2007,0.0042708,0.0045604,31.92
1,52,1956,2008,0.0046082,0.0048831,31.06
1,53,1956,2009,0.0049489,0.0051916,30.21
1,54,1956,2010,0.0053157,0.0055067,29.37
1,55,1956,2011,0.0057365,0.0058638,28.53
1,56,1956,2012,0.0062406,0.0062968,27.69
1,57,1956,2013,0.0068502,0.0068304,26.86
1,58,1956,2014,0.0075521,0.0074438,26.05
1,59,1956,2015,0.0083035,0.0080865,25.24
1,60,1956,2016,0.0090849,0.0087400,24.44
1,61,1956,2017,0.0099105,0.0094235,23.65
1,62,1956,2018,0.0107829,0.0101391,22.87
1,63,1956,2019,0.0116995,0.0108738,22.10
1,64,1956,2020,0.0126957,0.0116547,21.34
1,65,1956,2021,0.0138071,0.0125192,20.58
1,66,1956,2022,0.0150054,0.0134503,19.84
1,67,1956,2023,0.0162315,0.0143795,19.10
1,68,1956,2024,0.0174919,0.0152905,18.37
1,69,1956,2025,0.0188954,0.0162806,17.65
1,70,1956,2026,0.0205786,0.0174910,16.93
1,71,1956,2027,0.0226142,0.0190275,16.23
1,72,1956,2028,0.0250119,0.0209171,15.53
1,73,1956,2029,0.0277519,0.0231182,14.85
1,74,1956,2030,0.0307579,0.0255385,14.19
1,75,1956,2031,0.0339099,0.0280425,13.55
1,76,1956,2032,0.0371478,0.0305649,12.93
1,77,1956,2033,0.0405123,0.0331282,12.32
1,78,1956,2034,0.0440886,0.0357770,11.72
1,79,1956,2035,0.0480027,0.0386145,11.14
1,80,1956,2036,0.0536037,0.0433211,10.57
1,81,1956,2037,0.0586892,0.0471809,10.02
1,82,1956,2038,0.0642414,0.0514165,9.50
1,83,1956,2039,0.0702997,0.0560435,8.98
1,84,1956,2040,0.0769067,0.0610924,8.49
1,85,1956,2041,0.0841076,0.0666241,8.01
1,86,1956,2042,0.0919504,0.0727394,7.54
1,87,1956,2043,0.1004863,0.0795089,7.10
1,88,1956,2044,0.1097689,0.0869382,6.66
1,89,1956,2045,0.1198550,0.0950395,6.25
1,90,1956,2046,0.1308036,0.1038958,5.86
1,91,1956,2047,0.1426766,0.1136310,5.48
1,92,1956,2048,0.1555375,0.1243336,5.12
1,93,1956,2049,0.1694519,0.1360093,4.77
1,94,1956,2050,0.1844867,0.1486864,4.44
1,95,1956,2051,0.2007091,0.1624976,4.13
1,96,1956,2052,0.2181866,0.1776108,3.84
1,97,1956,2053,0.2369856,0.1941320,3.56
1,98,1956,2054,0.2571705,0.2120636,3.29
1,99,1956,2055,0.2788028,0.2314452,3.04
1,100,1956,2056,0.3019394,0.2524392,2.81
1,101,1956,2057,0.3266317,0.2752391,2.59
1,102,1956,2058,0.3529236,0.2999601,2.38
1,103,1956,2059,0.3808502,0.3265885,2.19
1,104,1956,2060,0.4104359,0.3551356,2.01
1,105,1956,2061,0.4416930,0.3857404,1.84
1,106,1956,2062,0.4746198,0.4185588,1.69
1,107,1956,2063,0.5091990,0.4536428,1.54
1,108,1956,2064,0.5453968,0.4909061,1.41
1,109,1956,2065,0.5831612,0.5302861,1.28
1,110,1956,2066,0.6224217,0.5718213,1.17
1,111,1956,2067,0.6630882,0.6155307,1.06
1,112,1956,2068,0.7050519,0.6613144,0.96
1,113,1956,2069,0.7481851,0.7089558,0.86
1,114,1956,2070,0.7923424,0.7582644,0.74
1,115,1956,2071,1.0000000,1.0000000,0.50
1,43,1957,2000,0.0024669,0.0028026,39.07
1,44,1957,2001,0.0025867,0.0029010,38.17
1,45,1957,2002,0.0027191,0.0030205,37.28
1,46,1957,2003,0.0028925,0.0031848,36.40
1,47,1957,2004,0.0031101,0.0033982,35.51
1,48,1957,2005,0.0033571,0.0036378,34.63
1,49,1957,2006,0.0036304,0.0039024,33.75
1,50,1957,2007,0.0039379,0.0042036,32.88
1,51,1957,2008,0.0042708,0.0045236,32.02
1,52,1957,2009,0.0046082,0.0048301,31.16
1,53,1957,2010,0.0049489,0.0051241,30.31
1,54,1957,2011,0.0053157,0.0054323,29.47
1,55,1957,2012,0.0057365,0.0057884,28.62
1,56,1957,2013,0.0062406,0.0062223,27.79
1,57,1957,2014,0.0068502,0.0067491,26.96
1,58,1957,2015,0.0075521,0.0073502,26.14
1,59,1957,2016,0.0083035,0.0079848,25.33
1,60,1957,2017,0.0090849,0.0086375,24.53
1,61,1957,2018,0.0099105,0.0093214,23.74
1,62,1957,2019,0.0107829,0.0100263,22.96
1,63,1957,2020,0.0116995,0.0107413,22.18
1,64,1957,2021,0.0126957,0.0115092,21.42
1,65,1957,2022,0.0138071,0.0123720,20.66
1,66,1957,2023,0.0150054,0.0133039,19.92
1,67,1957,2024,0.0162315,0.0142176,19.18
1,68,1957,2025,0.0174919,0.0151000,18.45
1,69,1957,2026,0.0188954,0.0160703,17.72
1,70,1957,2027,0.0205786,0.0172772,17.00
1,71,1957,2028,0.0226142,0.0188147,16.29
1,72,1957,2029,0.0250119,0.0206842,15.60
1,73,1957,2030,0.0277519,0.0228487,14.92
1,74,1957,2031,0.0307579,0.0252468,14.25
1,75,1957,2032,0.0339099,0.0277521,13.61
1,76,1957,2033,0.0371478,0.0302800,12.98
1,77,1957,2034,0.0405123,0.0328178,12.37
1,78,1957,2035,0.0440886,0.0354154,11.78
1,79,1957,2036,0.0480027,0.0382174,11.19
1,80,1957,2037,0.0536037,0.0429286,10.61
1,81,1957,2038,0.0586892,0.0467911,10.07
1,82,1957,2039,0.0642414,0.0509879,9.54
1,83,1957,2040,0.0702997,0.0555441,9.02
1,84,1957,2041,0.0769067,0.0605474,8.52
1,85,1957,2042,0.0841076,0.0660783,8.04
1,86,1957,2043,0.0919504,0.0722042,7.58
1,87,1957,2044,0.1004863,0.0789304,7.13
1,88,1957,2045,0.1097689,0.0862735,6.69
1,89,1957,2046,0.1198550,0.0943224,6.28
1,90,1957,2047,0.1308036,0.1031849,5.88
1,91,1957,2048,0.1426766,0.1129378,5.50
1,92,1957,2049,0.1555375,0.1235863,5.14
1,93,1957,2050,0.1694519,0.1351566,4.79
1,94,1957,2051,0.1844867,0.1477750,4.46
1,95,1957,2052,0.2007091,0.1616019,4.15
1,96,1957,2053,0.2181866,0.1767407,3.85
1,97,1957,2054,0.2369856,0.1931952,3.57
1,98,1957,2055,0.2571705,0.2110053,3.30
1,99,1957,2056,0.2788028,0.2303311,3.06
1,100,1957,2057,0.3019394,0.2513649,2.82
1,101,1957,2058,0.3266317,0.2742263,2.60
1,102,1957,2059,0.3529236,0.2989101,2.39
1,103,1957,2060,0.3808502,0.3254363,2.20
1,104,1957,2061,0.4104359,0.3539535,2.02
1,105,1957,2062,0.4416930,0.3846326,1.85
1,106,1957,2063,0.4746198,0.4175457,1.69
1,107,1957,2064,0.5091990,0.4526270,1.55
1,108,1957,2065,0.5453968,0.4898353,1.41
1,109,1957,2066,0.5831612,0.5292380,1.29
1,110,1957,2067,0.6224217,0.5708897,1.17
1,111,1957,2068,0.6630882,0.6147262,1.06
1,112,1957,2069,0.7050519,0.6605589,0.96
1,113,1957,2070,0.7481851,0.7082254,0.86
1,114,1957,2071,0.7923424,0.7576244,0.74
1,115,1957,2072,1.0000000,1.0000000,0.50
1,42,1958,2000,0.0023342,0.0026570,40.07
1,43,1958,2001,0.0024669,0.0027656,39.17
1,44,1958,2002,0.0025867,0.0028657,38.28
1,45,1958,2003,0.0027191,0.0029908,37.39
1,46,1958,2004,0.0028925,0.0031610,36.50
1,47,1958,2005,0.0031101,0.0033741,35.62
1,48,1958,2006,0.0033571,0.0036118,34.73
1,49,1958,2007,0.0036304,0.0038753,33.86
1,50,1958,2008,0.0039379,0.0041699,32.99
1,51,1958,2009,0.0042708,0.0044748,32.12
1,52,1958,2010,0.0046082,0.0047684,31.27
1,53,1958,2011,0.0049489,0.0050560,30.41
1,54,1958,2012,0.0053157,0.0053633,29.57
1,55,1958,2013,0.0057365,0.0057196,28.72
1,56,1958,2014,0.0062406,0.0061469,27.88
1,57,1958,2015,0.0068502,0.0066618,27.05
1,58,1958,2016,0.0075521,0.0072555,26.23
1,59,1958,2017,0.0083035,0.0078902,25.42
1,60,1958,2018,0.0090849,0.0085437,24.62
1,61,1958,2019,0.0099105,0.0092181,23.83
1,62,1958,2020,0.0107829,0.0099048,23.04
1,63,1958,2021,0.0116995,0.0106073,22.27
1,64,1958,2022,0.0126957,0.0113736,21.50
1,65,1958,2023,0.0138071,0.0122370,20.74
1,66,1958,2024,0.0150054,0.0131552,19.99
1,67,1958,2025,0.0162315,0.0140432,19.25
1,68,1958,2026,0.0174919,0.0149075,18.52
1,69,1958,2027,0.0188954,0.0158746,17.79
1,70,1958,2028,0.0205786,0.0170816,17.07
1,71,1958,2029,0.0226142,0.0185992,16.36
1,72,1958,2030,0.0250119,0.0204335,15.66
1,73,1958,2031,0.0277519,0.0225760,14.98
1,74,1958,2032,0.0307579,0.0249752,14.31
1,75,1958,2033,0.0339099,0.0274864,13.67
1,76,1958,2034,0.0371478,0.0299918,13.04
1,77,1958,2035,0.0405123,0.0324834,12.43
1,78,1958,2036,0.0440886,0.0350488,11.83
1,79,1958,2037,0.0480027,0.0378469,11.24
1,80,1958,2038,0.0536037,0.0425678,10.66
1,81,1958,2039,0.0586892,0.0463944,10.11
1,82,1958,2040,0.0642414,0.0505248,9.58
1,83,1958,2041,0.0702997,0.0550372,9.06
1,84,1958,2042,0.0769067,0.0600385,8.56
1,85,1958,2043,0.0841076,0.0655781,8.08
1,86,1958,2044,0.0919504,0.0716621,7.61
1,87,1958,2045,0.1004863,0.0783059,7.16
1,88,1958,2046,0.1097689,0.0855981,6.72
1,89,1958,2047,0.1198550,0.0936514,6.31
1,90,1958,2048,0.1308036,0.1025294,5.91
1,91,1958,2049,0.1426766,0.1122296,5.52
1,92,1958,2050,0.1555375,0.1227764,5.16
1,93,1958,2051,0.1694519,0.1342887,4.81
1,94,1958,2052,0.1844867,0.1469197,4.48
1,95,1958,2053,0.2007091,0.1607686,4.16
1,96,1958,2054,0.2181866,0.1758404,3.87
1,97,1958,2055,0.2369856,0.1921746,3.58
1,98,1958,2056,0.2571705,0.2099266,3.32
1,99,1958,2057,0.2788028,0.2292863,3.07
1,100,1958,2058,0.3019394,0.2503751,2.83
1,101,1958,2059,0.3266317,0.2731945,2.61
1,102,1958,2060,0.3529236,0.2977709,2.40
1,103,1958,2061,0.3808502,0.3242598,2.21
1,104,1958,2062,0.4104359,0.3528428,2.02
1,105,1958,2063,0.4416930,0.3836083,1.85
1,106,1958,2064,0.4746198,0.4165089,1.70
1,107,1958,2065,0.5091990,0.4515223,1.55
1,108,1958,2066,0.5453968,0.4887406,1.41
1,109,1958,2067,0.5831612,0.5282509,1.29
1,110,1958,2068,0.6224217,0.5700226,1.17
1,111,1958,2069,0.6630882,0.6138951,1.07
1,112,1958,2070,0.7050519,0.6597342,0.96
1,113,1958,2071,0.7481851,0.7074779,0.86
1,114,1958,2072,0.7923424,0.7570227,0.74
1,115,1958,2073,1.0000000,1.0000000,0.50
1,41,1959,2000,0.0021897,0.0025019,41.08
1,42,1959,2001,0.0023342,0.0026214,40.18
1,43,1959,2002,0.0024669,0.0027321,39.28
1,44,1959,2003,0.0025867,0.0028382,38.39
1,45,1959,2004,0.0027191,0.0029687,37.50
1,46,1959,2005,0.0028925,0.0031386,36.61
1,47,1959,2006,0.0031101,0.0033497,35.72
1,48,1959,2007,0.0033571,0.0035864,34.84
1,49,1959,2008,0.0036304,0.0038442,33.96
1,50,1959,2009,0.0039379,0.0041251,33.09
1,51,1959,2010,0.0042708,0.0044181,32.23
1,52,1959,2011,0.0046082,0.0047061,31.37
1,53,1959,2012,0.0049489,0.0049926,30.51
1,54,1959,2013,0.0053157,0.0053001,29.66
1,55,1959,2014,0.0057365,0.0056500,28.82
1,56,1959,2015,0.0062406,0.0060660,27.98
1,57,1959,2016,0.0068502,0.0065736,27.15
1,58,1959,2017,0.0075521,0.0071675,26.32
1,59,1959,2018,0.0083035,0.0078036,25.51
1,60,1959,2019,0.0090849,0.0084488,24.71
1,61,1959,2020,0.0099105,0.0091069,23.91
1,62,1959,2021,0.0107829,0.0097820,23.13
1,63,1959,2022,0.0116995,0.0104826,22.35
1,64,1959,2023,0.0126957,0.0112493,21.58
1,65,1959,2024,0.0138071,0.0120998,20.82
1,66,1959,2025,0.0150054,0.0129948,20.07
1,67,1959,2026,0.0162315,0.0138668,19.33
1,68,1959,2027,0.0174919,0.0147283,18.60
1,69,1959,2028,0.0188954,0.0156956,17.87
1,70,1959,2029,0.0205786,0.0168836,17.14
1,71,1959,2030,0.0226142,0.0183674,16.43
1,72,1959,2031,0.0250119,0.0201800,15.73
1,73,1959,2032,0.0277519,0.0223221,15.04
1,74,1959,2033,0.0307579,0.0247268,14.37
1,75,1959,2034,0.0339099,0.0272177,13.72
1,76,1959,2035,0.0371478,0.0296814,13.09
1,77,1959,2036,0.0405123,0.0321445,12.48
1,78,1959,2037,0.0440886,0.0347070,11.88
1,79,1959,2038,0.0480027,0.0375067,11.29
1,80,1959,2039,0.0536037,0.0422007,10.71
1,81,1959,2040,0.0586892,0.0459658,10.16
1,82,1959,2041,0.0642414,0.0500549,9.62
1,83,1959,2042,0.0702997,0.0545640,9.10
1,84,1959,2043,0.0769067,0.0595723,8.60
1,85,1959,2044,0.0841076,0.0650715,8.11
1,86,1959,2045,0.0919504,0.0710769,7.64
1,87,1959,2046,0.1004863,0.0776714,7.19
1,88,1959,2047,0.1097689,0.0849662,6.75
1,89,1959,2048,0.1198550,0.0930329,6.33
1,90,1959,2049,0.1308036,0.1018598,5.93
1,91,1959,2050,0.1426766,0.1114623,5.55
1,92,1959,2051,0.1555375,0.1219522,5.18
1,93,1959,2052,0.1694519,0.1334746,4.83
1,94,1959,2053,0.1844867,0.1461243,4.50
1,95,1959,2054,0.2007091,0.1599067,4.18
1,96,1959,2055,0.2181866,0.1748600,3.88
1,97,1959,2056,0.2369856,0.1911345,3.60
1,98,1959,2057,0.2571705,0.2089153,3.33
1,99,1959,2058,0.2788028,0.2283239,3.08
1,100,1959,2059,0.3019394,0.2493668,2.84
1,101,1959,2060,0.3266317,0.2720754,2.62
1,102,1959,2061,0.3529236,0.2966083,2.41
1,103,1959,2062,0.3808502,0.3231547,2.21
1,104,1959,2063,0.4104359,0.3518161,2.03
1,105,1959,2064,0.4416930,0.3825603,1.86
1,106,1959,2065,0.4746198,0.4153817,1.70
1,107,1959,2066,0.5091990,0.4503932,1.55
1,108,1959,2067,0.5453968,0.4877099,1.42
1,109,1959,2068,0.5831612,0.5273323,1.29
1,110,1959,2069,0.6224217,0.5691268,1.18
1,111,1959,2070,0.6630882,0.6129877,1.07
1,112,1959,2071,0.7050519,0.6588903,0.97
1,113,1959,2072,0.7481851,0.7067751,0.86
1,114,1959,2073,0.7923424,0.7564699,0.74
1,115,1959,2074,1.0000000,1.0000000,0.50
1,40,1960,2000,0.0020513,0.0023538,42.09
1,41,1960,2001,0.0021897,0.0024674,41.19
1,42,1960,2002,0.0023342,0.0025892,40.29
1,43,1960,2003,0.0024669,0.0027059,39.39
1,44,1960,2004,0.0025867,0.0028178,38.50
1,45,1960,2005,0.0027191,0.0029478,37.60
1,46,1960,2006,0.0028925,0.0031158,36.71
1,47,1960,2007,0.0031101,0.0033258,35.83
1,48,1960,2008,0.0033571,0.0035573,34.94
1,49,1960,2009,0.0036304,0.0038030,34.07
1,50,1960,2010,0.0039379,0.0040731,33.20
1,51,1960,2011,0.0042708,0.0043608,32.33
1,52,1960,2012,0.0046082,0.0046481,31.47
1,53,1960,2013,0.0049489,0.0049347,30.61
1,54,1960,2014,0.0053157,0.0052364,29.76
1,55,1960,2015,0.0057365,0.0055752,28.92
1,56,1960,2016,0.0062406,0.0059842,28.08
1,57,1960,2017,0.0068502,0.0064916,27.24
1,58,1960,2018,0.0075521,0.0070870,26.42
1,59,1960,2019,0.0083035,0.0077160,25.60
1,60,1960,2020,0.0090849,0.0083467,24.80
1,61,1960,2021,0.0099105,0.0089944,24.00
1,62,1960,2022,0.0107829,0.0096677,23.22
1,63,1960,2023,0.0116995,0.0103681,22.44
1,64,1960,2024,0.0126957,0.0111228,21.67
1,65,1960,2025,0.0138071,0.0119519,20.90
1,66,1960,2026,0.0150054,0.0128327,20.15
1,67,1960,2027,0.0162315,0.0137027,19.41
1,68,1960,2028,0.0174919,0.0145643,18.67
1,69,1960,2029,0.0188954,0.0155143,17.94
1,70,1960,2030,0.0205786,0.0166705,17.21
1,71,1960,2031,0.0226142,0.0181330,16.50
1,72,1960,2032,0.0250119,0.0199441,15.79
1,73,1960,2033,0.0277519,0.0220901,15.10
1,74,1960,2034,0.0307579,0.0244756,14.43
1,75,1960,2035,0.0339099,0.0269284,13.78
1,76,1960,2036,0.0371478,0.0293669,13.15
1,77,1960,2037,0.0405123,0.0318284,12.53
1,78,1960,2038,0.0440886,0.0343929,11.93
1,79,1960,2039,0.0480027,0.0371606,11.34
1,80,1960,2040,0.0536037,0.0418042,10.75
1,81,1960,2041,0.0586892,0.0455310,10.20
1,82,1960,2042,0.0642414,0.0496164,9.66
1,83,1960,2043,0.0702997,0.0541305,9.14
1,84,1960,2044,0.0769067,0.0591001,8.64
1,85,1960,2045,0.0841076,0.0645248,8.15
1,86,1960,2046,0.0919504,0.0704826,7.68
1,87,1960,2047,0.1004863,0.0770781,7.22
1,88,1960,2048,0.1097689,0.0843839,6.78
1,89,1960,2049,0.1198550,0.0924013,6.36
1,90,1960,2050,0.1308036,0.1011347,5.96
1,91,1960,2051,0.1426766,0.1106818,5.57
1,92,1960,2052,0.1555375,0.1211795,5.20
1,93,1960,2053,0.1694519,0.1327177,4.85
1,94,1960,2054,0.1844867,0.1453018,4.51
1,95,1960,2055,0.2007091,0.1589683,4.20
1,96,1960,2056,0.2181866,0.1738612,3.90
1,97,1960,2057,0.2369856,0.1901598,3.61
1,98,1960,2058,0.2571705,0.2079839,3.34
1,99,1960,2059,0.2788028,0.2273439,3.09
1,100,1960,2060,0.3019394,0.2482737,2.85
1,101,1960,2061,0.3266317,0.2709336,2.63
1,102,1960,2062,0.3529236,0.2955165,2.42
1,103,1960,2063,0.3808502,0.3221336,2.22
1,104,1960,2064,0.4104359,0.3507659,2.03
1,105,1960,2065,0.4416930,0.3814212,1.86
1,106,1960,2066,0.4746198,0.4142298,1.71
1,107,1960,2067,0.5091990,0.4493304,1.56
1,108,1960,2068,0.5453968,0.4867509,1.42
1,109,1960,2069,0.5831612,0.5263836,1.29
1,110,1960,2070,0.6224217,0.5681493,1.18
1,111,1960,2071,0.6630882,0.6120595,1.07
1,112,1960,2072,0.7050519,0.6580970,0.97
1,113,1960,2073,0.7481851,0.7061296,0.87
1,114,1960,2074,0.7923424,0.7559108,0.74
1,115,1960,2075,1.0000000,1.0000000,0.50
1,39,1961,2000,0.0019305,0.0022232,43.11
1,40,1961,2001,0.0020513,0.0023204,42.20
1,41,1961,2002,0.0021897,0.0024362,41.30
1,42,1961,2003,0.0023342,0.0025640,40.40
1,43,1961,2004,0.0024669,0.0026865,39.50
1,44,1961,2005,0.0025867,0.0027985,38.60
1,45,1961,2006,0.0027191,0.0029266,37.71
1,46,1961,2007,0.0028925,0.0030935,36.82
1,47,1961,2008,0.0031101,0.0032984,35.93
1,48,1961,2009,0.0033571,0.0035187,35.05
1,49,1961,2010,0.0036304,0.0037551,34.17
1,50,1961,2011,0.0039379,0.0040205,33.30
1,51,1961,2012,0.0042708,0.0043075,32.43
1,52,1961,2013,0.0046082,0.0045952,31.57
1,53,1961,2014,0.0049489,0.0048761,30.71
1,54,1961,2015,0.0053157,0.0051679,29.86
1,55,1961,2016,0.0057365,0.0054997,29.01
1,56,1961,2017,0.0062406,0.0059082,28.17
1,57,1961,2018,0.0068502,0.0064166,27.34
1,58,1961,2019,0.0075521,0.0070056,26.51
1,59,1961,2020,0.0083035,0.0076217,25.69
1,60,1961,2021,0.0090849,0.0082434,24.89
1,61,1961,2022,0.0099105,0.0088898,24.09
1,62,1961,2023,0.0107829,0.0095627,23.30
1,63,1961,2024,0.0116995,0.0102517,22.52
1,64,1961,2025,0.0126957,0.0109866,21.75
1,65,1961,2026,0.0138071,0.0118023,20.99
1,66,1961,2027,0.0150054,0.0126818,20.23
1,67,1961,2028,0.0162315,0.0135524,19.48
1,68,1961,2029,0.0174919,0.0143983,18.74
1,69,1961,2030,0.0188954,0.0153193,18.01
1,70,1961,2031,0.0205786,0.0164551,17.28
1,71,1961,2032,0.0226142,0.0179150,16.56
1,72,1961,2033,0.0250119,0.0197285,15.86
1,73,1961,2034,0.0277519,0.0218556,15.17
1,74,1961,2035,0.0307579,0.0242054,14.49
1,75,1961,2036,0.0339099,0.0266354,13.84
1,76,1961,2037,0.0371478,0.0290736,13.21
1,77,1961,2038,0.0405123,0.0315381,12.59
1,78,1961,2039,0.0440886,0.0340736,11.98
1,79,1961,2040,0.0480027,0.0367871,11.38
1,80,1961,2041,0.0536037,0.0414020,10.80
1,81,1961,2042,0.0586892,0.0451254,10.25
1,82,1961,2043,0.0642414,0.0492146,9.71
1,83,1961,2044,0.0702997,0.0536917,9.18
1,84,1961,2045,0.0769067,0.0585908,8.67
1,85,1961,2046,0.0841076,0.0639697,8.18
1,86,1961,2047,0.0919504,0.0699270,7.71
1,87,1961,2048,0.1004863,0.0765314,7.25
1,88,1961,2049,0.1097689,0.0837895,6.81
1,89,1961,2050,0.1198550,0.0917175,6.39
1,90,1961,2051,0.1308036,0.1003973,5.98
1,91,1961,2052,0.1426766,0.1099502,5.59
1,92,1961,2053,0.1555375,0.1204612,5.22
1,93,1961,2054,0.1694519,0.1319352,4.87
1,94,1961,2055,0.1844867,0.1444065,4.53
1,95,1961,2056,0.2007091,0.1580126,4.21
1,96,1961,2057,0.2181866,0.1729254,3.91
1,97,1961,2058,0.2369856,0.1892624,3.62
1,98,1961,2059,0.2571705,0.2070358,3.35
1,99,1961,2060,0.2788028,0.2262817,3.10
1,100,1961,2061,0.3019394,0.2471588,2.86
1,101,1961,2062,0.3266317,0.2698616,2.63
1,102,1961,2063,0.3529236,0.2945079,2.42
1,103,1961,2064,0.3808502,0.3210893,2.23
1,104,1961,2065,0.4104359,0.3496247,2.04
1,105,1961,2066,0.4416930,0.3802576,1.87
1,106,1961,2067,0.4746198,0.4131460,1.71
1,107,1961,2068,0.5091990,0.4483418,1.56
1,108,1961,2069,0.5453968,0.4857607,1.42
1,109,1961,2070,0.5831612,0.5253485,1.30
1,110,1961,2071,0.6224217,0.5671495,1.18
1,111,1961,2072,0.6630882,0.6111870,1.07
1,112,1961,2073,0.7050519,0.6573685,0.97
1,113,1961,2074,0.7481851,0.7054767,0.87
1,114,1961,2075,0.7923424,0.7553046,0.74
1,115,1961,2076,1.0000000,1.0000000,0.50
1,38,1962,2000,0.0018255,0.0021069,44.12
1,39,1962,2001,0.0019305,0.0021908,43.22
1,40,1962,2002,0.0020513,0.0022901,42.31
1,41,1962,2003,0.0021897,0.0024119,41.41
1,42,1962,2004,0.0023342,0.0025453,40.51
1,43,1962,2005,0.0024669,0.0026682,39.61
1,44,1962,2006,0.0025867,0.0027789,38.71
1,45,1962,2007,0.0027191,0.0029060,37.82
1,46,1962,2008,0.0028925,0.0030680,36.93
1,47,1962,2009,0.0031101,0.0032620,36.04
1,48,1962,2010,0.0033571,0.0034737,35.16
1,49,1962,2011,0.0036304,0.0037066,34.28
1,50,1962,2012,0.0039379,0.0039716,33.40
1,51,1962,2013,0.0042708,0.0042588,32.53
1,52,1962,2014,0.0046082,0.0045416,31.67
1,53,1962,2015,0.0049489,0.0048132,30.81
1,54,1962,2016,0.0053157,0.0050986,29.96
1,55,1962,2017,0.0057365,0.0054295,29.11
1,56,1962,2018,0.0062406,0.0058387,28.27
1,57,1962,2019,0.0068502,0.0063408,27.43
1,58,1962,2020,0.0075521,0.0069180,26.60
1,59,1962,2021,0.0083035,0.0075264,25.78
1,60,1962,2022,0.0090849,0.0081473,24.98
1,61,1962,2023,0.0099105,0.0087937,24.18
1,62,1962,2024,0.0107829,0.0094560,23.39
1,63,1962,2025,0.0116995,0.0101263,22.60
1,64,1962,2026,0.0126957,0.0108488,21.83
1,65,1962,2027,0.0138071,0.0116631,21.06
1,66,1962,2028,0.0150054,0.0125436,20.31
1,67,1962,2029,0.0162315,0.0134003,19.56
1,68,1962,2030,0.0174919,0.0142196,18.82
1,69,1962,2031,0.0188954,0.0151221,18.08
1,70,1962,2032,0.0205786,0.0162548,17.35
1,71,1962,2033,0.0226142,0.0177158,16.63
1,72,1962,2034,0.0250119,0.0195109,15.92
1,73,1962,2035,0.0277519,0.0216034,15.23
1,74,1962,2036,0.0307579,0.0239317,14.55
1,75,1962,2037,0.0339099,0.0263621,13.90
1,76,1962,2038,0.0371478,0.0288043,13.26
1,77,1962,2039,0.0405123,0.0312429,12.64
1,78,1962,2040,0.0440886,0.0337289,12.03
1,79,1962,2041,0.0480027,0.0364084,11.43
1,80,1962,2042,0.0536037,0.0410268,10.85
1,81,1962,2043,0.0586892,0.0447538,10.29
1,82,1962,2044,0.0642414,0.0488080,9.75
1,83,1962,2045,0.0702997,0.0532183,9.22
1,84,1962,2046,0.0769067,0.0580737,8.71
1,85,1962,2047,0.0841076,0.0634509,8.22
1,86,1962,2048,0.0919504,0.0694152,7.74
1,87,1962,2049,0.1004863,0.0759735,7.28
1,88,1962,2050,0.1097689,0.0831461,6.84
1,89,1962,2051,0.1198550,0.0910223,6.41
1,90,1962,2052,0.1308036,0.0997062,6.01
1,91,1962,2053,0.1426766,0.1092703,5.62
1,92,1962,2054,0.1555375,0.1197188,5.24
1,93,1962,2055,0.1694519,0.1310837,4.89
1,94,1962,2056,0.1844867,0.1434952,4.55
1,95,1962,2057,0.2007091,0.1571175,4.23
1,96,1962,2058,0.2181866,0.1720642,3.93
1,97,1962,2059,0.2369856,0.1883491,3.64
1,98,1962,2060,0.2571705,0.2060085,3.37
1,99,1962,2061,0.2788028,0.2251986,3.11
1,100,1962,2062,0.3019394,0.2461124,2.87
1,101,1962,2063,0.3266317,0.2688717,2.64
1,102,1962,2064,0.3529236,0.2934767,2.43
1,103,1962,2065,0.3808502,0.3199549,2.23
1,104,1962,2066,0.4104359,0.3484593,2.05
1,105,1962,2067,0.4416930,0.3791630,1.87
1,106,1962,2068,0.4746198,0.4121380,1.71
1,107,1962,2069,0.5091990,0.4473213,1.57
1,108,1962,2070,0.5453968,0.4846806,1.43
1,109,1962,2071,0.5831612,0.5242900,1.30
1,110,1962,2072,0.6224217,0.5662099,1.18
1,111,1962,2073,0.6630882,0.6103860,1.07
1,112,1962,2074,0.7050519,0.6566316,0.97
1,113,1962,2075,0.7481851,0.7047690,0.87
1,114,1962,2076,0.7923424,0.7546841,0.75
1,115,1962,2077,1.0000000,1.0000000,0.50
1,37,1963,2000,0.0017318,0.0019973,45.15
1,38,1963,2001,0.0018255,0.0020757,44.24
1,39,1963,2002,0.0019305,0.0021614,43.33
1,40,1963,2003,0.0020513,0.0022664,42.42
1,41,1963,2004,0.0021897,0.0023938,41.52
1,42,1963,2005,0.0023342,0.0025277,40.61
1,43,1963,2006,0.0024669,0.0026495,39.72
1,44,1963,2007,0.0025867,0.0027597,38.82
1,45,1963,2008,0.0027191,0.0028822,37.93
1,46,1963,2009,0.0028925,0.0030341,37.03
1,47,1963,2010,0.0031101,0.0032198,36.15
1,48,1963,2011,0.0033571,0.0034283,35.26
1,49,1963,2012,0.0036304,0.0036615,34.38
1,50,1963,2013,0.0039379,0.0039269,33.51
1,51,1963,2014,0.0042708,0.0042095,32.64
1,52,1963,2015,0.0046082,0.0044841,31.77
1,53,1963,2016,0.0049489,0.0047497,30.91
1,54,1963,2017,0.0053157,0.0050343,30.06
1,55,1963,2018,0.0057365,0.0053653,29.21
1,56,1963,2019,0.0062406,0.0057685,28.36
1,57,1963,2020,0.0068502,0.0062592,27.52
1,58,1963,2021,0.0075521,0.0068295,26.69
1,59,1963,2022,0.0083035,0.0074377,25.87
1,60,1963,2023,0.0090849,0.0080590,25.06
1,61,1963,2024,0.0099105,0.0086960,24.26
1,62,1963,2025,0.0107829,0.0093410,23.47
1,63,1963,2026,0.0116995,0.0099995,22.69
1,64,1963,2027,0.0126957,0.0107207,21.91
1,65,1963,2028,0.0138071,0.0115357,21.14
1,66,1963,2029,0.0150054,0.0124037,20.39
1,67,1963,2030,0.0162315,0.0132365,19.64
1,68,1963,2031,0.0174919,0.0140389,18.89
1,69,1963,2032,0.0188954,0.0149388,18.15
1,70,1963,2033,0.0205786,0.0160719,17.42
1,71,1963,2034,0.0226142,0.0175148,16.70
1,72,1963,2035,0.0250119,0.0192768,15.99
1,73,1963,2036,0.0277519,0.0213481,15.29
1,74,1963,2037,0.0307579,0.0236766,14.61
1,75,1963,2038,0.0339099,0.0261113,13.96
1,76,1963,2039,0.0371478,0.0285305,13.32
1,77,1963,2040,0.0405123,0.0309244,12.69
1,78,1963,2041,0.0440886,0.0333796,12.08
1,79,1963,2042,0.0480027,0.0360554,11.48
1,80,1963,2043,0.0536037,0.0406832,10.89
1,81,1963,2044,0.0586892,0.0443777,10.33
1,82,1963,2045,0.0642414,0.0483696,9.79
1,83,1963,2046,0.0702997,0.0527379,9.26
1,84,1963,2047,0.0769067,0.0575906,8.75
1,85,1963,2048,0.0841076,0.0629731,8.25
1,86,1963,2049,0.0919504,0.0688931,7.78
1,87,1963,2050,0.1004863,0.0753698,7.31
1,88,1963,2051,0.1097689,0.0824923,6.87
1,89,1963,2052,0.1198550,0.0903711,6.44
1,90,1963,2053,0.1308036,0.0990643,6.03
1,91,1963,2054,0.1426766,0.1085679,5.64
1,92,1963,2055,0.1555375,0.1189113,5.27
1,93,1963,2056,0.1694519,0.1302172,4.91
1,94,1963,2057,0.1844867,0.1426418,4.57
1,95,1963,2058,0.2007091,0.1562939,4.25
1,96,1963,2059,0.2181866,0.1711880,3.94
1,97,1963,2060,0.2369856,0.1873599,3.65
1,98,1963,2061,0.2571705,0.2049613,3.38
1,99,1963,2062,0.2788028,0.2241824,3.12
1,100,1963,2063,0.3019394,0.2451463,2.88
1,101,1963,2064,0.3266317,0.2678599,2.65
1,102,1963,2065,0.3529236,0.2923568,2.44
1,103,1963,2066,0.3808502,0.3187968,2.24
1,104,1963,2067,0.4104359,0.3473633,2.05
1,105,1963,2068,0.4416930,0.3781452,1.88
1,106,1963,2069,0.4746198,0.4110978,1.72
1,107,1963,2070,0.5091990,0.4462083,1.57
1,108,1963,2071,0.5453968,0.4835763,1.43
1,109,1963,2072,0.5831612,0.5232956,1.30
1,110,1963,2073,0.6224217,0.5653475,1.18
1,111,1963,2074,0.6630882,0.6095760,1.07
1,112,1963,2075,0.7050519,0.6558332,0.97
1,113,1963,2076,0.7481851,0.7040448,0.87
1,114,1963,2077,0.7923424,0.7540992,0.75
1,115,1963,2078,1.0000000,1.0000000,0.50
1,36,1964,2000,0.0016525,0.0018972,46.17
1,37,1964,2001,0.0017318,0.0019679,45.26
1,38,1964,2002,0.0018255,0.0020475,44.35
1,39,1964,2003,0.0019305,0.0021385,43.44
1,40,1964,2004,0.0020513,0.0022489,42.53
1,41,1964,2005,0.0021897,0.0023767,41.63
1,42,1964,2006,0.0023342,0.0025098,40.72
1,43,1964,2007,0.0024669,0.0026313,39.83
1,44,1964,2008,0.0025867,0.0027378,38.93
1,45,1964,2009,0.0027191,0.0028508,38.03
1,46,1964,2010,0.0028925,0.0029947,37.14
1,47,1964,2011,0.0031101,0.0031771,36.25
1,48,1964,2012,0.0033571,0.0033861,35.37
1,49,1964,2013,0.0036304,0.0036203,34.48
1,50,1964,2014,0.0039379,0.0038817,33.61
1,51,1964,2015,0.0042708,0.0041566,32.74
1,52,1964,2016,0.0046082,0.0044259,31.87
1,53,1964,2017,0.0049489,0.0046906,31.01
1,54,1964,2018,0.0053157,0.0049754,30.15
1,55,1964,2019,0.0057365,0.0053005,29.30
1,56,1964,2020,0.0062406,0.0056930,28.46
1,57,1964,2021,0.0068502,0.0061768,27.62
1,58,1964,2022,0.0075521,0.0067471,26.78
1,59,1964,2023,0.0083035,0.0073562,25.96
1,60,1964,2024,0.0090849,0.0079693,25.15
1,61,1964,2025,0.0099105,0.0085907,24.35
1,62,1964,2026,0.0107829,0.0092248,23.56
1,63,1964,2027,0.0116995,0.0098815,22.77
1,64,1964,2028,0.0126957,0.0106033,21.99
1,65,1964,2029,0.0138071,0.0114066,21.22
1,66,1964,2030,0.0150054,0.0122531,20.46
1,67,1964,2031,0.0162315,0.0130708,19.71
1,68,1964,2032,0.0174919,0.0138709,18.97
1,69,1964,2033,0.0188954,0.0147713,18.22
1,70,1964,2034,0.0205786,0.0158872,17.49
1,71,1964,2035,0.0226142,0.0172987,16.76
1,72,1964,2036,0.0250119,0.0190400,16.05
1,73,1964,2037,0.0277519,0.0211104,15.35
1,74,1964,2038,0.0307579,0.0234426,14.67
1,75,1964,2039,0.0339099,0.0258564,14.01
1,76,1964,2040,0.0371478,0.0282351,13.37
1,77,1964,2041,0.0405123,0.0306015,12.75
1,78,1964,2042,0.0440886,0.0330540,12.13
1,79,1964,2043,0.0480027,0.0357324,11.53
1,80,1964,2044,0.0536037,0.0403355,10.94
1,81,1964,2045,0.0586892,0.0439723,10.38
1,82,1964,2046,0.0642414,0.0479246,9.83
1,83,1964,2047,0.0702997,0.0522891,9.30
1,84,1964,2048,0.0769067,0.0571457,8.79
1,85,1964,2049,0.0841076,0.0624858,8.29
1,86,1964,2050,0.0919504,0.0683282,7.81
1,87,1964,2051,0.1004863,0.0747564,7.35
1,88,1964,2052,0.1097689,0.0818799,6.90
1,89,1964,2053,0.1198550,0.0897662,6.47
1,90,1964,2054,0.1308036,0.0984012,6.06
1,91,1964,2055,0.1426766,0.1078040,5.66
1,92,1964,2056,0.1555375,0.1180898,5.29
1,93,1964,2057,0.1694519,0.1294061,4.93
1,94,1964,2058,0.1844867,0.1418569,4.59
1,95,1964,2059,0.2007091,0.1554562,4.26
1,96,1964,2060,0.2181866,0.1702391,3.96
1,97,1964,2061,0.2369856,0.1863518,3.67
1,98,1964,2062,0.2571705,0.2039792,3.39
1,99,1964,2063,0.2788028,0.2232445,3.13
1,100,1964,2064,0.3019394,0.2441591,2.89
1,101,1964,2065,0.3266317,0.2667614,2.66
1,102,1964,2066,0.3529236,0.2912140,2.45
1,103,1964,2067,0.3808502,0.3177079,2.25
1,104,1964,2068,0.4104359,0.3463446,2.06
1,105,1964,2069,0.4416930,0.3770952,1.88
1,106,1964,2070,0.4746198,0.4099636,1.72
1,107,1964,2071,0.5091990,0.4450708,1.57
1,108,1964,2072,0.5453968,0.4825391,1.43
1,109,1964,2073,0.5831612,0.5223830,1.31
1,110,1964,2074,0.6224217,0.5644755,1.19
1,111,1964,2075,0.6630882,0.6086984,1.08
1,112,1964,2076,0.7050519,0.6550161,0.97
1,113,1964,2077,0.7481851,0.7033621,0.87
1,114,1964,2078,0.7923424,0.7535540,0.75
1,115,1964,2079,1.0000000,1.0000000,0.50
1,35,1965,2000,0.0015941,0.0018190,47.20
1,36,1965,2001,0.0016525,0.0018701,46.29
1,37,1965,2002,0.0017318,0.0019412,45.37
1,38,1965,2003,0.0018255,0.0020255,44.46
1,39,1965,2004,0.0019305,0.0021215,43.55
1,40,1965,2005,0.0020513,0.0022324,42.64
1,41,1965,2006,0.0021897,0.0023594,41.74
1,42,1965,2007,0.0023342,0.0024923,40.83
1,43,1965,2008,0.0024669,0.0026105,39.93
1,44,1965,2009,0.0025867,0.0027086,39.04
1,45,1965,2010,0.0027191,0.0028142,38.14
1,46,1965,2011,0.0028925,0.0029550,37.25
1,47,1965,2012,0.0031101,0.0031374,36.36
1,48,1965,2013,0.0033571,0.0033476,35.47
1,49,1965,2014,0.0036304,0.0035786,34.59
1,50,1965,2015,0.0039379,0.0038331,33.71
1,51,1965,2016,0.0042708,0.0041030,32.84
1,52,1965,2017,0.0046082,0.0043718,31.97
1,53,1965,2018,0.0049489,0.0046365,31.11
1,54,1965,2019,0.0053157,0.0049159,30.25
1,55,1965,2020,0.0057365,0.0052307,29.40
1,56,1965,2021,0.0062406,0.0056167,28.55
1,57,1965,2022,0.0068502,0.0061001,27.71
1,58,1965,2023,0.0075521,0.0066715,26.88
1,59,1965,2024,0.0083035,0.0072735,26.05
1,60,1965,2025,0.0090849,0.0078726,25.24
1,61,1965,2026,0.0099105,0.0084842,24.44
1,62,1965,2027,0.0107829,0.0091166,23.64
1,63,1965,2028,0.0116995,0.0097735,22.85
1,64,1965,2029,0.0126957,0.0104844,22.07
1,65,1965,2030,0.0138071,0.0112677,21.30
1,66,1965,2031,0.0150054,0.0121008,20.54
1,67,1965,2032,0.0162315,0.0129168,19.79
1,68,1965,2033,0.0174919,0.0137174,19.04
1,69,1965,2034,0.0188954,0.0146023,18.30
1,70,1965,2035,0.0205786,0.0156888,17.56
1,71,1965,2036,0.0226142,0.0170801,16.83
1,72,1965,2037,0.0250119,0.0188196,16.12
1,73,1965,2038,0.0277519,0.0208923,15.42
1,74,1965,2039,0.0307579,0.0232048,14.73
1,75,1965,2040,0.0339099,0.0255814,14.07
1,76,1965,2041,0.0371478,0.0279357,13.43
1,77,1965,2042,0.0405123,0.0303006,12.80
1,78,1965,2043,0.0440886,0.0327560,12.18
1,79,1965,2044,0.0480027,0.0354057,11.58
1,80,1965,2045,0.0536037,0.0399608,10.99
1,81,1965,2046,0.0586892,0.0435610,10.42
1,82,1965,2047,0.0642414,0.0475090,9.87
1,83,1965,2048,0.0702997,0.0518760,9.34
1,84,1965,2049,0.0769067,0.0566921,8.83
1,85,1965,2050,0.0841076,0.0619587,8.33
1,86,1965,2051,0.0919504,0.0677545,7.84
1,87,1965,2052,0.1004863,0.0741822,7.38
1,88,1965,2053,0.1097689,0.0813113,6.93
1,89,1965,2054,0.1198550,0.0891417,6.50
1,90,1965,2055,0.1308036,0.0976804,6.08
1,91,1965,2056,0.1426766,0.1070272,5.69
1,92,1965,2057,0.1555375,0.1173211,5.31
1,93,1965,2058,0.1694519,0.1286603,4.95
1,94,1965,2059,0.1844867,0.1410588,4.61
1,95,1965,2060,0.2007091,0.1545495,4.28
1,96,1965,2061,0.2181866,0.1692725,3.97
1,97,1965,2062,0.2369856,0.1854066,3.68
1,98,1965,2063,0.2571705,0.2030729,3.40
1,99,1965,2064,0.2788028,0.2222864,3.14
1,100,1965,2065,0.3019394,0.2430877,2.90
1,101,1965,2066,0.3266317,0.2656406,2.67
1,102,1965,2067,0.3529236,0.2901397,2.45
1,103,1965,2068,0.3808502,0.3166961,2.25
1,104,1965,2069,0.4104359,0.3452938,2.07
1,105,1965,2070,0.4416930,0.3759506,1.89
1,106,1965,2071,0.4746198,0.4088047,1.73
1,107,1965,2072,0.5091990,0.4440026,1.58
1,108,1965,2073,0.5453968,0.4815875,1.44
1,109,1965,2074,0.5831612,0.5214605,1.31
1,110,1965,2075,0.6224217,0.5635309,1.19
1,111,1965,2076,0.6630882,0.6078005,1.08
1,112,1965,2077,0.7050519,0.6542462,0.97
1,113,1965,2078,0.7481851,0.7027259,0.87
1,114,1965,2079,0.7923424,0.7529900,0.75
1,115,1965,2080,1.0000000,1.0000000,0.50
1,34,1966,2000,0.0015540,0.0017588,48.23
1,35,1966,2001,0.0015941,0.0017942,47.32
1,36,1966,2002,0.0016525,0.0018456,46.40
1,37,1966,2003,0.0017318,0.0019204,45.49
1,38,1966,2004,0.0018255,0.0020091,44.57
1,39,1966,2005,0.0019305,0.0021055,43.66
1,40,1966,2006,0.0020513,0.0022156,42.75
1,41,1966,2007,0.0021897,0.0023425,41.85
1,42,1966,2008,0.0023342,0.0024722,40.94
1,43,1966,2009,0.0024669,0.0025828,40.04
1,44,1966,2010,0.0025867,0.0026748,39.15
1,45,1966,2011,0.0027191,0.0027772,38.25
1,46,1966,2012,0.0028925,0.0029180,37.35
1,47,1966,2013,0.0031101,0.0031011,36.46
1,48,1966,2014,0.0033571,0.0033086,35.57
1,49,1966,2015,0.0036304,0.0035338,34.69
1,50,1966,2016,0.0039379,0.0037839,33.81
1,51,1966,2017,0.0042708,0.0040532,32.94
1,52,1966,2018,0.0046082,0.0043223,32.07
1,53,1966,2019,0.0049489,0.0045819,31.21
1,54,1966,2020,0.0053157,0.0048520,30.35
1,55,1966,2021,0.0057365,0.0051603,29.49
1,56,1966,2022,0.0062406,0.0055457,28.64
1,57,1966,2023,0.0068502,0.0060298,27.80
1,58,1966,2024,0.0075521,0.0065947,26.97
1,59,1966,2025,0.0083035,0.0071843,26.14
1,60,1966,2026,0.0090849,0.0077749,25.33
1,61,1966,2027,0.0099105,0.0083851,24.52
1,62,1966,2028,0.0107829,0.0090175,23.73
1,63,1966,2029,0.0116995,0.0096641,22.94
1,64,1966,2030,0.0126957,0.0103565,22.16
1,65,1966,2031,0.0138071,0.0111273,21.38
1,66,1966,2032,0.0150054,0.0119591,20.62
1,67,1966,2033,0.0162315,0.0127760,19.86
1,68,1966,2034,0.0174919,0.0135624,19.11
1,69,1966,2035,0.0188954,0.0144206,18.37
1,70,1966,2036,0.0205786,0.0154881,17.63
1,71,1966,2037,0.0226142,0.0168767,16.90
1,72,1966,2038,0.0250119,0.0186175,16.18
1,73,1966,2039,0.0277519,0.0206708,15.48
1,74,1966,2040,0.0307579,0.0229484,14.79
1,75,1966,2041,0.0339099,0.0253028,14.13
1,76,1966,2042,0.0371478,0.0276567,13.48
1,77,1966,2043,0.0405123,0.0300252,12.85
1,78,1966,2044,0.0440886,0.0324546,12.24
1,79,1966,2045,0.0480027,0.0350538,11.63
1,80,1966,2046,0.0536037,0.0395806,11.03
1,81,1966,2047,0.0586892,0.0431768,10.47
1,82,1966,2048,0.0642414,0.0471265,9.92
1,83,1966,2049,0.0702997,0.0514548,9.38
1,84,1966,2050,0.0769067,0.0562015,8.86
1,85,1966,2051,0.0841076,0.0614235,8.36
1,86,1966,2052,0.0919504,0.0672174,7.88
1,87,1966,2053,0.1004863,0.0736491,7.41
1,88,1966,2054,0.1097689,0.0807244,6.96
1,89,1966,2055,0.1198550,0.0884629,6.53
1,90,1966,2056,0.1308036,0.0969475,6.11
1,91,1966,2057,0.1426766,0.1063005,5.71
1,92,1966,2058,0.1555375,0.1166144,5.33
1,93,1966,2059,0.1694519,0.1279022,4.97
1,94,1966,2060,0.1844867,0.1401950,4.63
1,95,1966,2061,0.2007091,0.1536260,4.30
1,96,1966,2062,0.2181866,0.1683666,3.99
1,97,1966,2063,0.2369856,0.1845347,3.69
1,98,1966,2064,0.2571705,0.2021475,3.42
1,99,1966,2065,0.2788028,0.2212469,3.15
1,100,1966,2066,0.3019394,0.2419949,2.91
1,101,1966,2067,0.3266317,0.2645875,2.68
1,102,1966,2068,0.3529236,0.2891418,2.46
1,103,1966,2069,0.3808502,0.3156527,2.26
1,104,1966,2070,0.4104359,0.3441487,2.07
1,105,1966,2071,0.4416930,0.3747814,1.90
1,106,1966,2072,0.4746198,0.4077168,1.73
1,107,1966,2073,0.5091990,0.4430228,1.58
1,108,1966,2074,0.5453968,0.4806257,1.44
1,109,1966,2075,0.5831612,0.5204613,1.31
1,110,1966,2076,0.6224217,0.5625648,1.19
1,111,1966,2077,0.6630882,0.6069545,1.08
1,112,1966,2078,0.7050519,0.6535287,0.98
1,113,1966,2079,0.7481851,0.7020678,0.87
1,114,1966,2080,0.7923424,0.7523738,0.75
1,115,1966,2081,1.0000000,1.0000000,0.50
1,33,1967,2000,0.0015203,0.0017103,49.26
1,34,1967,2001,0.0015540,0.0017363,48.35
1,35,1967,2002,0.0015941,0.0017717,47.43
1,36,1967,2003,0.0016525,0.0018265,46.51
1,37,1967,2004,0.0017318,0.0019051,45.60
1,38,1967,2005,0.0018255,0.0019937,44.68
1,39,1967,2006,0.0019305,0.0020893,43.77
1,40,1967,2007,0.0020513,0.0021992,42.86
1,41,1967,2008,0.0021897,0.0023231,41.96
1,42,1967,2009,0.0023342,0.0024456,41.05
1,43,1967,2010,0.0024669,0.0025506,40.15
1,44,1967,2011,0.0025867,0.0026405,39.25
1,45,1967,2012,0.0027191,0.0027428,38.36
1,46,1967,2013,0.0028925,0.0028842,37.46
1,47,1967,2014,0.0031101,0.0030645,36.57
1,48,1967,2015,0.0033571,0.0032666,35.68
1,49,1967,2016,0.0036304,0.0034886,34.79
1,50,1967,2017,0.0039379,0.0037382,33.91
1,51,1967,2018,0.0042708,0.0040077,33.04
1,52,1967,2019,0.0046082,0.0042722,32.17
1,53,1967,2020,0.0049489,0.0045231,31.31
1,54,1967,2021,0.0053157,0.0047874,30.45
1,55,1967,2022,0.0057365,0.0050948,29.59
1,56,1967,2023,0.0062406,0.0054806,28.74
1,57,1967,2024,0.0068502,0.0059584,27.89
1,58,1967,2025,0.0075521,0.0065119,27.06
1,59,1967,2026,0.0083035,0.0070941,26.23
1,60,1967,2027,0.0090849,0.0076839,25.42
1,61,1967,2028,0.0099105,0.0082944,24.61
1,62,1967,2029,0.0107829,0.0089171,23.81
1,63,1967,2030,0.0116995,0.0095463,23.02
1,64,1967,2031,0.0126957,0.0102272,22.24
1,65,1967,2032,0.0138071,0.0109966,21.46
1,66,1967,2033,0.0150054,0.0118297,20.69
1,67,1967,2034,0.0162315,0.0126338,19.94
1,68,1967,2035,0.0174919,0.0133959,19.19
1,69,1967,2036,0.0188954,0.0142369,18.44
1,70,1967,2037,0.0205786,0.0153014,17.70
1,71,1967,2038,0.0226142,0.0166903,16.97
1,72,1967,2039,0.0250119,0.0184123,16.24
1,73,1967,2040,0.0277519,0.0204322,15.54
1,74,1967,2041,0.0307579,0.0226888,14.85
1,75,1967,2042,0.0339099,0.0250433,14.19
1,76,1967,2043,0.0371478,0.0274015,13.54
1,77,1967,2044,0.0405123,0.0297468,12.91
1,78,1967,2045,0.0440886,0.0321300,12.29
1,79,1967,2046,0.0480027,0.0346970,11.68
1,80,1967,2047,0.0536037,0.0392256,11.08
1,81,1967,2048,0.0586892,0.0428233,10.51
1,82,1967,2049,0.0642414,0.0467366,9.96
1,83,1967,2050,0.0702997,0.0509994,9.42
1,84,1967,2051,0.0769067,0.0557036,8.90
1,85,1967,2052,0.0841076,0.0609226,8.40
1,86,1967,2053,0.0919504,0.0667191,7.91
1,87,1967,2054,0.1004863,0.0730990,7.44
1,88,1967,2055,0.1097689,0.0800867,6.99
1,89,1967,2056,0.1198550,0.0877731,6.55
1,90,1967,2057,0.1308036,0.0962621,6.14
1,91,1967,2058,0.1426766,0.1056326,5.74
1,92,1967,2059,0.1555375,0.1158963,5.35
1,93,1967,2060,0.1694519,0.1270820,4.99
1,94,1967,2061,0.1844867,0.1393157,4.64
1,95,1967,2062,0.2007091,0.1527608,4.31
1,96,1967,2063,0.2181866,0.1675311,4.00
1,97,1967,2064,0.2369856,0.1836447,3.71
1,98,1967,2065,0.2571705,0.2011436,3.43
1,99,1967,2066,0.2788028,0.2201869,3.17
1,100,1967,2067,0.3019394,0.2409685,2.92
1,101,1967,2068,0.3266317,0.2636095,2.69
1,102,1967,2069,0.3529236,0.2881130,2.47
1,103,1967,2070,0.3808502,0.3145160,2.27
1,104,1967,2071,0.4104359,0.3429794,2.08
1,105,1967,2072,0.4416930,0.3736841,1.90
1,106,1967,2073,0.4746198,0.4067191,1.74
1,107,1967,2074,0.5091990,0.4420329,1.58
1,108,1967,2075,0.5453968,0.4795844,1.44
1,109,1967,2076,0.5831612,0.5194396,1.31
1,110,1967,2077,0.6224217,0.5616546,1.19
1,111,1967,2078,0.6630882,0.6061664,1.08
1,112,1967,2079,0.7050519,0.6527866,0.98
1,113,1967,2080,0.7481851,0.7013488,0.87
1,114,1967,2081,0.7923424,0.7517431,0.75
1,115,1967,2082,1.0000000,1.0000000,0.50
1,32,1968,2000,0.0014859,0.0016651,50.30
1,33,1968,2001,0.0015203,0.0016894,49.38
1,34,1968,2002,0.0015540,0.0017159,48.46
1,35,1968,2003,0.0015941,0.0017541,47.54
1,36,1968,2004,0.0016525,0.0018123,46.63
1,37,1968,2005,0.0017318,0.0018905,45.71
1,38,1968,2006,0.0018255,0.0019781,44.80
1,39,1968,2007,0.0019305,0.0020734,43.88
1,40,1968,2008,0.0020513,0.0021804,42.97
1,41,1968,2009,0.0021897,0.0022973,42.07
1,42,1968,2010,0.0023342,0.0024146,41.16
1,43,1968,2011,0.0024669,0.0025180,40.26
1,44,1968,2012,0.0025867,0.0026086,39.36
1,45,1968,2013,0.0027191,0.0027114,38.46
1,46,1968,2014,0.0028925,0.0028500,37.57
1,47,1968,2015,0.0031101,0.0030251,36.67
1,48,1968,2016,0.0033571,0.0032243,35.78
1,49,1968,2017,0.0036304,0.0034464,34.90
1,50,1968,2018,0.0039379,0.0036964,34.01
1,51,1968,2019,0.0042708,0.0039616,33.14
1,52,1968,2020,0.0046082,0.0042184,32.27
1,53,1968,2021,0.0049489,0.0044637,31.40
1,54,1968,2022,0.0053157,0.0047273,30.54
1,55,1968,2023,0.0057365,0.0050347,29.68
1,56,1968,2024,0.0062406,0.0054146,28.83
1,57,1968,2025,0.0068502,0.0058815,27.99
1,58,1968,2026,0.0075521,0.0064282,27.15
1,59,1968,2027,0.0083035,0.0070102,26.32
1,60,1968,2028,0.0090849,0.0076006,25.50
1,61,1968,2029,0.0099105,0.0082025,24.69
1,62,1968,2030,0.0107829,0.0088091,23.90
1,63,1968,2031,0.0116995,0.0094272,23.10
1,64,1968,2032,0.0126957,0.0101068,22.32
1,65,1968,2033,0.0138071,0.0108772,21.54
1,66,1968,2034,0.0150054,0.0116989,20.77
1,67,1968,2035,0.0162315,0.0124810,20.01
1,68,1968,2036,0.0174919,0.0132274,19.26
1,69,1968,2037,0.0188954,0.0140660,18.51
1,70,1968,2038,0.0205786,0.0151304,17.77
1,71,1968,2039,0.0226142,0.0165012,17.03
1,72,1968,2040,0.0250119,0.0181913,16.31
1,73,1968,2041,0.0277519,0.0201906,15.60
1,74,1968,2042,0.0307579,0.0224471,14.91
1,75,1968,2043,0.0339099,0.0248059,14.24
1,76,1968,2044,0.0371478,0.0271434,13.59
1,77,1968,2045,0.0405123,0.0294469,12.96
1,78,1968,2046,0.0440886,0.0318010,12.34
1,79,1968,2047,0.0480027,0.0343641,11.73
1,80,1968,2048,0.0536037,0.0388990,11.13
1,81,1968,2049,0.0586892,0.0424630,10.56
1,82,1968,2050,0.0642414,0.0463152,10.00
1,83,1968,2051,0.0702997,0.0505372,9.46
1,84,1968,2052,0.0769067,0.0552377,8.94
1,85,1968,2053,0.0841076,0.0604579,8.43
1,86,1968,2054,0.0919504,0.0662049,7.95
1,87,1968,2055,0.1004863,0.0725015,7.47
1,88,1968,2056,0.1097689,0.0794388,7.02
1,89,1968,2057,0.1198550,0.0871281,6.58
1,90,1968,2058,0.1308036,0.0956325,6.16
1,91,1968,2059,0.1426766,0.1049541,5.76
1,92,1968,2060,0.1555375,0.1151196,5.38
1,93,1968,2061,0.1694519,0.1262473,5.01
1,94,1968,2062,0.1844867,0.1384921,4.66
1,95,1968,2063,0.2007091,0.1519630,4.33
1,96,1968,2064,0.2181866,0.1666784,4.02
1,97,1968,2065,0.2369856,0.1826795,3.72
1,98,1968,2066,0.2571705,0.2001204,3.44
1,99,1968,2067,0.2788028,0.2191916,3.18
1,100,1968,2068,0.3019394,0.2400155,2.93
1,101,1968,2069,0.3266317,0.2626015,2.70
1,102,1968,2070,0.3529236,0.2869926,2.48
1,103,1968,2071,0.3808502,0.3133557,2.27
1,104,1968,2072,0.4104359,0.3418824,2.08
1,105,1968,2073,0.4416930,0.3726782,1.91
1,106,1968,2074,0.4746198,0.4057113,1.74
1,107,1968,2075,0.5091990,0.4409612,1.59
1,108,1968,2076,0.5453968,0.4785197,1.45
1,109,1968,2077,0.5831612,0.5184773,1.32
1,110,1968,2078,0.6224217,0.5608069,1.20
1,111,1968,2079,0.6630882,0.6053513,1.08
1,112,1968,2080,0.7050519,0.6519761,0.98
1,113,1968,2081,0.7481851,0.7006131,0.87
1,114,1968,2082,0.7923424,0.7511493,0.75
1,115,1968,2083,1.0000000,1.0000000,0.50
1,31,1969,2000,0.0014530,0.0016243,51.33
1,32,1969,2001,0.0014859,0.0016455,50.41
1,33,1969,2002,0.0015203,0.0016705,49.49
1,34,1969,2003,0.0015540,0.0016999,48.57
1,35,1969,2004,0.0015941,0.0017411,47.66
1,36,1969,2005,0.0016525,0.0017989,46.74
1,37,1969,2006,0.0017318,0.0018758,45.82
1,38,1969,2007,0.0018255,0.0019628,44.91
1,39,1969,2008,0.0019305,0.0020552,43.99
1,40,1969,2009,0.0020513,0.0021554,43.08
1,41,1969,2010,0.0021897,0.0022674,42.18
1,42,1969,2011,0.0023342,0.0023833,41.27
1,43,1969,2012,0.0024669,0.0024877,40.37
1,44,1969,2013,0.0025867,0.0025795,39.47
1,45,1969,2014,0.0027191,0.0026796,38.57
1,46,1969,2015,0.0028925,0.0028133,37.67
1,47,1969,2016,0.0031101,0.0029853,36.78
1,48,1969,2017,0.0033571,0.0031849,35.88
1,49,1969,2018,0.0036304,0.0034079,35.00
1,50,1969,2019,0.0039379,0.0036542,34.12
1,51,1969,2020,0.0042708,0.0039121,33.24
1,52,1969,2021,0.0046082,0.0041640,32.37
1,53,1969,2022,0.0049489,0.0044085,31.50
1,54,1969,2023,0.0053157,0.0046721,30.64
1,55,1969,2024,0.0057365,0.0049737,29.78
1,56,1969,2025,0.0062406,0.0053434,28.93
1,57,1969,2026,0.0068502,0.0058038,28.08
1,58,1969,2027,0.0075521,0.0063504,27.24
1,59,1969,2028,0.0083035,0.0069333,26.41
1,60,1969,2029,0.0090849,0.0075162,25.59
1,61,1969,2030,0.0099105,0.0081036,24.78
1,62,1969,2031,0.0107829,0.0086999,23.98
1,63,1969,2032,0.0116995,0.0093164,23.19
1,64,1969,2033,0.0126957,0.0099969,22.40
1,65,1969,2034,0.0138071,0.0107566,21.62
1,66,1969,2035,0.0150054,0.0115583,20.85
1,67,1969,2036,0.0162315,0.0123264,20.09
1,68,1969,2037,0.0174919,0.0130706,19.33
1,69,1969,2038,0.0188954,0.0139093,18.58
1,70,1969,2039,0.0205786,0.0149568,17.84
1,71,1969,2040,0.0226142,0.0162975,17.10
1,72,1969,2041,0.0250119,0.0179678,16.37
1,73,1969,2042,0.0277519,0.0199658,15.66
1,74,1969,2043,0.0307579,0.0222260,14.97
1,75,1969,2044,0.0339099,0.0245660,14.30
1,76,1969,2045,0.0371478,0.0268655,13.65
1,77,1969,2046,0.0405123,0.0291430,13.01
1,78,1969,2047,0.0440886,0.0314940,12.39
1,79,1969,2048,0.0480027,0.0340580,11.78
1,80,1969,2049,0.0536037,0.0385661,11.17
1,81,1969,2050,0.0586892,0.0420736,10.60
1,82,1969,2051,0.0642414,0.0458875,10.05
1,83,1969,2052,0.0702997,0.0501049,9.50
1,84,1969,2053,0.0769067,0.0548055,8.98
1,85,1969,2054,0.0841076,0.0599786,8.47
1,86,1969,2055,0.0919504,0.0656466,7.98
1,87,1969,2056,0.1004863,0.0718946,7.50
1,88,1969,2057,0.1097689,0.0788332,7.05
1,89,1969,2058,0.1198550,0.0865358,6.61
1,90,1969,2059,0.1308036,0.0949930,6.19
1,91,1969,2060,0.1426766,0.1042206,5.78
1,92,1969,2061,0.1555375,0.1143294,5.40
1,93,1969,2062,0.1694519,0.1254656,5.03
1,94,1969,2063,0.1844867,0.1377330,4.68
1,95,1969,2064,0.2007091,0.1511491,4.35
1,96,1969,2065,0.2181866,0.1657540,4.03
1,97,1969,2066,0.2369856,0.1816960,3.74
1,98,1969,2067,0.2571705,0.1991598,3.45
1,99,1969,2068,0.2788028,0.2182678,3.19
1,100,1969,2069,0.3019394,0.2390336,2.94
1,101,1969,2070,0.3266317,0.2615041,2.71
1,102,1969,2071,0.3529236,0.2858492,2.49
1,103,1969,2072,0.3808502,0.3122674,2.28
1,104,1969,2073,0.4104359,0.3408768,2.09
1,105,1969,2074,0.4416930,0.3716623,1.91
1,106,1969,2075,0.4746198,0.4046206,1.75
1,107,1969,2076,0.5091990,0.4398658,1.59
1,108,1969,2077,0.5453968,0.4775173,1.45
1,109,1969,2078,0.5831612,0.5175812,1.32
1,110,1969,2079,0.6224217,0.5599303,1.20
1,111,1969,2080,0.6630882,0.6044613,1.09
1,112,1969,2081,0.7050519,0.6511468,0.98
1,113,1969,2082,0.7481851,0.6999206,0.87
1,114,1969,2083,0.7923424,0.7506005,0.75
1,115,1969,2084,1.0000000,1.0000000,0.50
1,30,1970,2000,0.0014216,0.0015851,52.36
1,31,1970,2001,0.0014530,0.0016056,51.44
1,32,1970,2002,0.0014859,0.0016277,50.53
1,33,1970,2003,0.0015203,0.0016558,49.61
1,34,1970,2004,0.0015540,0.0016881,48.69
1,35,1970,2005,0.0015941,0.0017288,47.77
1,36,1970,2006,0.0016525,0.0017854,46.85
1,37,1970,2007,0.0017318,0.0018614,45.93
1,38,1970,2008,0.0018255,0.0019453,45.02
1,39,1970,2009,0.0019305,0.0020311,44.11
1,40,1970,2010,0.0020513,0.0021265,43.19
1,41,1970,2011,0.0021897,0.0022372,42.29
1,42,1970,2012,0.0023342,0.0023542,41.38
1,43,1970,2013,0.0024669,0.0024600,40.48
1,44,1970,2014,0.0025867,0.0025501,39.57
1,45,1970,2015,0.0027191,0.0026455,38.67
1,46,1970,2016,0.0028925,0.0027763,37.78
1,47,1970,2017,0.0031101,0.0029483,36.88
1,48,1970,2018,0.0033571,0.0031488,35.99
1,49,1970,2019,0.0036304,0.0033690,35.10
1,50,1970,2020,0.0039379,0.0036087,34.22
1,51,1970,2021,0.0042708,0.0038620,33.34
1,52,1970,2022,0.0046082,0.0041134,32.47
1,53,1970,2023,0.0049489,0.0043578,31.60
1,54,1970,2024,0.0053157,0.0046162,30.73
1,55,1970,2025,0.0057365,0.0049080,29.87
1,56,1970,2026,0.0062406,0.0052715,29.02
1,57,1970,2027,0.0068502,0.0057315,28.17
1,58,1970,2028,0.0075521,0.0062792,27.33
1,59,1970,2029,0.0083035,0.0068555,26.50
1,60,1970,2030,0.0090849,0.0074254,25.68
1,61,1970,2031,0.0099105,0.0080036,24.87
1,62,1970,2032,0.0107829,0.0085983,24.06
1,63,1970,2033,0.0116995,0.0092152,23.27
1,64,1970,2034,0.0126957,0.0098859,22.48
1,65,1970,2035,0.0138071,0.0106270,21.70
1,66,1970,2036,0.0150054,0.0114161,20.93
1,67,1970,2037,0.0162315,0.0121826,20.16
1,68,1970,2038,0.0174919,0.0129269,19.40
1,69,1970,2039,0.0188954,0.0137504,18.65
1,70,1970,2040,0.0205786,0.0147699,17.91
1,71,1970,2041,0.0226142,0.0160915,17.17
1,72,1970,2042,0.0250119,0.0177598,16.44
1,73,1970,2043,0.0277519,0.0197603,15.73
1,74,1970,2044,0.0307579,0.0220027,15.03
1,75,1970,2045,0.0339099,0.0243077,14.36
1,76,1970,2046,0.0371478,0.0265839,13.71
1,77,1970,2047,0.0405123,0.0288594,13.07
1,78,1970,2048,0.0440886,0.0312117,12.44
1,79,1970,2049,0.0480027,0.0337463,11.83
1,80,1970,2050,0.0536037,0.0382064,11.22
1,81,1970,2051,0.0586892,0.0416785,10.65
1,82,1970,2052,0.0642414,0.0454875,10.09
1,83,1970,2053,0.0702997,0.0497040,9.54
1,84,1970,2054,0.0769067,0.0543599,9.02
1,85,1970,2055,0.0841076,0.0594583,8.51
1,86,1970,2056,0.0919504,0.0650796,8.01
1,87,1970,2057,0.1004863,0.0713275,7.54
1,88,1970,2058,0.1097689,0.0782772,7.08
1,89,1970,2059,0.1198550,0.0859344,6.64
1,90,1970,2060,0.1308036,0.0943018,6.21
1,91,1970,2061,0.1426766,0.1034745,5.81
1,92,1970,2062,0.1555375,0.1135897,5.42
1,93,1970,2063,0.1694519,0.1247455,5.05
1,94,1970,2064,0.1844867,0.1369587,4.70
1,95,1970,2065,0.2007091,0.1502671,4.37
1,96,1970,2066,0.2181866,0.1648124,4.05
1,97,1970,2067,0.2369856,0.1807730,3.75
1,98,1970,2068,0.2571705,0.1982686,3.47
1,99,1970,2069,0.2788028,0.2173162,3.20
1,100,1970,2070,0.3019394,0.2379648,2.95
1,101,1970,2071,0.3266317,0.2603845,2.71
1,102,1970,2072,0.3529236,0.2847771,2.49
1,103,1970,2073,0.3808502,0.3112701,2.29
1,104,1970,2074,0.4104359,0.3398617,2.10
1,105,1970,2075,0.4416930,0.3705631,1.92
1,106,1970,2076,0.4746198,0.4035062,1.75
1,107,1970,2077,0.5091990,0.4388347,1.60
1,108,1970,2078,0.5453968,0.4765840,1.45
1,109,1970,2079,0.5831612,0.5166548,1.32
1,110,1970,2080,0.6224217,0.5589733,1.20
1,111,1970,2081,0.6630882,0.6035507,1.09
1,112,1970,2082,0.7050519,0.6503663,0.98
1,113,1970,2083,0.7481851,0.6992806,0.88
1,114,1970,2084,0.7923424,0.7500398,0.75
1,115,1970,2085,1.0000000,1.0000000,0.50
1,29,1971,2000,0.0013859,0.0015420,53.40
1,30,1971,2001,0.0014216,0.0015673,52.48
1,31,1971,2002,0.0014530,0.0015885,51.56
1,32,1971,2003,0.0014859,0.0016137,50.64
1,33,1971,2004,0.0015203,0.0016448,49.72
1,34,1971,2005,0.0015540,0.0016769,48.80
1,35,1971,2006,0.0015941,0.0017163,47.88
1,36,1971,2007,0.0016525,0.0017721,46.96
1,37,1971,2008,0.0017318,0.0018449,46.05
1,38,1971,2009,0.0018255,0.0019222,45.13
1,39,1971,2010,0.0019305,0.0020031,44.22
1,40,1971,2011,0.0020513,0.0020972,43.30
1,41,1971,2012,0.0021897,0.0022091,42.39
1,42,1971,2013,0.0023342,0.0023276,41.49
1,43,1971,2014,0.0024669,0.0024320,40.58
1,44,1971,2015,0.0025867,0.0025184,39.68
1,45,1971,2016,0.0027191,0.0026109,38.78
1,46,1971,2017,0.0028925,0.0027418,37.88
1,47,1971,2018,0.0031101,0.0029144,36.98
1,48,1971,2019,0.0033571,0.0031124,36.09
1,49,1971,2020,0.0036304,0.0033270,35.20
1,50,1971,2021,0.0039379,0.0035627,34.32
1,51,1971,2022,0.0042708,0.0038154,33.44
1,52,1971,2023,0.0046082,0.0040669,32.56
1,53,1971,2024,0.0049489,0.0043063,31.69
1,54,1971,2025,0.0053157,0.0045559,30.83
1,55,1971,2026,0.0057365,0.0048417,29.97
1,56,1971,2027,0.0062406,0.0052047,29.11
1,57,1971,2028,0.0068502,0.0056654,28.26
1,58,1971,2029,0.0075521,0.0062071,27.42
1,59,1971,2030,0.0083035,0.0067718,26.59
1,60,1971,2031,0.0090849,0.0073335,25.77
1,61,1971,2032,0.0099105,0.0079105,24.95
1,62,1971,2033,0.0107829,0.0085054,24.15
1,63,1971,2034,0.0116995,0.0091130,23.35
1,64,1971,2035,0.0126957,0.0097665,22.56
1,65,1971,2036,0.0138071,0.0104959,21.78
1,66,1971,2037,0.0150054,0.0112838,21.00
1,67,1971,2038,0.0162315,0.0120507,20.24
1,68,1971,2039,0.0174919,0.0127811,19.48
1,69,1971,2040,0.0188954,0.0135792,18.72
1,70,1971,2041,0.0205786,0.0145809,17.97
1,71,1971,2042,0.0226142,0.0159000,17.23
1,72,1971,2043,0.0250119,0.0175698,16.50
1,73,1971,2044,0.0277519,0.0195528,15.79
1,74,1971,2045,0.0307579,0.0217624,15.09
1,75,1971,2046,0.0339099,0.0240460,14.42
1,76,1971,2047,0.0371478,0.0263212,13.76
1,77,1971,2048,0.0405123,0.0285987,13.12
1,78,1971,2049,0.0440886,0.0309243,12.49
1,79,1971,2050,0.0480027,0.0334096,11.87
1,80,1971,2051,0.0536037,0.0378416,11.27
1,81,1971,2052,0.0586892,0.0413091,10.69
1,82,1971,2053,0.0642414,0.0451166,10.13
1,83,1971,2054,0.0702997,0.0492906,9.59
1,84,1971,2055,0.0769067,0.0538762,9.06
1,85,1971,2056,0.0841076,0.0589301,8.54
1,86,1971,2057,0.0919504,0.0645500,8.05
1,87,1971,2058,0.1004863,0.0708070,7.57
1,88,1971,2059,0.1097689,0.0777129,7.11
1,89,1971,2060,0.1198550,0.0852845,6.66
1,90,1971,2061,0.1308036,0.0935990,6.24
1,91,1971,2062,0.1426766,0.1027763,5.83
1,92,1971,2063,0.1555375,0.1129084,5.44
1,93,1971,2064,0.1694519,0.1240111,5.07
1,94,1971,2065,0.1844867,0.1361198,4.72
1,95,1971,2066,0.2007091,0.1493689,4.38
1,96,1971,2067,0.2181866,0.1639291,4.06
1,97,1971,2068,0.2369856,0.1799169,3.76
1,98,1971,2069,0.2571705,0.1973508,3.48
1,99,1971,2070,0.2788028,0.2162808,3.21
1,100,1971,2071,0.3019394,0.2368748,2.96
1,101,1971,2072,0.3266317,0.2593350,2.72
1,102,1971,2073,0.3529236,0.2837950,2.50
1,103,1971,2074,0.3808502,0.3102636,2.29
1,104,1971,2075,0.4104359,0.3387636,2.10
1,105,1971,2076,0.4416930,0.3694403,1.92
1,106,1971,2077,0.4746198,0.4024574,1.75
1,107,1971,2078,0.5091990,0.4378749,1.60
1,108,1971,2079,0.5453968,0.4756193,1.46
1,109,1971,2080,0.5831612,0.5156437,1.32
1,110,1971,2081,0.6224217,0.5579945,1.20
1,111,1971,2082,0.6630882,0.6026940,1.09
1,112,1971,2083,0.7050519,0.6496451,0.98
1,113,1971,2084,0.7481851,0.6986268,0.88
1,114,1971,2085,0.7923424,0.7494299,0.75
1,115,1971,2086,1.0000000,1.0000000,0.50
1,28,1972,2000,0.0013446,0.0014980,54.43
1,29,1972,2001,0.0013859,0.0015249,53.51
1,30,1972,2002,0.0014216,0.0015510,52.59
1,31,1972,2003,0.0014530,0.0015753,51.67
1,32,1972,2004,0.0014859,0.0016034,50.75
1,33,1972,2005,0.0015203,0.0016344,49.83
1,34,1972,2006,0.0015540,0.0016655,48.92
1,35,1972,2007,0.0015941,0.0017042,48.00
1,36,1972,2008,0.0016525,0.0017569,47.08
1,37,1972,2009,0.0017318,0.0018230,46.16
1,38,1972,2010,0.0018255,0.0018953,45.24
1,39,1972,2011,0.0019305,0.0019748,44.33
1,40,1972,2012,0.0020513,0.0020700,43.41
1,41,1972,2013,0.0021897,0.0021834,42.50
1,42,1972,2014,0.0023342,0.0023007,41.60
1,43,1972,2015,0.0024669,0.0024019,40.69
1,44,1972,2016,0.0025867,0.0024864,39.79
1,45,1972,2017,0.0027191,0.0025789,38.88
1,46,1972,2018,0.0028925,0.0027102,37.98
1,47,1972,2019,0.0031101,0.0028802,37.09
1,48,1972,2020,0.0033571,0.0030732,36.19
1,49,1972,2021,0.0036304,0.0032847,35.30
1,50,1972,2022,0.0039379,0.0035199,34.42
1,51,1972,2023,0.0042708,0.0037727,33.54
1,52,1972,2024,0.0046082,0.0040197,32.66
1,53,1972,2025,0.0049489,0.0042509,31.79
1,54,1972,2026,0.0053157,0.0044950,30.92
1,55,1972,2027,0.0057365,0.0047800,30.06
1,56,1972,2028,0.0062406,0.0051436,29.20
1,57,1972,2029,0.0068502,0.0055984,28.35
1,58,1972,2030,0.0075521,0.0061295,27.51
1,59,1972,2031,0.0083035,0.0066871,26.68
1,60,1972,2032,0.0090849,0.0072480,25.85
1,61,1972,2033,0.0099105,0.0078255,25.04
1,62,1972,2034,0.0107829,0.0084117,24.23
1,63,1972,2035,0.0116995,0.0090031,23.43
1,64,1972,2036,0.0126957,0.0096458,22.64
1,65,1972,2037,0.0138071,0.0103738,21.86
1,66,1972,2038,0.0150054,0.0111624,21.08
1,67,1972,2039,0.0162315,0.0119168,20.31
1,68,1972,2040,0.0174919,0.0126241,19.55
1,69,1972,2041,0.0188954,0.0134062,18.79
1,70,1972,2042,0.0205786,0.0144052,18.04
1,71,1972,2043,0.0226142,0.0157250,17.30
1,72,1972,2044,0.0250119,0.0173781,16.57
1,73,1972,2045,0.0277519,0.0193297,15.85
1,74,1972,2046,0.0307579,0.0215190,15.15
1,75,1972,2047,0.0339099,0.0238020,14.48
1,76,1972,2048,0.0371478,0.0260797,13.82
1,77,1972,2049,0.0405123,0.0283332,13.17
1,78,1972,2050,0.0440886,0.0306139,12.54
1,79,1972,2051,0.0480027,0.0330683,11.92
1,80,1972,2052,0.0536037,0.0375005,11.32
1,81,1972,2053,0.0586892,0.0409667,10.74
1,82,1972,2054,0.0642414,0.0447343,10.17
1,83,1972,2055,0.0702997,0.0488421,9.63
1,84,1972,2056,0.0769067,0.0533853,9.10
1,85,1972,2057,0.0841076,0.0584368,8.58
1,86,1972,2058,0.0919504,0.0640641,8.08
1,87,1972,2059,0.1004863,0.0702788,7.60
1,88,1972,2060,0.1097689,0.0771032,7.14
1,89,1972,2061,0.1198550,0.0846239,6.69
1,90,1972,2062,0.1308036,0.0929415,6.26
1,91,1972,2063,0.1426766,0.1021333,5.85
1,92,1972,2064,0.1555375,0.1122138,5.46
1,93,1972,2065,0.1694519,0.1232157,5.09
1,94,1972,2066,0.1844867,0.1352659,4.74
1,95,1972,2067,0.2007091,0.1485265,4.40
1,96,1972,2068,0.2181866,0.1631100,4.08
1,97,1972,2069,0.2369856,0.1790355,3.78
1,98,1972,2070,0.2571705,0.1963525,3.49
1,99,1972,2071,0.2788028,0.2152252,3.22
1,100,1972,2072,0.3019394,0.2358535,2.97
1,101,1972,2073,0.3266317,0.2583740,2.73
1,102,1972,2074,0.3529236,0.2828040,2.51
1,103,1972,2075,0.3808502,0.3091751,2.30
1,104,1972,2076,0.4104359,0.3376422,2.11
1,105,1972,2077,0.4416930,0.3683839,1.93
1,106,1972,2078,0.4746198,0.4014813,1.76
1,107,1972,2079,0.5091990,0.4368832,1.60
1,108,1972,2080,0.5453968,0.4745667,1.46
1,109,1972,2081,0.5831612,0.5146098,1.33
1,110,1972,2082,0.6224217,0.5570738,1.20
1,111,1972,2083,0.6630882,0.6019025,1.09
1,112,1972,2084,0.7050519,0.6489085,0.98
1,113,1972,2085,0.7481851,0.6979158,0.88
1,114,1972,2086,0.7923424,0.7488056,0.75
1,115,1972,2087,1.0000000,1.0000000,0.50
1,27,1973,2000,0.0013058,0.0014592,55.47
1,28,1973,2001,0.0013446,0.0014813,54.55
1,29,1973,2002,0.0013859,0.0015095,53.63
1,30,1973,2003,0.0014216,0.0015384,52.71
1,31,1973,2004,0.0014530,0.0015654,51.79
1,32,1973,2005,0.0014859,0.0015936,50.87
1,33,1973,2006,0.0015203,0.0016239,49.95
1,34,1973,2007,0.0015540,0.0016544,49.03
1,35,1973,2008,0.0015941,0.0016902,48.11
1,36,1973,2009,0.0016525,0.0017367,47.19
1,37,1973,2010,0.0017318,0.0017976,46.27
1,38,1973,2011,0.0018255,0.0018681,45.35
1,39,1973,2012,0.0019305,0.0019485,44.44
1,40,1973,2013,0.0020513,0.0020452,43.52
1,41,1973,2014,0.0021897,0.0021575,42.61
1,42,1973,2015,0.0023342,0.0022718,41.70
1,43,1973,2016,0.0024669,0.0023715,40.80
1,44,1973,2017,0.0025867,0.0024566,39.89
1,45,1973,2018,0.0027191,0.0025495,38.99
1,46,1973,2019,0.0028925,0.0026784,38.09
1,47,1973,2020,0.0031101,0.0028434,37.19
1,48,1973,2021,0.0033571,0.0030335,36.29
1,49,1973,2022,0.0036304,0.0032452,35.40
1,50,1973,2023,0.0039379,0.0034807,34.52
1,51,1973,2024,0.0042708,0.0037292,33.63
1,52,1973,2025,0.0046082,0.0039689,32.76
1,53,1973,2026,0.0049489,0.0041949,31.89
1,54,1973,2027,0.0053157,0.0044384,31.02
1,55,1973,2028,0.0057365,0.0047236,30.16
1,56,1973,2029,0.0062406,0.0050817,29.30
1,57,1973,2030,0.0068502,0.0055265,28.44
1,58,1973,2031,0.0075521,0.0060511,27.60
1,59,1973,2032,0.0083035,0.0066084,26.76
1,60,1973,2033,0.0090849,0.0071700,25.94
1,61,1973,2034,0.0099105,0.0077396,25.12
1,62,1973,2035,0.0107829,0.0083109,24.31
1,63,1973,2036,0.0116995,0.0088920,23.51
1,64,1973,2037,0.0126957,0.0095334,22.72
1,65,1973,2038,0.0138071,0.0102620,21.93
1,66,1973,2039,0.0150054,0.0110393,21.16
1,67,1973,2040,0.0162315,0.0117726,20.39
1,68,1973,2041,0.0174919,0.0124653,19.62
1,69,1973,2042,0.0188954,0.0132453,18.87
1,70,1973,2043,0.0205786,0.0142448,18.11
1,71,1973,2044,0.0226142,0.0155485,17.37
1,72,1973,2045,0.0250119,0.0171719,16.63
1,73,1973,2046,0.0277519,0.0191038,15.91
1,74,1973,2047,0.0307579,0.0212921,15.21
1,75,1973,2048,0.0339099,0.0235777,14.53
1,76,1973,2049,0.0371478,0.0258339,13.87
1,77,1973,2050,0.0405123,0.0280465,13.23
1,78,1973,2051,0.0440886,0.0302992,12.60
1,79,1973,2052,0.0480027,0.0327495,11.97
1,80,1973,2053,0.0536037,0.0371844,11.36
1,81,1973,2054,0.0586892,0.0406137,10.78
1,82,1973,2055,0.0642414,0.0443196,10.22
1,83,1973,2056,0.0702997,0.0483869,9.67
1,84,1973,2057,0.0769067,0.0529270,9.13
1,85,1973,2058,0.0841076,0.0579843,8.62
1,86,1973,2059,0.0919504,0.0635710,8.12
1,87,1973,2060,0.1004863,0.0697084,7.63
1,88,1973,2061,0.1097689,0.0764837,7.17
1,89,1973,2062,0.1198550,0.0840062,6.72
1,90,1973,2063,0.1308036,0.0923362,6.29
1,91,1973,2064,0.1426766,0.1014781,5.88
1,92,1973,2065,0.1555375,0.1114618,5.49
1,93,1973,2066,0.1694519,0.1224063,5.11
1,94,1973,2067,0.1844867,0.1344652,4.76
1,95,1973,2068,0.2007091,0.1477457,4.42
1,96,1973,2069,0.2181866,0.1622670,4.10
1,97,1973,2070,0.2369856,0.1780772,3.79
1,98,1973,2071,0.2571705,0.1953351,3.50
1,99,1973,2072,0.2788028,0.2142364,3.23
1,100,1973,2073,0.3019394,0.2349184,2.98
1,101,1973,2074,0.3266317,0.2574045,2.74
1,102,1973,2075,0.3529236,0.2817327,2.52
1,103,1973,2076,0.3808502,0.3080639,2.31
1,104,1973,2077,0.4104359,0.3365875,2.11
1,105,1973,2078,0.4416930,0.3674011,1.93
1,106,1973,2079,0.4746198,0.4004731,1.76
1,107,1973,2080,0.5091990,0.4358013,1.61
1,108,1973,2081,0.5453968,0.4734906,1.46
1,109,1973,2082,0.5831612,0.5136374,1.33
1,110,1973,2083,0.6224217,0.5562233,1.21
1,111,1973,2084,0.6630882,0.6010942,1.09
1,112,1973,2085,0.7050519,0.6481076,0.99
1,113,1973,2086,0.7481851,0.6971881,0.88
1,114,1973,2087,0.7923424,0.7482175,0.75
1,115,1973,2088,1.0000000,1.0000000,0.50
1,26,1974,2000,0.0012759,0.0014250,56.50
1,27,1974,2001,0.0013058,0.0014424,55.58
1,28,1974,2002,0.0013446,0.0014660,54.66
1,29,1974,2003,0.0013859,0.0014974,53.74
1,30,1974,2004,0.0014216,0.0015289,52.82
1,31,1974,2005,0.0014530,0.0015560,51.90
1,32,1974,2006,0.0014859,0.0015837,50.98
1,33,1974,2007,0.0015203,0.0016136,50.06
1,34,1974,2008,0.0015540,0.0016417,49.14
1,35,1974,2009,0.0015941,0.0016716,48.22
1,36,1974,2010,0.0016525,0.0017133,47.30
1,37,1974,2011,0.0017318,0.0017720,46.38
1,38,1974,2012,0.0018255,0.0018429,45.46
1,39,1974,2013,0.0019305,0.0019246,44.55
1,40,1974,2014,0.0020513,0.0020201,43.63
1,41,1974,2015,0.0021897,0.0021296,42.72
1,42,1974,2016,0.0023342,0.0022426,41.81
1,43,1974,2017,0.0024669,0.0023432,40.90
1,44,1974,2018,0.0025867,0.0024294,40.00
1,45,1974,2019,0.0027191,0.0025198,39.09
1,46,1974,2020,0.0028925,0.0026441,38.19
1,47,1974,2021,0.0031101,0.0028062,37.29
1,48,1974,2022,0.0033571,0.0029967,36.40
1,49,1974,2023,0.0036304,0.0032090,35.50
1,50,1974,2024,0.0039379,0.0034408,34.62
1,51,1974,2025,0.0042708,0.0036824,33.73
1,52,1974,2026,0.0046082,0.0039175,32.86
1,53,1974,2027,0.0049489,0.0041428,31.98
1,54,1974,2028,0.0053157,0.0043866,31.11
1,55,1974,2029,0.0057365,0.0046665,30.25
1,56,1974,2030,0.0062406,0.0050152,29.39
1,57,1974,2031,0.0068502,0.0054537,28.53
1,58,1974,2032,0.0075521,0.0059781,27.69
1,59,1974,2033,0.0083035,0.0065364,26.85
1,60,1974,2034,0.0090849,0.0070911,26.03
1,61,1974,2035,0.0099105,0.0076472,25.21
1,62,1974,2036,0.0107829,0.0082089,24.40
1,63,1974,2037,0.0116995,0.0087885,23.60
1,64,1974,2038,0.0126957,0.0094304,22.80
1,65,1974,2039,0.0138071,0.0101484,22.01
1,66,1974,2040,0.0150054,0.0109066,21.23
1,67,1974,2041,0.0162315,0.0116268,20.46
1,68,1974,2042,0.0174919,0.0123176,19.70
1,69,1974,2043,0.0188954,0.0130984,18.94
1,70,1974,2044,0.0205786,0.0140829,18.18
1,71,1974,2045,0.0226142,0.0153588,17.43
1,72,1974,2046,0.0250119,0.0169633,16.70
1,73,1974,2047,0.0277519,0.0188933,15.98
1,74,1974,2048,0.0307579,0.0210837,15.27
1,75,1974,2049,0.0339099,0.0233495,14.59
1,76,1974,2050,0.0371478,0.0255685,13.93
1,77,1974,2051,0.0405123,0.0277560,13.28
1,78,1974,2052,0.0440886,0.0300053,12.65
1,79,1974,2053,0.0480027,0.0324542,12.02
1,80,1974,2054,0.0536037,0.0368586,11.41
1,81,1974,2055,0.0586892,0.0402308,10.83
1,82,1974,2056,0.0642414,0.0438988,10.26
1,83,1974,2057,0.0702997,0.0479621,9.71
1,84,1974,2058,0.0769067,0.0525066,9.17
1,85,1974,2059,0.0841076,0.0575252,8.65
1,86,1974,2060,0.0919504,0.0630387,8.15
1,87,1974,2061,0.1004863,0.0691289,7.66
1,88,1974,2062,0.1097689,0.0759045,7.20
1,89,1974,2063,0.1198550,0.0834376,6.75
1,90,1974,2064,0.1308036,0.0917196,6.32
1,91,1974,2065,0.1426766,0.1007689,5.90
1,92,1974,2066,0.1555375,0.1106967,5.51
1,93,1974,2067,0.1694519,0.1216476,5.13
1,94,1974,2068,0.1844867,0.1337232,4.77
1,95,1974,2069,0.2007091,0.1469422,4.43
1,96,1974,2070,0.2181866,0.1613506,4.11
1,97,1974,2071,0.2369856,0.1771007,3.81
1,98,1974,2072,0.2571705,0.1943822,3.52
1,99,1974,2073,0.2788028,0.2133314,3.24
1,100,1974,2074,0.3019394,0.2339754,2.99
1,101,1974,2075,0.3266317,0.2563568,2.75
1,102,1974,2076,0.3529236,0.2806393,2.53
1,103,1974,2077,0.3808502,0.3070191,2.32
1,104,1974,2078,0.4104359,0.3356065,2.12
1,105,1974,2079,0.4416930,0.3663861,1.94
1,106,1974,2080,0.4746198,0.3993734,1.77
1,107,1974,2081,0.5091990,0.4346955,1.61
1,108,1974,2082,0.5453968,0.4724787,1.47
1,109,1974,2083,0.5831612,0.5127394,1.33
1,110,1974,2084,0.6224217,0.5553550,1.21
1,111,1974,2085,0.6630882,0.6002155,1.09
1,112,1974,2086,0.7050519,0.6472880,0.99
1,113,1974,2087,0.7481851,0.6965026,0.88
1,114,1974,2088,0.7923424,0.7476715,0.75
1,115,1974,2089,1.0000000,1.0000000,0.50
1,25,1975,2000,0.0012521,0.0013958,57.54
1,26,1975,2001,0.0012759,0.0014087,56.62
1,27,1975,2002,0.0013058,0.0014272,55.70
1,28,1975,2003,0.0013446,0.0014541,54.78
1,29,1975,2004,0.0013859,0.0014884,53.86
1,30,1975,2005,0.0014216,0.0015200,52.94
1,31,1975,2006,0.0014530,0.0015465,52.02
1,32,1975,2007,0.0014859,0.0015740,51.10
1,33,1975,2008,0.0015203,0.0016018,50.18
1,34,1975,2009,0.0015540,0.0016248,49.26
1,35,1975,2010,0.0015941,0.0016501,48.34
1,36,1975,2011,0.0016525,0.0016897,47.42
1,37,1975,2012,0.0017318,0.0017482,46.49
1,38,1975,2013,0.0018255,0.0018198,45.58
1,39,1975,2014,0.0019305,0.0019004,44.66
1,40,1975,2015,0.0020513,0.0019932,43.74
1,41,1975,2016,0.0021897,0.0021014,42.83
1,42,1975,2017,0.0023342,0.0022154,41.92
1,43,1975,2018,0.0024669,0.0023173,41.01
1,44,1975,2019,0.0025867,0.0024019,40.10
1,45,1975,2020,0.0027191,0.0024879,39.20
1,46,1975,2021,0.0028925,0.0026094,38.29
1,47,1975,2022,0.0031101,0.0027716,37.39
1,48,1975,2023,0.0033571,0.0029628,36.50
1,49,1975,2024,0.0036304,0.0031723,35.60
1,50,1975,2025,0.0039379,0.0033978,34.71
1,51,1975,2026,0.0042708,0.0036351,33.83
1,52,1975,2027,0.0046082,0.0038697,32.95
1,53,1975,2028,0.0049489,0.0040951,32.08
1,54,1975,2029,0.0053157,0.0043341,31.21
1,55,1975,2030,0.0057365,0.0046051,30.34
1,56,1975,2031,0.0062406,0.0049480,29.48
1,57,1975,2032,0.0068502,0.0053861,28.62
1,58,1975,2033,0.0075521,0.0059115,27.78
1,59,1975,2034,0.0083035,0.0064637,26.94
1,60,1975,2035,0.0090849,0.0070063,26.11
1,61,1975,2036,0.0099105,0.0075538,25.29
1,62,1975,2037,0.0107829,0.0081140,24.48
1,63,1975,2038,0.0116995,0.0086937,23.68
1,64,1975,2039,0.0126957,0.0093258,22.88
1,65,1975,2040,0.0138071,0.0100261,22.09
1,66,1975,2041,0.0150054,0.0107724,21.31
1,67,1975,2042,0.0162315,0.0114911,20.54
1,68,1975,2043,0.0174919,0.0121827,19.77
1,69,1975,2044,0.0188954,0.0129501,19.01
1,70,1975,2045,0.0205786,0.0139090,18.25
1,71,1975,2046,0.0226142,0.0151669,17.50
1,72,1975,2047,0.0250119,0.0167690,16.76
1,73,1975,2048,0.0277519,0.0187001,16.04
1,74,1975,2049,0.0307579,0.0208717,15.34
1,75,1975,2050,0.0339099,0.0231031,14.65
1,76,1975,2051,0.0371478,0.0252995,13.99
1,77,1975,2052,0.0405123,0.0274847,13.34
1,78,1975,2053,0.0440886,0.0297331,12.70
1,79,1975,2054,0.0480027,0.0321500,12.07
1,80,1975,2055,0.0536037,0.0365052,11.46
1,81,1975,2056,0.0586892,0.0398424,10.87
1,82,1975,2057,0.0642414,0.0435061,10.30
1,83,1975,2058,0.0702997,0.0475725,9.75
1,84,1975,2059,0.0769067,0.0520803,9.21
1,85,1975,2060,0.0841076,0.0570298,8.69
1,86,1975,2061,0.0919504,0.0624981,8.18
1,87,1975,2062,0.1004863,0.0685873,7.70
1,88,1975,2063,0.1097689,0.0753717,7.23
1,89,1975,2064,0.1198550,0.0828585,6.78
1,90,1975,2065,0.1308036,0.0910523,6.34
1,91,1975,2066,0.1426766,0.1000476,5.93
1,92,1975,2067,0.1555375,0.1099799,5.53
1,93,1975,2068,0.1694519,0.1209448,5.15
1,94,1975,2069,0.1844867,0.1329601,4.79
1,95,1975,2070,0.2007091,0.1460691,4.45
1,96,1975,2071,0.2181866,0.1604172,4.13
1,97,1975,2072,0.2369856,0.1761866,3.82
1,98,1975,2073,0.2571705,0.1935105,3.53
1,99,1975,2074,0.2788028,0.2124189,3.26
1,100,1975,2075,0.3019394,0.2329566,3.00
1,101,1975,2076,0.3266317,0.2552878,2.76
1,102,1975,2077,0.3529236,0.2796115,2.53
1,103,1975,2078,0.3808502,0.3060475,2.32
1,104,1975,2079,0.4104359,0.3345936,2.13
1,105,1975,2080,0.4416930,0.3652793,1.94
1,106,1975,2081,0.4746198,0.3982498,1.77
1,107,1975,2082,0.5091990,0.4336561,1.62
1,108,1975,2083,0.5453968,0.4715446,1.47
1,109,1975,2084,0.5831612,0.5118227,1.34
1,110,1975,2085,0.6224217,0.5544111,1.21
1,111,1975,2086,0.6630882,0.5993165,1.10
1,112,1975,2087,0.7050519,0.6465161,0.99
1,113,1975,2088,0.7481851,0.6958664,0.88
1,114,1975,2089,0.7923424,0.7471100,0.75
1,115,1975,2090,1.0000000,1.0000000,0.50
1,24,1976,2000,0.0012275,0.0013672,58.58
1,25,1976,2001,0.0012521,0.0013801,57.66
1,26,1976,2002,0.0012759,0.0013939,56.74
1,27,1976,2003,0.0013058,0.0014153,55.82
1,28,1976,2004,0.0013446,0.0014453,54.89
1,29,1976,2005,0.0013859,0.0014799,53.97
1,30,1976,2006,0.0014216,0.0015110,53.05
1,31,1976,2007,0.0014530,0.0015373,52.13
1,32,1976,2008,0.0014859,0.0015628,51.21
1,33,1976,2009,0.0015203,0.0015861,50.29
1,34,1976,2010,0.0015540,0.0016051,49.37
1,35,1976,2011,0.0015941,0.0016283,48.45
1,36,1976,2012,0.0016525,0.0016677,47.53
1,37,1976,2013,0.0017318,0.0017265,46.61
1,38,1976,2014,0.0018255,0.0017966,45.69
1,39,1976,2015,0.0019305,0.0018743,44.77
1,40,1976,2016,0.0020513,0.0019660,43.85
1,41,1976,2017,0.0021897,0.0020752,42.94
1,42,1976,2018,0.0023342,0.0021905,42.02
1,43,1976,2019,0.0024669,0.0022911,41.11
1,44,1976,2020,0.0025867,0.0023722,40.21
1,45,1976,2021,0.0027191,0.0024557,39.30
1,46,1976,2022,0.0028925,0.0025772,38.40
1,47,1976,2023,0.0031101,0.0027399,37.50
1,48,1976,2024,0.0033571,0.0029285,36.60
1,49,1976,2025,0.0036304,0.0031327,35.70
1,50,1976,2026,0.0039379,0.0033543,34.81
1,51,1976,2027,0.0042708,0.0035911,33.93
1,52,1976,2028,0.0046082,0.0038260,33.05
1,53,1976,2029,0.0049489,0.0040469,32.17
1,54,1976,2030,0.0053157,0.0042778,31.30
1,55,1976,2031,0.0057365,0.0045431,30.44
1,56,1976,2032,0.0062406,0.0048856,29.57
1,57,1976,2033,0.0068502,0.0053244,28.72
1,58,1976,2034,0.0075521,0.0058443,27.87
1,59,1976,2035,0.0083035,0.0063856,27.03
1,60,1976,2036,0.0090849,0.0069205,26.20
1,61,1976,2037,0.0099105,0.0074668,25.38
1,62,1976,2038,0.0107829,0.0080269,24.56
1,63,1976,2039,0.0116995,0.0085974,23.76
1,64,1976,2040,0.0126957,0.0092132,22.96
1,65,1976,2041,0.0138071,0.0099023,22.17
1,66,1976,2042,0.0150054,0.0106475,21.39
1,67,1976,2043,0.0162315,0.0113672,20.61
1,68,1976,2044,0.0174919,0.0120466,19.84
1,69,1976,2045,0.0188954,0.0127908,19.08
1,70,1976,2046,0.0205786,0.0137331,18.32
1,71,1976,2047,0.0226142,0.0149883,17.57
1,72,1976,2048,0.0250119,0.0165907,16.83
1,73,1976,2049,0.0277519,0.0185036,16.10
1,74,1976,2050,0.0307579,0.0206430,15.40
1,75,1976,2051,0.0339099,0.0228536,14.71
1,76,1976,2052,0.0371478,0.0250483,14.04
1,77,1976,2053,0.0405123,0.0272333,13.39
1,78,1976,2054,0.0440886,0.0294527,12.75
1,79,1976,2055,0.0480027,0.0318203,12.12
1,80,1976,2056,0.0536037,0.0361468,11.50
1,81,1976,2057,0.0586892,0.0394801,10.92
1,82,1976,2058,0.0642414,0.0431461,10.35
1,83,1976,2059,0.0702997,0.0471775,9.79
1,84,1976,2060,0.0769067,0.0516203,9.25
1,85,1976,2061,0.0841076,0.0565268,8.73
1,86,1976,2062,0.0919504,0.0619930,8.22
1,87,1976,2063,0.1004863,0.0680891,7.73
1,88,1976,2064,0.1097689,0.0748290,7.26
1,89,1976,2065,0.1198550,0.0822321,6.80
1,90,1976,2066,0.1308036,0.0903739,6.37
1,91,1976,2067,0.1426766,0.0993720,5.95
1,92,1976,2068,0.1555375,0.1093159,5.55
1,93,1976,2069,0.1694519,0.1202221,5.17
1,94,1976,2070,0.1844867,0.1321310,4.81
1,95,1976,2071,0.2007091,0.1451801,4.47
1,96,1976,2072,0.2181866,0.1595436,4.14
1,97,1976,2073,0.2369856,0.1753504,3.83
1,98,1976,2074,0.2571705,0.1926318,3.54
1,99,1976,2075,0.2788028,0.2114334,3.27
1,100,1976,2076,0.3019394,0.2319174,3.01
1,101,1976,2077,0.3266317,0.2542832,2.77
1,102,1976,2078,0.3529236,0.2786561,2.54
1,103,1976,2079,0.3808502,0.3050447,2.33
1,104,1976,2080,0.4104359,0.3334895,2.13
1,105,1976,2081,0.4416930,0.3641489,1.95
1,106,1976,2082,0.4746198,0.3971939,1.78
1,107,1976,2083,0.5091990,0.4326966,1.62
1,108,1976,2084,0.5453968,0.4705912,1.47
1,109,1976,2085,0.5831612,0.5108265,1.34
1,110,1976,2086,0.6224217,0.5534456,1.21
1,111,1976,2087,0.6630882,0.5984700,1.10
1,112,1976,2088,0.7050519,0.6457998,0.99
1,113,1976,2089,0.7481851,0.6952121,0.88
1,114,1976,2090,0.7923424,0.7464979,0.75
1,115,1976,2091,1.0000000,1.0000000,0.50
1,23,1977,2000,0.0011978,0.0013368,59.62
1,24,1977,2001,0.0012275,0.0013520,58.70
1,25,1977,2002,0.0012521,0.0013659,57.78
1,26,1977,2003,0.0012759,0.0013823,56.85
1,27,1977,2004,0.0013058,0.0014064,55.93
1,28,1977,2005,0.0013446,0.0014369,55.01
1,29,1977,2006,0.0013859,0.0014712,54.09
1,30,1977,2007,0.0014216,0.0015021,53.17
1,31,1977,2008,0.0014530,0.0015266,52.25
1,32,1977,2009,0.0014859,0.0015480,51.33
1,33,1977,2010,0.0015203,0.0015678,50.40
1,34,1977,2011,0.0015540,0.0015852,49.48
1,35,1977,2012,0.0015941,0.0016081,48.56
1,36,1977,2013,0.0016525,0.0016476,47.64
1,37,1977,2014,0.0017318,0.0017045,46.72
1,38,1977,2015,0.0018255,0.0017716,45.80
1,39,1977,2016,0.0019305,0.0018481,44.88
1,40,1977,2017,0.0020513,0.0019407,43.96
1,41,1977,2018,0.0021897,0.0020513,43.04
1,42,1977,2019,0.0023342,0.0021654,42.13
1,43,1977,2020,0.0024669,0.0022629,41.22
1,44,1977,2021,0.0025867,0.0023422,40.31
1,45,1977,2022,0.0027191,0.0024257,39.41
1,46,1977,2023,0.0028925,0.0025476,38.50
1,47,1977,2024,0.0031101,0.0027076,37.60
1,48,1977,2025,0.0033571,0.0028915,36.70
1,49,1977,2026,0.0036304,0.0030926,35.80
1,50,1977,2027,0.0039379,0.0033139,34.91
1,51,1977,2028,0.0042708,0.0035508,34.03
1,52,1977,2029,0.0046082,0.0037817,33.15
1,53,1977,2030,0.0049489,0.0039950,32.27
1,54,1977,2031,0.0053157,0.0042208,31.40
1,55,1977,2032,0.0057365,0.0044855,30.53
1,56,1977,2033,0.0062406,0.0048286,29.66
1,57,1977,2034,0.0068502,0.0052621,28.81
1,58,1977,2035,0.0075521,0.0057720,27.96
1,59,1977,2036,0.0083035,0.0063066,27.11
1,60,1977,2037,0.0090849,0.0068407,26.28
1,61,1977,2038,0.0099105,0.0073871,25.46
1,62,1977,2039,0.0107829,0.0079386,24.65
1,63,1977,2040,0.0116995,0.0084937,23.84
1,64,1977,2041,0.0126957,0.0090993,23.04
1,65,1977,2042,0.0138071,0.0097872,22.25
1,66,1977,2043,0.0150054,0.0105335,21.46
1,67,1977,2044,0.0162315,0.0112421,20.69
1,68,1977,2045,0.0174919,0.0119003,19.91
1,69,1977,2046,0.0188954,0.0126297,19.15
1,70,1977,2047,0.0205786,0.0135694,18.39
1,71,1977,2048,0.0226142,0.0148244,17.63
1,72,1977,2049,0.0250119,0.0164095,16.89
1,73,1977,2050,0.0277519,0.0182917,16.16
1,74,1977,2051,0.0307579,0.0204113,15.46
1,75,1977,2052,0.0339099,0.0226206,14.77
1,76,1977,2053,0.0371478,0.0248157,14.10
1,77,1977,2054,0.0405123,0.0269745,13.44
1,78,1977,2055,0.0440886,0.0291488,12.80
1,79,1977,2056,0.0480027,0.0314862,12.17
1,80,1977,2057,0.0536037,0.0358125,11.55
1,81,1977,2058,0.0586892,0.0391479,10.96
1,82,1977,2059,0.0642414,0.0427811,10.39
1,83,1977,2060,0.0702997,0.0467514,9.83
1,84,1977,2061,0.0769067,0.0511534,9.29
1,85,1977,2062,0.0841076,0.0560569,8.76
1,86,1977,2063,0.0919504,0.0615285,8.25
1,87,1977,2064,0.1004863,0.0675820,7.76
1,88,1977,2065,0.1097689,0.0742423,7.29
1,89,1977,2066,0.1198550,0.0815954,6.83
1,90,1977,2067,0.1308036,0.0897386,6.39
1,91,1977,2068,0.1426766,0.0987464,5.98
1,92,1977,2069,0.1555375,0.1086334,5.58
1,93,1977,2070,0.1694519,0.1194371,5.19
1,94,1977,2071,0.1844867,0.1312871,4.83
1,95,1977,2072,0.2007091,0.1443484,4.48
1,96,1977,2073,0.2181866,0.1587449,4.16
1,97,1977,2074,0.2369856,0.1745079,3.85
1,98,1977,2075,0.2571705,0.1916830,3.55
1,99,1977,2076,0.2788028,0.2104285,3.28
1,100,1977,2077,0.3019394,0.2309412,3.02
1,101,1977,2078,0.3266317,0.2533496,2.78
1,102,1977,2079,0.3529236,0.2776702,2.55
1,103,1977,2080,0.3808502,0.3039518,2.34
1,104,1977,2081,0.4104359,0.3323620,2.14
1,105,1977,2082,0.4416930,0.3630868,1.95
1,106,1977,2083,0.4746198,0.3962195,1.78
1,107,1977,2084,0.5091990,0.4317177,1.62
1,108,1977,2085,0.5453968,0.4695553,1.48
1,109,1977,2086,0.5831612,0.5098078,1.34
1,110,1977,2087,0.6224217,0.5525368,1.22
1,111,1977,2088,0.6630882,0.5976846,1.10
1,112,1977,2089,0.7050519,0.6450633,0.99
1,113,1977,2090,0.7481851,0.6944990,0.88
1,114,1977,2091,0.7923424,0.7458713,0.75
1,115,1977,2092,1.0000000,1.0000000,0.50
1,22,1978,2000,0.0011584,0.0012948,60.66
1,23,1978,2001,0.0011978,0.0013216,59.74
1,24,1978,2002,0.0012275,0.0013381,58.81
1,25,1978,2003,0.0012521,0.0013547,57.89
1,26,1978,2004,0.0012759,0.0013737,56.97
1,27,1978,2005,0.0013058,0.0013981,56.05
1,28,1978,2006,0.0013446,0.0014284,55.13
1,29,1978,2007,0.0013859,0.0014628,54.20
1,30,1978,2008,0.0014216,0.0014919,53.28
1,31,1978,2009,0.0014530,0.0015124,52.36
1,32,1978,2010,0.0014859,0.0015308,51.44
1,33,1978,2011,0.0015203,0.0015493,50.52
1,34,1978,2012,0.0015540,0.0015667,49.60
1,35,1978,2013,0.0015941,0.0015896,48.67
1,36,1978,2014,0.0016525,0.0016273,47.75
1,37,1978,2015,0.0017318,0.0016810,46.83
1,38,1978,2016,0.0018255,0.0017464,45.90
1,39,1978,2017,0.0019305,0.0018237,44.98
1,40,1978,2018,0.0020513,0.0019176,44.07
1,41,1978,2019,0.0021897,0.0020270,43.15
1,42,1978,2020,0.0023342,0.0021383,42.24
1,43,1978,2021,0.0024669,0.0022344,41.32
1,44,1978,2022,0.0025867,0.0023143,40.42
1,45,1978,2023,0.0027191,0.0023981,39.51
1,46,1978,2024,0.0028925,0.0025176,38.60
1,47,1978,2025,0.0031101,0.0026729,37.70
1,48,1978,2026,0.0033571,0.0028540,36.80
1,49,1978,2027,0.0036304,0.0030553,35.90
1,50,1978,2028,0.0039379,0.0032769,35.01
1,51,1978,2029,0.0042708,0.0035100,34.12
1,52,1978,2030,0.0046082,0.0037341,33.24
1,53,1978,2031,0.0049489,0.0039426,32.37
1,54,1978,2032,0.0053157,0.0041679,31.49
1,55,1978,2033,0.0057365,0.0044329,30.62
1,56,1978,2034,0.0062406,0.0047710,29.76
1,57,1978,2035,0.0068502,0.0051951,28.90
1,58,1978,2036,0.0075521,0.0056989,28.04
1,59,1978,2037,0.0083035,0.0062331,27.20
1,60,1978,2038,0.0090849,0.0067675,26.37
1,61,1978,2039,0.0099105,0.0073061,25.55
1,62,1978,2040,0.0107829,0.0078434,24.73
1,63,1978,2041,0.0116995,0.0083888,23.92
1,64,1978,2042,0.0126957,0.0089933,23.12
1,65,1978,2043,0.0138071,0.0096821,22.33
1,66,1978,2044,0.0150054,0.0104184,21.54
1,67,1978,2045,0.0162315,0.0111077,20.76
1,68,1978,2046,0.0174919,0.0117524,19.99
1,69,1978,2047,0.0188954,0.0124798,19.22
1,70,1978,2048,0.0205786,0.0134192,18.46
1,71,1978,2049,0.0226142,0.0146579,17.70
1,72,1978,2050,0.0250119,0.0162142,16.96
1,73,1978,2051,0.0277519,0.0180772,16.23
1,74,1978,2052,0.0307579,0.0201951,15.52
1,75,1978,2053,0.0339099,0.0224048,14.83
1,76,1978,2054,0.0371478,0.0245762,14.15
1,77,1978,2055,0.0405123,0.0266940,13.50
1,78,1978,2056,0.0440886,0.0288409,12.86
1,79,1978,2057,0.0480027,0.0311747,12.22
1,80,1978,2058,0.0536037,0.0355061,11.60
1,81,1978,2059,0.0586892,0.0388112,11.01
1,82,1978,2060,0.0642414,0.0423874,10.43
1,83,1978,2061,0.0702997,0.0463189,9.87
1,84,1978,2062,0.0769067,0.0507173,9.33
1,85,1978,2063,0.0841076,0.0556249,8.80
1,86,1978,2064,0.0919504,0.0610558,8.29
1,87,1978,2065,0.1004863,0.0670338,7.79
1,88,1978,2066,0.1097689,0.0736460,7.32
1,89,1978,2067,0.1198550,0.0809994,6.86
1,90,1978,2068,0.1308036,0.0891506,6.42
1,91,1978,2069,0.1426766,0.0981035,6.00
1,92,1978,2070,0.1555375,0.1078924,5.60
1,93,1978,2071,0.1694519,0.1186384,5.21
1,94,1978,2072,0.1844867,0.1304978,4.85
1,95,1978,2073,0.2007091,0.1435881,4.50
1,96,1978,2074,0.2181866,0.1579402,4.17
1,97,1978,2075,0.2369856,0.1735985,3.86
1,98,1978,2076,0.2571705,0.1907159,3.57
1,99,1978,2077,0.2788028,0.2094848,3.29
1,100,1978,2078,0.3019394,0.2300342,3.03
1,101,1978,2079,0.3266317,0.2523865,2.79
1,102,1978,2080,0.3529236,0.2765961,2.56
1,103,1978,2081,0.3808502,0.3028362,2.34
1,104,1978,2082,0.4104359,0.3313031,2.14
1,105,1978,2083,0.4416930,0.3621069,1.96
1,106,1978,2084,0.4746198,0.3952255,1.79
1,107,1978,2085,0.5091990,0.4306543,1.63
1,108,1978,2086,0.5453968,0.4684964,1.48
1,109,1978,2087,0.5831612,0.5088491,1.34
1,110,1978,2088,0.6224217,0.5516937,1.22
1,111,1978,2089,0.6630882,0.5968772,1.10
1,112,1978,2090,0.7050519,0.6442606,0.99
1,113,1978,2091,0.7481851,0.6937691,0.88
1,114,1978,2092,0.7923424,0.7452812,0.75
1,115,1978,2093,1.0000000,1.0000000,0.50
1,21,1979,2000,0.0011033,0.0012336,61.70
1,22,1979,2001,0.0011584,0.0012799,60.78
1,23,1979,2002,0.0011978,0.0013078,59.85
1,24,1979,2003,0.0012275,0.0013273,58.93
1,25,1979,2004,0.0012521,0.0013465,58.01
1,26,1979,2005,0.0012759,0.0013656,57.09
1,27,1979,2006,0.0013058,0.0013896,56.16
1,28,1979,2007,0.0013446,0.0014201,55.24
1,29,1979,2008,0.0013859,0.0014530,54.32
1,30,1979,2009,0.0014216,0.0014784,53.40
1,31,1979,2010,0.0014530,0.0014959,52.48
1,32,1979,2011,0.0014859,0.0015133,51.55
1,33,1979,2012,0.0015203,0.0015321,50.63
1,34,1979,2013,0.0015540,0.0015498,49.71
1,35,1979,2014,0.0015941,0.0015709,48.78
1,36,1979,2015,0.0016525,0.0016055,47.86
1,37,1979,2016,0.0017318,0.0016572,46.94
1,38,1979,2017,0.0018255,0.0017230,46.01
1,39,1979,2018,0.0019305,0.0018014,45.09
1,40,1979,2019,0.0020513,0.0018942,44.17
1,41,1979,2020,0.0021897,0.0020010,43.26
1,42,1979,2021,0.0023342,0.0021110,42.34
1,43,1979,2022,0.0024669,0.0022079,41.43
1,44,1979,2023,0.0025867,0.0022888,40.52
1,45,1979,2024,0.0027191,0.0023701,39.61
1,46,1979,2025,0.0028925,0.0024852,38.70
1,47,1979,2026,0.0031101,0.0026378,37.80
1,48,1979,2027,0.0033571,0.0028192,36.90
1,49,1979,2028,0.0036304,0.0030213,36.00
1,50,1979,2029,0.0039379,0.0032394,35.11
1,51,1979,2030,0.0042708,0.0034661,34.22
1,52,1979,2031,0.0046082,0.0036859,33.34
1,53,1979,2032,0.0049489,0.0038938,32.46
1,54,1979,2033,0.0053157,0.0041196,31.59
1,55,1979,2034,0.0057365,0.0043799,30.71
1,56,1979,2035,0.0062406,0.0047093,29.85
1,57,1979,2036,0.0068502,0.0051274,28.99
1,58,1979,2037,0.0075521,0.0056309,28.13
1,59,1979,2038,0.0083035,0.0061656,27.29
1,60,1979,2039,0.0090849,0.0066932,26.46
1,61,1979,2040,0.0099105,0.0072189,25.63
1,62,1979,2041,0.0107829,0.0077472,24.81
1,63,1979,2042,0.0116995,0.0082913,24.00
1,64,1979,2043,0.0126957,0.0088965,23.20
1,65,1979,2044,0.0138071,0.0095760,22.40
1,66,1979,2045,0.0150054,0.0102946,21.61
1,67,1979,2046,0.0162315,0.0109717,20.83
1,68,1979,2047,0.0174919,0.0116146,20.06
1,69,1979,2048,0.0188954,0.0123422,19.29
1,70,1979,2049,0.0205786,0.0132666,18.52
1,71,1979,2050,0.0226142,0.0144785,17.77
1,72,1979,2051,0.0250119,0.0160166,17.02
1,73,1979,2052,0.0277519,0.0178771,16.29
1,74,1979,2053,0.0307579,0.0199951,15.58
1,75,1979,2054,0.0339099,0.0221828,14.88
1,76,1979,2055,0.0371478,0.0243168,14.21
1,77,1979,2056,0.0405123,0.0264098,13.55
1,78,1979,2057,0.0440886,0.0285539,12.91
1,79,1979,2058,0.0480027,0.0308894,12.27
1,80,1979,2059,0.0536037,0.0351956,11.65
1,81,1979,2060,0.0586892,0.0384480,11.05
1,82,1979,2061,0.0642414,0.0419880,10.48
1,83,1979,2062,0.0702997,0.0459151,9.91
1,84,1979,2063,0.0769067,0.0503165,9.37
1,85,1979,2064,0.0841076,0.0551853,8.83
1,86,1979,2065,0.0919504,0.0605449,8.32
1,87,1979,2066,0.1004863,0.0664769,7.83
1,88,1979,2067,0.1097689,0.0730881,7.35
1,89,1979,2068,0.1198550,0.0804479,6.89
1,90,1979,2069,0.1308036,0.0885465,6.45
1,91,1979,2070,0.1426766,0.0974057,6.02
1,92,1979,2071,0.1555375,0.1071386,5.62
1,93,1979,2072,0.1694519,0.1178917,5.23
1,94,1979,2073,0.1844867,0.1297765,4.87
1,95,1979,2074,0.2007091,0.1428224,4.52
1,96,1979,2075,0.2181866,0.1570720,4.19
1,97,1979,2076,0.2369856,0.1726718,3.88
1,98,1979,2077,0.2571705,0.1898079,3.58
1,99,1979,2078,0.2788028,0.2086083,3.30
1,100,1979,2079,0.3019394,0.2290989,3.04
1,101,1979,2080,0.3266317,0.2513376,2.79
1,102,1979,2081,0.3529236,0.2755000,2.57
1,103,1979,2082,0.3808502,0.3017887,2.35
1,104,1979,2083,0.4104359,0.3303264,2.15
1,105,1979,2084,0.4416930,0.3611077,1.96
1,106,1979,2085,0.4746198,0.3941462,1.79
1,107,1979,2086,0.5091990,0.4295676,1.63
1,108,1979,2087,0.5453968,0.4675000,1.48
1,109,1979,2088,0.5831612,0.5079598,1.35
1,110,1979,2089,0.6224217,0.5508271,1.22
1,111,1979,2090,0.6630882,0.5959973,1.10
1,112,1979,2091,0.7050519,0.6434392,0.99
1,113,1979,2092,0.7481851,0.6930818,0.89
1,114,1979,2093,0.7923424,0.7447342,0.76
1,115,1979,2094,1.0000000,1.0000000,0.50
1,20,1980,2000,0.0010297,0.0011530,62.75
1,21,1980,2001,0.0011033,0.0012194,61.82
1,22,1980,2002,0.0011584,0.0012664,60.89
1,23,1980,2003,0.0011978,0.0012970,59.97
1,24,1980,2004,0.0012275,0.0013192,59.05
1,25,1980,2005,0.0012521,0.0013386,58.13
1,26,1980,2006,0.0012759,0.0013573,57.20
1,27,1980,2007,0.0013058,0.0013813,56.28
1,28,1980,2008,0.0013446,0.0014106,55.36
1,29,1980,2009,0.0013859,0.0014401,54.43
1,30,1980,2010,0.0014216,0.0014627,53.51
1,31,1980,2011,0.0014530,0.0014792,52.59
1,32,1980,2012,0.0014859,0.0014971,51.67
1,33,1980,2013,0.0015203,0.0015164,50.74
1,34,1980,2014,0.0015540,0.0015327,49.82
1,35,1980,2015,0.0015941,0.0015508,48.90
1,36,1980,2016,0.0016525,0.0015835,47.97
1,37,1980,2017,0.0017318,0.0016351,47.05
1,38,1980,2018,0.0018255,0.0017016,46.12
1,39,1980,2019,0.0019305,0.0017789,45.20
1,40,1980,2020,0.0020513,0.0018691,44.28
1,41,1980,2021,0.0021897,0.0019747,43.36
1,42,1980,2022,0.0023342,0.0020856,42.45
1,43,1980,2023,0.0024669,0.0021835,41.53
1,44,1980,2024,0.0025867,0.0022627,40.62
1,45,1980,2025,0.0027191,0.0023400,39.71
1,46,1980,2026,0.0028925,0.0024526,38.81
1,47,1980,2027,0.0031101,0.0026052,37.90
1,48,1980,2028,0.0033571,0.0027874,37.00
1,49,1980,2029,0.0036304,0.0029867,36.10
1,50,1980,2030,0.0039379,0.0031991,35.21
1,51,1980,2031,0.0042708,0.0034218,34.32
1,52,1980,2032,0.0046082,0.0036412,33.43
1,53,1980,2033,0.0049489,0.0038493,32.56
1,54,1980,2034,0.0053157,0.0040708,31.68
1,55,1980,2035,0.0057365,0.0043229,30.81
1,56,1980,2036,0.0062406,0.0046468,29.94
1,57,1980,2037,0.0068502,0.0050645,29.08
1,58,1980,2038,0.0075521,0.0055686,28.22
1,59,1980,2039,0.0083035,0.0060972,27.38
1,60,1980,2040,0.0090849,0.0066132,26.54
1,61,1980,2041,0.0099105,0.0071307,25.71
1,62,1980,2042,0.0107829,0.0076576,24.90
1,63,1980,2043,0.0116995,0.0082022,24.08
1,64,1980,2044,0.0126957,0.0087988,23.28
1,65,1980,2045,0.0138071,0.0094619,22.48
1,66,1980,2046,0.0150054,0.0101694,21.69
1,67,1980,2047,0.0162315,0.0108451,20.91
1,68,1980,2048,0.0174919,0.0114883,20.13
1,69,1980,2049,0.0188954,0.0122024,19.36
1,70,1980,2050,0.0205786,0.0131022,18.59
1,71,1980,2051,0.0226142,0.0142970,17.83
1,72,1980,2052,0.0250119,0.0158323,17.09
1,73,1980,2053,0.0277519,0.0176921,16.35
1,74,1980,2054,0.0307579,0.0197892,15.64
1,75,1980,2055,0.0339099,0.0219423,14.94
1,76,1980,2056,0.0371478,0.0240539,14.27
1,77,1980,2057,0.0405123,0.0261449,13.61
1,78,1980,2058,0.0440886,0.0282910,12.96
1,79,1980,2059,0.0480027,0.0306005,12.32
1,80,1980,2060,0.0536037,0.0348608,11.69
1,81,1980,2061,0.0586892,0.0380797,11.10
1,82,1980,2062,0.0642414,0.0416151,10.52
1,83,1980,2063,0.0702997,0.0455441,9.95
1,84,1980,2064,0.0769067,0.0499087,9.40
1,85,1980,2065,0.0841076,0.0547104,8.87
1,86,1980,2066,0.0919504,0.0600261,8.36
1,87,1980,2067,0.1004863,0.0659559,7.86
1,88,1980,2068,0.1097689,0.0725719,7.38
1,89,1980,2069,0.1198550,0.0798814,6.92
1,90,1980,2070,0.1308036,0.0878910,6.47
1,91,1980,2071,0.1426766,0.0966962,6.05
1,92,1980,2072,0.1555375,0.1064341,5.64
1,93,1980,2073,0.1694519,0.1172095,5.25
1,94,1980,2074,0.1844867,0.1290503,4.89
1,95,1980,2075,0.2007091,0.1419964,4.54
1,96,1980,2076,0.2181866,0.1561875,4.20
1,97,1980,2077,0.2369856,0.1718020,3.89
1,98,1980,2078,0.2571705,0.1889649,3.59
1,99,1980,2079,0.2788028,0.2077046,3.31
1,100,1980,2080,0.3019394,0.2280804,3.05
1,101,1980,2081,0.3266317,0.2502675,2.80
1,102,1980,2082,0.3529236,0.2744711,2.57
1,103,1980,2083,0.3808502,0.3008229,2.36
1,104,1980,2084,0.4104359,0.3293307,2.16
1,105,1980,2085,0.4416930,0.3600229,1.97
1,106,1980,2086,0.4746198,0.3930433,1.80
1,107,1980,2087,0.5091990,0.4285453,1.64
1,108,1980,2088,0.5453968,0.4665760,1.49
1,109,1980,2089,0.5831612,0.5070461,1.35
1,110,1980,2090,0.6224217,0.5498830,1.22
1,111,1980,2091,0.6630882,0.5950972,1.11
1,112,1980,2092,0.7050519,0.6426659,1.00
1,113,1980,2093,0.7481851,0.6924449,0.89
1,114,1980,2094,0.7923424,0.7441731,0.76
1,115,1980,2095,1.0000000,1.0000000,0.50
1,19,1981,2000,0.0009391,0.0010557,63.80
1,20,1981,2001,0.0010297,0.0011395,62.87
1,21,1981,2002,0.0011033,0.0012064,61.94
1,22,1981,2003,0.0011584,0.0012558,61.01
1,23,1981,2004,0.0011978,0.0012890,60.09
1,24,1981,2005,0.0012275,0.0013116,59.16
1,25,1981,2006,0.0012521,0.0013307,58.24
1,26,1981,2007,0.0012759,0.0013493,57.32
1,27,1981,2008,0.0013058,0.0013717,56.39
1,28,1981,2009,0.0013446,0.0013979,55.47
1,29,1981,2010,0.0013859,0.0014251,54.55
1,30,1981,2011,0.0014216,0.0014467,53.63
1,31,1981,2012,0.0014530,0.0014637,52.70
1,32,1981,2013,0.0014859,0.0014822,51.78
1,33,1981,2014,0.0015203,0.0015005,50.86
1,34,1981,2015,0.0015540,0.0015143,49.93
1,35,1981,2016,0.0015941,0.0015305,49.01
1,36,1981,2017,0.0016525,0.0015631,48.08
1,37,1981,2018,0.0017318,0.0016149,47.15
1,38,1981,2019,0.0018255,0.0016800,46.23
1,39,1981,2020,0.0019305,0.0017547,45.31
1,40,1981,2021,0.0020513,0.0018437,44.39
1,41,1981,2022,0.0021897,0.0019502,43.47
1,42,1981,2023,0.0023342,0.0020622,42.55
1,43,1981,2024,0.0024669,0.0021588,41.64
1,44,1981,2025,0.0025867,0.0022347,40.73
1,45,1981,2026,0.0027191,0.0023096,39.82
1,46,1981,2027,0.0028925,0.0024222,38.91
1,47,1981,2028,0.0031101,0.0025753,38.00
1,48,1981,2029,0.0033571,0.0027551,37.10
1,49,1981,2030,0.0036304,0.0029496,36.20
1,50,1981,2031,0.0039379,0.0031584,35.30
1,51,1981,2032,0.0042708,0.0033805,34.42
1,52,1981,2033,0.0046082,0.0036003,33.53
1,53,1981,2034,0.0049489,0.0038044,32.65
1,54,1981,2035,0.0053157,0.0040184,31.77
1,55,1981,2036,0.0057365,0.0042653,30.90
1,56,1981,2037,0.0062406,0.0045888,30.03
1,57,1981,2038,0.0068502,0.0050068,29.16
1,58,1981,2039,0.0075521,0.0055053,28.31
1,59,1981,2040,0.0083035,0.0060235,27.46
1,60,1981,2041,0.0090849,0.0065322,26.63
1,61,1981,2042,0.0099105,0.0070487,25.80
1,62,1981,2043,0.0107829,0.0075758,24.98
1,63,1981,2044,0.0116995,0.0081122,24.16
1,64,1981,2045,0.0126957,0.0086938,23.36
1,65,1981,2046,0.0138071,0.0093465,22.56
1,66,1981,2047,0.0150054,0.0100528,21.77
1,67,1981,2048,0.0162315,0.0107289,20.98
1,68,1981,2049,0.0174919,0.0113598,20.20
1,69,1981,2050,0.0188954,0.0120518,19.43
1,70,1981,2051,0.0205786,0.0129360,18.66
1,71,1981,2052,0.0226142,0.0141279,17.90
1,72,1981,2053,0.0250119,0.0156620,17.15
1,73,1981,2054,0.0277519,0.0175018,16.41
1,74,1981,2055,0.0307579,0.0195664,15.70
1,75,1981,2056,0.0339099,0.0216987,15.00
1,76,1981,2057,0.0371478,0.0238089,14.32
1,77,1981,2058,0.0405123,0.0259023,13.66
1,78,1981,2059,0.0440886,0.0280248,13.01
1,79,1981,2060,0.0480027,0.0302891,12.37
1,80,1981,2061,0.0536037,0.0345211,11.74
1,81,1981,2062,0.0586892,0.0377358,11.14
1,82,1981,2063,0.0642414,0.0412724,10.56
1,83,1981,2064,0.0702997,0.0451667,9.99
1,84,1981,2065,0.0769067,0.0494682,9.44
1,85,1981,2066,0.0841076,0.0542282,8.91
1,86,1981,2067,0.0919504,0.0595408,8.39
1,87,1981,2068,0.1004863,0.0654740,7.89
1,88,1981,2069,0.1097689,0.0720419,7.41
1,89,1981,2070,0.1198550,0.0792669,6.94
1,90,1981,2071,0.1308036,0.0872246,6.50
1,91,1981,2072,0.1426766,0.0960332,6.07
1,92,1981,2073,0.1555375,0.1057906,5.66
1,93,1981,2074,0.1694519,0.1165228,5.28
1,94,1981,2075,0.1844867,0.1282672,4.90
1,95,1981,2076,0.2007091,0.1411553,4.55
1,96,1981,2077,0.2181866,0.1553576,4.22
1,97,1981,2078,0.2369856,0.1709947,3.90
1,98,1981,2079,0.2571705,0.1880959,3.61
1,99,1981,2080,0.2788028,0.2067209,3.32
1,100,1981,2081,0.3019394,0.2270418,3.06
1,101,1981,2082,0.3266317,0.2492634,2.81
1,102,1981,2083,0.3529236,0.2735227,2.58
1,103,1981,2084,0.3808502,0.2998384,2.36
1,104,1981,2085,0.4104359,0.3282500,2.16
1,105,1981,2086,0.4416930,0.3589148,1.97
1,106,1981,2087,0.4746198,0.3920062,1.80
1,107,1981,2088,0.5091990,0.4275975,1.64
1,108,1981,2089,0.5453968,0.4656267,1.49
1,109,1981,2090,0.5831612,0.5060508,1.35
1,110,1981,2091,0.6224217,0.5489174,1.23
1,111,1981,2092,0.6630882,0.5942499,1.11
1,112,1981,2093,0.7050519,0.6419494,1.00
1,113,1981,2094,0.7481851,0.6917915,0.89
1,114,1981,2095,0.7923424,0.7435619,0.76
1,115,1981,2096,1.0000000,1.0000000,0.50
1,18,1982,2000,0.0008321,0.0009422,64.86
1,19,1982,2001,0.0009391,0.0010429,63.92
1,20,1982,2002,0.0010297,0.0011272,62.98
1,21,1982,2003,0.0011033,0.0011963,62.05
1,22,1982,2004,0.0011584,0.0012479,61.13
1,23,1982,2005,0.0011978,0.0012814,60.20
1,24,1982,2006,0.0012275,0.0013039,59.28
1,25,1982,2007,0.0012521,0.0013229,58.36
1,26,1982,2008,0.0012759,0.0013400,57.43
1,27,1982,2009,0.0013058,0.0013590,56.51
1,28,1982,2010,0.0013446,0.0013831,55.59
1,29,1982,2011,0.0013859,0.0014099,54.66
1,30,1982,2012,0.0014216,0.0014319,53.74
1,31,1982,2013,0.0014530,0.0014495,52.82
1,32,1982,2014,0.0014859,0.0014671,51.89
1,33,1982,2015,0.0015203,0.0014833,50.97
1,34,1982,2016,0.0015540,0.0014957,50.04
1,35,1982,2017,0.0015941,0.0015116,49.12
1,36,1982,2018,0.0016525,0.0015444,48.19
1,37,1982,2019,0.0017318,0.0015945,47.26
1,38,1982,2020,0.0018255,0.0016568,46.34
1,39,1982,2021,0.0019305,0.0017302,45.41
1,40,1982,2022,0.0020513,0.0018201,44.49
1,41,1982,2023,0.0021897,0.0019278,43.57
1,42,1982,2024,0.0023342,0.0020385,42.66
1,43,1982,2025,0.0024669,0.0021321,41.74
1,44,1982,2026,0.0025867,0.0022064,40.83
1,45,1982,2027,0.0027191,0.0022812,39.92
1,46,1982,2028,0.0028925,0.0023943,39.01
1,47,1982,2029,0.0031101,0.0025451,38.10
1,48,1982,2030,0.0033571,0.0027205,37.20
1,49,1982,2031,0.0036304,0.0029120,36.30
1,50,1982,2032,0.0039379,0.0031205,35.40
1,51,1982,2033,0.0042708,0.0033429,34.51
1,52,1982,2034,0.0046082,0.0035590,33.63
1,53,1982,2035,0.0049489,0.0037562,32.74
1,54,1982,2036,0.0053157,0.0039655,31.87
1,55,1982,2037,0.0057365,0.0042117,30.99
1,56,1982,2038,0.0062406,0.0045356,30.12
1,57,1982,2039,0.0068502,0.0049483,29.25
1,58,1982,2040,0.0075521,0.0054372,28.40
1,59,1982,2041,0.0083035,0.0059490,27.55
1,60,1982,2042,0.0090849,0.0064569,26.71
1,61,1982,2043,0.0099105,0.0069737,25.88
1,62,1982,2044,0.0107829,0.0074933,25.06
1,63,1982,2045,0.0116995,0.0080155,24.25
1,64,1982,2046,0.0126957,0.0085876,23.44
1,65,1982,2047,0.0138071,0.0092391,22.64
1,66,1982,2048,0.0150054,0.0099459,21.84
1,67,1982,2049,0.0162315,0.0106108,21.06
1,68,1982,2050,0.0174919,0.0112215,20.28
1,69,1982,2051,0.0188954,0.0118996,19.50
1,70,1982,2052,0.0205786,0.0127811,18.73
1,71,1982,2053,0.0226142,0.0139716,17.97
1,72,1982,2054,0.0250119,0.0154869,17.21
1,73,1982,2055,0.0277519,0.0172958,16.48
1,74,1982,2056,0.0307579,0.0193407,15.76
1,75,1982,2057,0.0339099,0.0214718,15.06
1,76,1982,2058,0.0371478,0.0235846,14.38
1,77,1982,2059,0.0405123,0.0256566,13.71
1,78,1982,2060,0.0440886,0.0277379,13.06
1,79,1982,2061,0.0480027,0.0299735,12.42
1,80,1982,2062,0.0536037,0.0342042,11.79
1,81,1982,2063,0.0586892,0.0374200,11.19
1,82,1982,2064,0.0642414,0.0409240,10.60
1,83,1982,2065,0.0702997,0.0447590,10.04
1,84,1982,2066,0.0769067,0.0490212,9.48
1,85,1982,2067,0.0841076,0.0537773,8.94
1,86,1982,2068,0.0919504,0.0590921,8.42
1,87,1982,2069,0.1004863,0.0649793,7.92
1,88,1982,2070,0.1097689,0.0714672,7.44
1,89,1982,2071,0.1198550,0.0786425,6.97
1,90,1982,2072,0.1308036,0.0866021,6.52
1,91,1982,2073,0.1426766,0.0954278,6.10
1,92,1982,2074,0.1555375,0.1051432,5.69
1,93,1982,2075,0.1694519,0.1157826,5.30
1,94,1982,2076,0.1844867,0.1274699,4.92
1,95,1982,2077,0.2007091,0.1403663,4.57
1,96,1982,2078,0.2181866,0.1545875,4.23
1,97,1982,2079,0.2369856,0.1701628,3.92
1,98,1982,2080,0.2571705,0.1871504,3.62
1,99,1982,2081,0.2788028,0.2057181,3.34
1,100,1982,2082,0.3019394,0.2260674,3.07
1,101,1982,2083,0.3266317,0.2483380,2.82
1,102,1982,2084,0.3529236,0.2725563,2.59
1,103,1982,2085,0.3808502,0.2987703,2.37
1,104,1982,2086,0.4104359,0.3271464,2.17
1,105,1982,2087,0.4416930,0.3578731,1.98
1,106,1982,2088,0.4746198,0.3910449,1.80
1,107,1982,2089,0.5091990,0.4266241,1.64
1,108,1982,2090,0.5453968,0.4645931,1.49
1,109,1982,2091,0.5831612,0.5050330,1.35
1,110,1982,2092,0.6224217,0.5480087,1.23
1,111,1982,2093,0.6630882,0.5934650,1.11
1,112,1982,2094,0.7050519,0.6412145,1.00
1,113,1982,2095,0.7481851,0.6910800,0.89
1,114,1982,2096,0.7923424,0.7429363,0.76
1,115,1982,2097,1.0000000,1.0000000,0.50
1,17,1983,2000,0.0007098,0.0008133,65.92
1,18,1983,2001,0.0008321,0.0009301,64.98
1,19,1983,2002,0.0009391,0.0010313,64.04
1,20,1983,2003,0.0010297,0.0011177,63.10
1,21,1983,2004,0.0011033,0.0011888,62.17
1,22,1983,2005,0.0011584,0.0012405,61.24
1,23,1983,2006,0.0011978,0.0012737,60.32
1,24,1983,2007,0.0012275,0.0012963,59.40
1,25,1983,2008,0.0012521,0.0013139,58.47
1,26,1983,2009,0.0012759,0.0013277,57.55
1,27,1983,2010,0.0013058,0.0013443,56.63
1,28,1983,2011,0.0013446,0.0013681,55.70
1,29,1983,2012,0.0013859,0.0013957,54.78
1,30,1983,2013,0.0014216,0.0014183,53.85
1,31,1983,2014,0.0014530,0.0014350,52.93
1,32,1983,2015,0.0014859,0.0014509,52.00
1,33,1983,2016,0.0015203,0.0014660,51.08
1,34,1983,2017,0.0015540,0.0014783,50.15
1,35,1983,2018,0.0015941,0.0014943,49.23
1,36,1983,2019,0.0016525,0.0015255,48.30
1,37,1983,2020,0.0017318,0.0015726,47.37
1,38,1983,2021,0.0018255,0.0016334,46.45
1,39,1983,2022,0.0019305,0.0017075,45.52
1,40,1983,2023,0.0020513,0.0017985,44.60
1,41,1983,2024,0.0021897,0.0019050,43.68
1,42,1983,2025,0.0023342,0.0020129,42.76
1,43,1983,2026,0.0024669,0.0021052,41.85
1,44,1983,2027,0.0025867,0.0021800,40.93
1,45,1983,2028,0.0027191,0.0022553,40.02
1,46,1983,2029,0.0028925,0.0023662,39.11
1,47,1983,2030,0.0031101,0.0025126,38.20
1,48,1983,2031,0.0033571,0.0026854,37.30
1,49,1983,2032,0.0036304,0.0028771,36.40
1,50,1983,2033,0.0039379,0.0030859,35.50
1,51,1983,2034,0.0042708,0.0033048,34.61
1,52,1983,2035,0.0046082,0.0035147,33.72
1,53,1983,2036,0.0049489,0.0037074,32.84
1,54,1983,2037,0.0053157,0.0039162,31.96
1,55,1983,2038,0.0057365,0.0041627,31.08
1,56,1983,2039,0.0062406,0.0044816,30.21
1,57,1983,2040,0.0068502,0.0048854,29.34
1,58,1983,2041,0.0075521,0.0053684,28.48
1,59,1983,2042,0.0083035,0.0058797,27.64
1,60,1983,2043,0.0090849,0.0063881,26.80
1,61,1983,2044,0.0099105,0.0068981,25.97
1,62,1983,2045,0.0107829,0.0074045,25.14
1,63,1983,2046,0.0116995,0.0079177,24.33
1,64,1983,2047,0.0126957,0.0084887,23.52
1,65,1983,2048,0.0138071,0.0091405,22.71
1,66,1983,2049,0.0150054,0.0098371,21.92
1,67,1983,2050,0.0162315,0.0104835,21.13
1,68,1983,2051,0.0174919,0.0110815,20.35
1,69,1983,2052,0.0188954,0.0117577,19.57
1,70,1983,2053,0.0205786,0.0126379,18.80
1,71,1983,2054,0.0226142,0.0138109,18.03
1,72,1983,2055,0.0250119,0.0152974,17.28
1,73,1983,2056,0.0277519,0.0170874,16.54
1,74,1983,2057,0.0307579,0.0191306,15.82
1,75,1983,2058,0.0339099,0.0212640,15.12
1,76,1983,2059,0.0371478,0.0233574,14.43
1,77,1983,2060,0.0405123,0.0253919,13.77
1,78,1983,2061,0.0440886,0.0274471,13.11
1,79,1983,2062,0.0480027,0.0296791,12.47
1,80,1983,2063,0.0536037,0.0339131,11.84
1,81,1983,2064,0.0586892,0.0370988,11.23
1,82,1983,2065,0.0642414,0.0405478,10.65
1,83,1983,2066,0.0702997,0.0443454,10.08
1,84,1983,2067,0.0769067,0.0486032,9.52
1,85,1983,2068,0.0841076,0.0533605,8.98
1,86,1983,2069,0.0919504,0.0586316,8.46
1,87,1983,2070,0.1004863,0.0644431,7.96
1,88,1983,2071,0.1097689,0.0708833,7.47
1,89,1983,2072,0.1198550,0.0780593,7.00
1,90,1983,2073,0.1308036,0.0860340,6.55
1,91,1983,2074,0.1426766,0.0948189,6.12
1,92,1983,2075,0.1555375,0.1044454,5.71
1,93,1983,2076,0.1694519,0.1150292,5.32
1,94,1983,2077,0.1844867,0.1267223,4.94
1,95,1983,2078,0.2007091,0.1396344,4.59
1,96,1983,2079,0.2181866,0.1537942,4.25
1,97,1983,2080,0.2369856,0.1692578,3.93
1,98,1983,2081,0.2571705,0.1861867,3.63
1,99,1983,2082,0.2788028,0.2047776,3.35
1,100,1983,2083,0.3019394,0.2251698,3.08
1,101,1983,2084,0.3266317,0.2473954,2.83
1,102,1983,2085,0.3529236,0.2715081,2.60
1,103,1983,2086,0.3808502,0.2976799,2.38
1,104,1983,2087,0.4104359,0.3261092,2.17
1,105,1983,2088,0.4416930,0.3569077,1.99
1,106,1983,2089,0.4746198,0.3900579,1.81
1,107,1983,2090,0.5091990,0.4255643,1.65
1,108,1983,2091,0.5453968,0.4635363,1.50
1,109,1983,2092,0.5831612,0.5040755,1.36
1,110,1983,2093,0.6224217,0.5471670,1.23
1,111,1983,2094,0.6630882,0.5926601,1.11
1,112,1983,2095,0.7050519,0.6404144,1.00
1,113,1983,2096,0.7481851,0.6903518,0.89
1,114,1983,2097,0.7923424,0.7423474,0.76
1,115,1983,2098,1.0000000,1.0000000,0.50
1,16,1984,2000,0.0005802,0.0006778,67.00
1,17,1984,2001,0.0007098,0.0008019,66.04
1,18,1984,2002,0.0008321,0.0009191,65.09
1,19,1984,2003,0.0009391,0.0010223,64.15
1,20,1984,2004,0.0010297,0.0011106,63.22
1,21,1984,2005,0.0011033,0.0011817,62.29
1,22,1984,2006,0.0011584,0.0012329,61.36
1,23,1984,2007,0.0011978,0.0012662,60.44
1,24,1984,2008,0.0012275,0.0012876,59.51
1,25,1984,2009,0.0012521,0.0013020,58.59
1,26,1984,2010,0.0012759,0.0013133,57.66
1,27,1984,2011,0.0013058,0.0013293,56.74
1,28,1984,2012,0.0013446,0.0013542,55.81
1,29,1984,2013,0.0013859,0.0013827,54.89
1,30,1984,2014,0.0014216,0.0014045,53.97
1,31,1984,2015,0.0014530,0.0014195,53.04
1,32,1984,2016,0.0014859,0.0014345,52.11
1,33,1984,2017,0.0015203,0.0014498,51.19
1,34,1984,2018,0.0015540,0.0014625,50.26
1,35,1984,2019,0.0015941,0.0014768,49.34
1,36,1984,2020,0.0016525,0.0015052,48.41
1,37,1984,2021,0.0017318,0.0015505,47.48
1,38,1984,2022,0.0018255,0.0016116,46.55
1,39,1984,2023,0.0019305,0.0016867,45.63
1,40,1984,2024,0.0020513,0.0017765,44.70
1,41,1984,2025,0.0021897,0.0018804,43.78
1,42,1984,2026,0.0023342,0.0019871,42.86
1,43,1984,2027,0.0024669,0.0020801,41.95
1,44,1984,2028,0.0025867,0.0021559,41.03
1,45,1984,2029,0.0027191,0.0022291,40.12
1,46,1984,2030,0.0028925,0.0023359,39.21
1,47,1984,2031,0.0031101,0.0024797,38.30
1,48,1984,2032,0.0033571,0.0026528,37.40
1,49,1984,2033,0.0036304,0.0028452,36.49
1,50,1984,2034,0.0039379,0.0030510,35.60
1,51,1984,2035,0.0042708,0.0032640,34.70
1,52,1984,2036,0.0046082,0.0034698,33.82
1,53,1984,2037,0.0049489,0.0036620,32.93
1,54,1984,2038,0.0053157,0.0038711,32.05
1,55,1984,2039,0.0057365,0.0041129,31.17
1,56,1984,2040,0.0062406,0.0044236,30.30
1,57,1984,2041,0.0068502,0.0048218,29.43
1,58,1984,2042,0.0075521,0.0053043,28.57
1,59,1984,2043,0.0083035,0.0058163,27.72
1,60,1984,2044,0.0090849,0.0063186,26.88
1,61,1984,2045,0.0099105,0.0068167,26.05
1,62,1984,2046,0.0107829,0.0073147,25.22
1,63,1984,2047,0.0116995,0.0078267,24.41
1,64,1984,2048,0.0126957,0.0083979,23.60
1,65,1984,2049,0.0138071,0.0090403,22.79
1,66,1984,2050,0.0150054,0.0097199,21.99
1,67,1984,2051,0.0162315,0.0103547,21.21
1,68,1984,2052,0.0174919,0.0109511,20.42
1,69,1984,2053,0.0188954,0.0116265,19.64
1,70,1984,2054,0.0205786,0.0124908,18.87
1,71,1984,2055,0.0226142,0.0136372,18.10
1,72,1984,2056,0.0250119,0.0151059,17.34
1,73,1984,2057,0.0277519,0.0168935,16.60
1,74,1984,2058,0.0307579,0.0189384,15.88
1,75,1984,2059,0.0339099,0.0210537,15.18
1,76,1984,2060,0.0371478,0.0231127,14.49
1,77,1984,2061,0.0405123,0.0251237,13.82
1,78,1984,2062,0.0440886,0.0271760,13.17
1,79,1984,2063,0.0480027,0.0294090,12.52
1,80,1984,2064,0.0536037,0.0336172,11.88
1,81,1984,2065,0.0586892,0.0367521,11.28
1,82,1984,2066,0.0642414,0.0401661,10.69
1,83,1984,2067,0.0702997,0.0439588,10.12
1,84,1984,2068,0.0769067,0.0482170,9.56
1,85,1984,2069,0.0841076,0.0529329,9.02
1,86,1984,2070,0.0919504,0.0581326,8.49
1,87,1984,2071,0.1004863,0.0638985,7.99
1,88,1984,2072,0.1097689,0.0703382,7.50
1,89,1984,2073,0.1198550,0.0775273,7.03
1,90,1984,2074,0.1308036,0.0854626,6.58
1,91,1984,2075,0.1426766,0.0941628,6.14
1,92,1984,2076,0.1555375,0.1037354,5.73
1,93,1984,2077,0.1694519,0.1143230,5.34
1,94,1984,2078,0.1844867,0.1260290,4.96
1,95,1984,2079,0.2007091,0.1388807,4.60
1,96,1984,2080,0.2181866,0.1529315,4.27
1,97,1984,2081,0.2369856,0.1683358,3.95
1,98,1984,2082,0.2571705,0.1852833,3.64
1,99,1984,2083,0.2788028,0.2039115,3.36
1,100,1984,2084,0.3019394,0.2242557,3.09
1,101,1984,2085,0.3266317,0.2463733,2.84
1,102,1984,2086,0.3529236,0.2704383,2.61
1,103,1984,2087,0.3808502,0.2966554,2.39
1,104,1984,2088,0.4104359,0.3251484,2.18
1,105,1984,2089,0.4416930,0.3559168,1.99
1,106,1984,2090,0.4746198,0.3889835,1.81
1,107,1984,2091,0.5091990,0.4244812,1.65
1,108,1984,2092,0.5453968,0.4625423,1.50
1,109,1984,2093,0.5831612,0.5031887,1.36
1,110,1984,2094,0.6224217,0.5463041,1.23
1,111,1984,2095,0.6630882,0.5917838,1.11
1,112,1984,2096,0.7050519,0.6395955,1.00
1,113,1984,2097,0.7481851,0.6896664,0.89
1,114,1984,2098,0.7923424,0.7418031,0.76
1,115,1984,2099,1.0000000,1.0000000,0.50
1,15,1985,2000,0.0004596,0.0005531,68.08
1,16,1985,2001,0.0005802,0.0006669,67.12
1,17,1985,2002,0.0007098,0.0007915,66.16
1,18,1985,2003,0.0008321,0.0009105,65.21
1,19,1985,2004,0.0009391,0.0010155,64.27
1,20,1985,2005,0.0010297,0.0011038,63.34
1,21,1985,2006,0.0011033,0.0011745,62.41
1,22,1985,2007,0.0011584,0.0012255,61.48
1,23,1985,2008,0.0011978,0.0012575,60.55
1,24,1985,2009,0.0012275,0.0012761,59.63
1,25,1985,2010,0.0012521,0.0012882,58.70
1,26,1985,2011,0.0012759,0.0012988,57.78
1,27,1985,2012,0.0013058,0.0013154,56.85
1,28,1985,2013,0.0013446,0.0013414,55.93
1,29,1985,2014,0.0013859,0.0013695,55.00
1,30,1985,2015,0.0014216,0.0013897,54.08
1,31,1985,2016,0.0014530,0.0014038,53.15
1,32,1985,2017,0.0014859,0.0014192,52.23
1,33,1985,2018,0.0015203,0.0014350,51.30
1,34,1985,2019,0.0015540,0.0014464,50.37
1,35,1985,2020,0.0015941,0.0014580,49.44
1,36,1985,2021,0.0016525,0.0014847,48.52
1,37,1985,2022,0.0017318,0.0015299,47.59
1,38,1985,2023,0.0018255,0.0015917,46.66
1,39,1985,2024,0.0019305,0.0016656,45.73
1,40,1985,2025,0.0020513,0.0017529,44.81
1,41,1985,2026,0.0021897,0.0018556,43.89
1,42,1985,2027,0.0023342,0.0019631,42.97
1,43,1985,2028,0.0024669,0.0020572,42.05
1,44,1985,2029,0.0025867,0.0021315,41.14
1,45,1985,2030,0.0027191,0.0022009,40.22
1,46,1985,2031,0.0028925,0.0023053,39.31
1,47,1985,2032,0.0031101,0.0024492,38.40
1,48,1985,2033,0.0033571,0.0026230,37.49
1,49,1985,2034,0.0036304,0.0028130,36.59
1,50,1985,2035,0.0039379,0.0030134,35.69
1,51,1985,2036,0.0042708,0.0032226,34.80
1,52,1985,2037,0.0046082,0.0034281,33.91
1,53,1985,2038,0.0049489,0.0036204,33.02
1,54,1985,2039,0.0053157,0.0038254,32.14
1,55,1985,2040,0.0057365,0.0040594,31.26
1,56,1985,2041,0.0062406,0.0043650,30.39
1,57,1985,2042,0.0068502,0.0047626,29.52
1,58,1985,2043,0.0075521,0.0052459,28.66
1,59,1985,2044,0.0083035,0.0057524,27.81
1,60,1985,2045,0.0090849,0.0062439,26.97
1,61,1985,2046,0.0099105,0.0067344,26.13
1,62,1985,2047,0.0107829,0.0072311,25.31
1,63,1985,2048,0.0116995,0.0077431,24.49
1,64,1985,2049,0.0126957,0.0083057,23.67
1,65,1985,2050,0.0138071,0.0089322,22.87
1,66,1985,2051,0.0150054,0.0096013,22.07
1,67,1985,2052,0.0162315,0.0102347,21.28
1,68,1985,2053,0.0174919,0.0108305,20.49
1,69,1985,2054,0.0188954,0.0114917,19.71
1,70,1985,2055,0.0205786,0.0123318,18.94
1,71,1985,2056,0.0226142,0.0134616,18.17
1,72,1985,2057,0.0250119,0.0149277,17.41
1,73,1985,2058,0.0277519,0.0167161,16.66
1,74,1985,2059,0.0307579,0.0187438,15.94
1,75,1985,2060,0.0339099,0.0208272,15.23
1,76,1985,2061,0.0371478,0.0228648,14.55
1,77,1985,2062,0.0405123,0.0248736,13.88
1,78,1985,2063,0.0440886,0.0269271,13.22
1,79,1985,2064,0.0480027,0.0291345,12.57
1,80,1985,2065,0.0536037,0.0332977,11.93
1,81,1985,2066,0.0586892,0.0364003,11.32
1,82,1985,2067,0.0642414,0.0398094,10.73
1,83,1985,2068,0.0702997,0.0436016,10.16
1,84,1985,2069,0.0769067,0.0478207,9.60
1,85,1985,2070,0.0841076,0.0524695,9.05
1,86,1985,2071,0.0919504,0.0576258,8.53
1,87,1985,2072,0.1004863,0.0633902,8.02
1,88,1985,2073,0.1097689,0.0698409,7.53
1,89,1985,2074,0.1198550,0.0769923,7.06
1,90,1985,2075,0.1308036,0.0848472,6.60
1,91,1985,2076,0.1426766,0.0934955,6.17
1,92,1985,2077,0.1555375,0.1030701,5.75
1,93,1985,2078,0.1694519,0.1136682,5.36
1,94,1985,2079,0.1844867,0.1253152,4.98
1,95,1985,2080,0.2007091,0.1380613,4.62
1,96,1985,2081,0.2181866,0.1520528,4.28
1,97,1985,2082,0.2369856,0.1674717,3.96
1,98,1985,2083,0.2571705,0.1844515,3.66
1,99,1985,2084,0.2788028,0.2030296,3.37
1,100,1985,2085,0.3019394,0.2232648,3.10
1,101,1985,2086,0.3266317,0.2453305,2.85
1,102,1985,2087,0.3529236,0.2694335,2.61
1,103,1985,2088,0.3808502,0.2957065,2.39
1,104,1985,2089,0.4104359,0.3241623,2.19
1,105,1985,2090,0.4416930,0.3548385,2.00
1,106,1985,2091,0.4746198,0.3878858,1.82
1,107,1985,2092,0.5091990,0.4234626,1.65
1,108,1985,2093,0.5453968,0.4616221,1.50
1,109,1985,2094,0.5831612,0.5022798,1.36
1,110,1985,2095,0.6224217,0.5453648,1.23
1,111,1985,2096,0.6630882,0.5908874,1.11
1,112,1985,2097,0.7050519,0.6388250,1.00
1,113,1985,2098,0.7481851,0.6890330,0.89
1,114,1985,2099,0.7923424,0.7412470,0.76
1,115,1985,2100,1.0000000,1.0000000,0.50
1,14,1986,2000,0.0003624,0.0004526,69.17
1,15,1986,2001,0.0004596,0.0005425,68.20
1,16,1986,2002,0.0005802,0.0006571,67.23
1,17,1986,2003,0.0007098,0.0007834,66.28
1,18,1986,2004,0.0008321,0.0009042,65.33
1,19,1986,2005,0.0009391,0.0010092,64.39
1,20,1986,2006,0.0010297,0.0010970,63.45
1,21,1986,2007,0.0011033,0.0011674,62.52
1,22,1986,2008,0.0011584,0.0012171,61.59
1,23,1986,2009,0.0011978,0.0012461,60.67
1,24,1986,2010,0.0012275,0.0012626,59.74
1,25,1986,2011,0.0012521,0.0012742,58.82
1,26,1986,2012,0.0012759,0.0012853,57.89
1,27,1986,2013,0.0013058,0.0013026,56.97
1,28,1986,2014,0.0013446,0.0013285,56.04
1,29,1986,2015,0.0013859,0.0013553,55.12
1,30,1986,2016,0.0014216,0.0013746,54.19
1,31,1986,2017,0.0014530,0.0013891,53.26
1,32,1986,2018,0.0014859,0.0014052,52.34
1,33,1986,2019,0.0015203,0.0014200,51.41
1,34,1986,2020,0.0015540,0.0014291,50.48
1,35,1986,2021,0.0015941,0.0014391,49.55
1,36,1986,2022,0.0016525,0.0014657,48.62
1,37,1986,2023,0.0017318,0.0015111,47.69
1,38,1986,2024,0.0018255,0.0015714,46.77
1,39,1986,2025,0.0019305,0.0016428,45.84
1,40,1986,2026,0.0020513,0.0017290,44.91
1,41,1986,2027,0.0021897,0.0018325,43.99
1,42,1986,2028,0.0023342,0.0019411,43.07
1,43,1986,2029,0.0024669,0.0020339,42.15
1,44,1986,2030,0.0025867,0.0021052,41.24
1,45,1986,2031,0.0027191,0.0021724,40.32
1,46,1986,2032,0.0028925,0.0022769,39.41
1,47,1986,2033,0.0031101,0.0024213,38.50
1,48,1986,2034,0.0033571,0.0025930,37.59
1,49,1986,2035,0.0036304,0.0027784,36.69
1,50,1986,2036,0.0039379,0.0029754,35.79
1,51,1986,2037,0.0042708,0.0031842,34.89
1,52,1986,2038,0.0046082,0.0033899,34.00
1,53,1986,2039,0.0049489,0.0035783,33.12
1,54,1986,2040,0.0053157,0.0037762,32.24
1,55,1986,2041,0.0057365,0.0040053,31.36
1,56,1986,2042,0.0062406,0.0043104,30.48
1,57,1986,2043,0.0068502,0.0047086,29.61
1,58,1986,2044,0.0075521,0.0051869,28.75
1,59,1986,2045,0.0083035,0.0056837,27.89
1,60,1986,2046,0.0090849,0.0061684,27.05
1,61,1986,2047,0.0099105,0.0066578,26.22
1,62,1986,2048,0.0107829,0.0071543,25.39
1,63,1986,2049,0.0116995,0.0076581,24.57
1,64,1986,2050,0.0126957,0.0082062,23.75
1,65,1986,2051,0.0138071,0.0088230,22.95
1,66,1986,2052,0.0150054,0.0094908,22.15
1,67,1986,2053,0.0162315,0.0101237,21.35
1,68,1986,2054,0.0174919,0.0107066,20.57
1,69,1986,2055,0.0188954,0.0113460,19.78
1,70,1986,2056,0.0205786,0.0121711,19.00
1,71,1986,2057,0.0226142,0.0132983,18.23
1,72,1986,2058,0.0250119,0.0147647,17.47
1,73,1986,2059,0.0277519,0.0165366,16.73
1,74,1986,2060,0.0307579,0.0185344,16.00
1,75,1986,2061,0.0339099,0.0205979,15.29
1,76,1986,2062,0.0371478,0.0226337,14.60
1,77,1986,2063,0.0405123,0.0246440,13.93
1,78,1986,2064,0.0440886,0.0266743,13.27
1,79,1986,2065,0.0480027,0.0288384,12.62
1,80,1986,2066,0.0536037,0.0329737,11.98
1,81,1986,2067,0.0586892,0.0360717,11.37
1,82,1986,2068,0.0642414,0.0394798,10.78
1,83,1986,2069,0.0702997,0.0432352,10.20
1,84,1986,2070,0.0769067,0.0473915,9.64
1,85,1986,2071,0.0841076,0.0519992,9.09
1,86,1986,2072,0.0919504,0.0571531,8.56
1,87,1986,2073,0.1004863,0.0629267,8.05
1,88,1986,2074,0.1097689,0.0693412,7.56
1,89,1986,2075,0.1198550,0.0764163,7.08
1,90,1986,2076,0.1308036,0.0842215,6.63
1,91,1986,2077,0.1426766,0.0928703,6.19
1,92,1986,2078,0.1555375,0.1024535,5.78
1,93,1986,2079,0.1694519,0.1129943,5.38
1,94,1986,2080,0.1844867,0.1245394,5.00
1,95,1986,2081,0.2007091,0.1372269,4.64
1,96,1986,2082,0.2181866,0.1512296,4.30
1,97,1986,2083,0.2369856,0.1666763,3.97
1,98,1986,2084,0.2571705,0.1836049,3.67
1,99,1986,2085,0.2788028,0.2020740,3.38
1,100,1986,2086,0.3019394,0.2222542,3.11
1,101,1986,2087,0.3266317,0.2443513,2.86
1,102,1986,2088,0.3529236,0.2685032,2.62
1,103,1986,2089,0.3808502,0.2947330,2.40
1,104,1986,2090,0.4104359,0.3230896,2.19
1,105,1986,2091,0.4416930,0.3537371,2.00
1,106,1986,2092,0.4746198,0.3868539,1.82
1,107,1986,2093,0.5091990,0.4225199,1.66
1,108,1986,2094,0.5453968,0.4606790,1.51
1,109,1986,2095,0.5831612,0.5012907,1.37
1,110,1986,2096,0.6224217,0.5444041,1.24
1,111,1986,2097,0.6630882,0.5900440,1.12
1,112,1986,2098,0.7050519,0.6381131,1.00
1,113,1986,2099,0.7481851,0.6883860,0.89
1,114,1986,2100,0.7923424,0.7406422,0.76
1,115,1986,2101,1.0000000,1.0000000,0.50
1,13,1987,2000,0.0002934,0.0003805,70.26
1,14,1987,2001,0.0003624,0.0004423,69.29
1,15,1987,2002,0.0004596,0.0005330,68.32
1,16,1987,2003,0.0005802,0.0006494,67.35
1,17,1987,2004,0.0007098,0.0007774,66.40
1,18,1987,2005,0.0008321,0.0008982,65.45
1,19,1987,2006,0.0009391,0.0010027,64.51
1,20,1987,2007,0.0010297,0.0010903,63.57
1,21,1987,2008,0.0011033,0.0011593,62.64
1,22,1987,2009,0.0011584,0.0012058,61.71
1,23,1987,2010,0.0011978,0.0012327,60.79
1,24,1987,2011,0.0012275,0.0012490,59.86
1,25,1987,2012,0.0012521,0.0012611,58.93
1,26,1987,2013,0.0012759,0.0012729,58.01
1,27,1987,2014,0.0013058,0.0012897,57.08
1,28,1987,2015,0.0013446,0.0013145,56.15
1,29,1987,2016,0.0013859,0.0013409,55.23
1,30,1987,2017,0.0014216,0.0013606,54.30
1,31,1987,2018,0.0014530,0.0013757,53.37
1,32,1987,2019,0.0014859,0.0013910,52.45
1,33,1987,2020,0.0015203,0.0014039,51.52
1,34,1987,2021,0.0015540,0.0014117,50.59
1,35,1987,2022,0.0015941,0.0014214,49.66
1,36,1987,2023,0.0016525,0.0014482,48.73
1,37,1987,2024,0.0017318,0.0014920,47.80
1,38,1987,2025,0.0018255,0.0015496,46.87
1,39,1987,2026,0.0019305,0.0016199,45.94
1,40,1987,2027,0.0020513,0.0017068,45.02
1,41,1987,2028,0.0021897,0.0018114,44.09
1,42,1987,2029,0.0023342,0.0019188,43.17
1,43,1987,2030,0.0024669,0.0020089,42.26
1,44,1987,2031,0.0025867,0.0020786,41.34
1,45,1987,2032,0.0027191,0.0021458,40.42
1,46,1987,2033,0.0028925,0.0022509,39.51
1,47,1987,2034,0.0031101,0.0023932,38.60
1,48,1987,2035,0.0033571,0.0025607,37.69
1,49,1987,2036,0.0036304,0.0027434,36.79
1,50,1987,2037,0.0039379,0.0029401,35.88
1,51,1987,2038,0.0042708,0.0031489,34.99
1,52,1987,2039,0.0046082,0.0033511,34.10
1,53,1987,2040,0.0049489,0.0035329,33.21
1,54,1987,2041,0.0053157,0.0037264,32.33
1,55,1987,2042,0.0057365,0.0039551,31.45
1,56,1987,2043,0.0062406,0.0042607,30.57
1,57,1987,2044,0.0068502,0.0046541,29.70
1,58,1987,2045,0.0075521,0.0051235,28.83
1,59,1987,2046,0.0083035,0.0056142,27.98
1,60,1987,2047,0.0090849,0.0060981,27.14
1,61,1987,2048,0.0099105,0.0065874,26.30
1,62,1987,2049,0.0107829,0.0070763,25.47
1,63,1987,2050,0.0116995,0.0075666,24.65
1,64,1987,2051,0.0126957,0.0081057,23.83
1,65,1987,2052,0.0138071,0.0087211,23.02
1,66,1987,2053,0.0150054,0.0093886,22.22
1,67,1987,2054,0.0162315,0.0100097,21.43
1,68,1987,2055,0.0174919,0.0105726,20.64
1,69,1987,2056,0.0188954,0.0111987,19.85
1,70,1987,2057,0.0205786,0.0120216,19.07
1,71,1987,2058,0.0226142,0.0131490,18.30
1,72,1987,2059,0.0250119,0.0146000,17.54
1,73,1987,2060,0.0277519,0.0163436,16.79
1,74,1987,2061,0.0307579,0.0183224,16.06
1,75,1987,2062,0.0339099,0.0203841,15.35
1,76,1987,2063,0.0371478,0.0224216,14.66
1,77,1987,2064,0.0405123,0.0244108,13.98
1,78,1987,2065,0.0440886,0.0264015,13.32
1,79,1987,2066,0.0480027,0.0285382,12.67
1,80,1987,2067,0.0536037,0.0326710,12.03
1,81,1987,2068,0.0586892,0.0357681,11.41
1,82,1987,2069,0.0642414,0.0391419,10.82
1,83,1987,2070,0.0702997,0.0428384,10.24
1,84,1987,2071,0.0769067,0.0469559,9.68
1,85,1987,2072,0.0841076,0.0515605,9.13
1,86,1987,2073,0.0919504,0.0567220,8.60
1,87,1987,2074,0.1004863,0.0624609,8.08
1,88,1987,2075,0.1097689,0.0688032,7.59
1,89,1987,2076,0.1198550,0.0758308,7.11
1,90,1987,2077,0.1308036,0.0836354,6.66
1,91,1987,2078,0.1426766,0.0922911,6.22
1,92,1987,2079,0.1555375,0.1018190,5.80
1,93,1987,2080,0.1694519,0.1122621,5.40
1,94,1987,2081,0.1844867,0.1237498,5.02
1,95,1987,2082,0.2007091,0.1364455,4.66
1,96,1987,2083,0.2181866,0.1504721,4.31
1,97,1987,2084,0.2369856,0.1658670,3.99
1,98,1987,2085,0.2571705,0.1826877,3.68
1,99,1987,2086,0.2788028,0.2010997,3.39
1,100,1987,2087,0.3019394,0.2213054,3.12
1,101,1987,2088,0.3266317,0.2434449,2.87
1,102,1987,2089,0.3529236,0.2675489,2.63
1,103,1987,2090,0.3808502,0.2936743,2.41
1,104,1987,2091,0.4104359,0.3219943,2.20
1,105,1987,2092,0.4416930,0.3527019,2.01
1,106,1987,2093,0.4746198,0.3858990,1.83
1,107,1987,2094,0.5091990,0.4215540,1.66
1,108,1987,2095,0.5453968,0.4596530,1.51
1,109,1987,2096,0.5831612,0.5002794,1.37
1,110,1987,2097,0.6224217,0.5435004,1.24
1,111,1987,2098,0.6630882,0.5892648,1.12
1,112,1987,2099,0.7050519,0.6373860,1.01
1,113,1987,2100,0.7481851,0.6876824,0.89
1,114,1987,2101,0.7923424,0.7400231,0.76
1,115,1987,2102,1.0000000,1.0000000,0.50
1,12,1988,2000,0.0002484,0.0003329,71.36
1,13,1988,2001,0.0002934,0.0003703,70.38
1,14,1988,2002,0.0003624,0.0004330,69.41
1,15,1988,2003,0.0004596,0.0005256,68.44
1,16,1988,2004,0.0005802,0.0006438,67.47
1,17,1988,2005,0.0007098,0.0007717,66.51
1,18,1988,2006,0.0008321,0.0008921,65.57
1,19,1988,2007,0.0009391,0.0009964,64.62
1,20,1988,2008,0.0010297,0.0010827,63.69
1,21,1988,2009,0.0011033,0.0011485,62.76
1,22,1988,2010,0.0011584,0.0011927,61.83
1,23,1988,2011,0.0011978,0.0012191,60.90
1,24,1988,2012,0.0012275,0.0012363,59.97
1,25,1988,2013,0.0012521,0.0012492,59.05
1,26,1988,2014,0.0012759,0.0012603,58.12
1,27,1988,2015,0.0013058,0.0012758,57.19
1,28,1988,2016,0.0013446,0.0013004,56.27
1,29,1988,2017,0.0013859,0.0013275,55.34
1,30,1988,2018,0.0014216,0.0013478,54.41
1,31,1988,2019,0.0014530,0.0013621,53.48
1,32,1988,2020,0.0014859,0.0013757,52.56
1,33,1988,2021,0.0015203,0.0013876,51.63
1,34,1988,2022,0.0015540,0.0013954,50.70
1,35,1988,2023,0.0015941,0.0014052,49.77
1,36,1988,2024,0.0016525,0.0014304,48.84
1,37,1988,2025,0.0017318,0.0014714,47.91
1,38,1988,2026,0.0018255,0.0015276,46.98
1,39,1988,2027,0.0019305,0.0015985,46.05
1,40,1988,2028,0.0020513,0.0016865,45.12
1,41,1988,2029,0.0021897,0.0017900,44.20
1,42,1988,2030,0.0023342,0.0018949,43.28
1,43,1988,2031,0.0024669,0.0019836,42.36
1,44,1988,2032,0.0025867,0.0020539,41.44
1,45,1988,2033,0.0027191,0.0021216,40.52
1,46,1988,2034,0.0028925,0.0022247,39.61
1,47,1988,2035,0.0031101,0.0023629,38.70
1,48,1988,2036,0.0033571,0.0025280,37.79
1,49,1988,2037,0.0036304,0.0027108,36.88
1,50,1988,2038,0.0039379,0.0029077,35.98
1,51,1988,2039,0.0042708,0.0031132,35.08
1,52,1988,2040,0.0046082,0.0033093,34.19
1,53,1988,2041,0.0049489,0.0034870,33.30
1,54,1988,2042,0.0053157,0.0036802,32.42
1,55,1988,2043,0.0057365,0.0039092,31.54
1,56,1988,2044,0.0062406,0.0042105,30.66
1,57,1988,2045,0.0068502,0.0045956,29.79
1,58,1988,2046,0.0075521,0.0050594,28.92
1,59,1988,2047,0.0083035,0.0055495,28.07
1,60,1988,2048,0.0090849,0.0060335,27.22
1,61,1988,2049,0.0099105,0.0065159,26.38
1,62,1988,2050,0.0107829,0.0069922,25.55
1,63,1988,2051,0.0116995,0.0074740,24.73
1,64,1988,2052,0.0126957,0.0080119,23.91
1,65,1988,2053,0.0138071,0.0086269,23.10
1,66,1988,2054,0.0150054,0.0092835,22.30
1,67,1988,2055,0.0162315,0.0098863,21.50
1,68,1988,2056,0.0174919,0.0104371,20.71
1,69,1988,2057,0.0188954,0.0110618,19.92
1,70,1988,2058,0.0205786,0.0118850,19.14
1,71,1988,2059,0.0226142,0.0129982,18.36
1,72,1988,2060,0.0250119,0.0144229,17.60
1,73,1988,2061,0.0277519,0.0161482,16.85
1,74,1988,2062,0.0307579,0.0181248,16.12
1,75,1988,2063,0.0339099,0.0201879,15.41
1,76,1988,2064,0.0371478,0.0222062,14.71
1,77,1988,2065,0.0405123,0.0241593,14.04
1,78,1988,2066,0.0440886,0.0261252,13.37
1,79,1988,2067,0.0480027,0.0282581,12.72
1,80,1988,2068,0.0536037,0.0323915,12.07
1,81,1988,2069,0.0586892,0.0354569,11.46
1,82,1988,2070,0.0642414,0.0387760,10.86
1,83,1988,2071,0.0702997,0.0424359,10.28
1,84,1988,2072,0.0769067,0.0465497,9.71
1,85,1988,2073,0.0841076,0.0511606,9.16
1,86,1988,2074,0.0919504,0.0562891,8.63
1,87,1988,2075,0.1004863,0.0619597,8.12
1,88,1988,2076,0.1097689,0.0682565,7.62
1,89,1988,2077,0.1198550,0.0752826,7.14
1,90,1988,2078,0.1308036,0.0830926,6.68
1,91,1988,2079,0.1426766,0.0916952,6.24
1,92,1988,2080,0.1555375,0.1011298,5.82
1,93,1988,2081,0.1694519,0.1115170,5.42
1,94,1988,2082,0.1844867,0.1230105,5.04
1,95,1988,2083,0.2007091,0.1357266,4.67
1,96,1988,2084,0.2181866,0.1497016,4.33
1,97,1988,2085,0.2369856,0.1649905,4.00
1,98,1988,2086,0.2571705,0.1817528,3.70
1,99,1988,2087,0.2788028,0.2001853,3.41
1,100,1988,2088,0.3019394,0.2204276,3.13
1,101,1988,2089,0.3266317,0.2425156,2.88
1,102,1988,2090,0.3529236,0.2665115,2.64
1,103,1988,2091,0.3808502,0.2925937,2.41
1,104,1988,2092,0.4104359,0.3209651,2.21
1,105,1988,2093,0.4416930,0.3517444,2.01
1,106,1988,2094,0.4746198,0.3849209,1.83
1,107,1988,2095,0.5091990,0.4205034,1.67
1,108,1988,2096,0.5453968,0.4586041,1.51
1,109,1988,2097,0.5831612,0.4993282,1.37
1,110,1988,2098,0.6224217,0.5426658,1.24
1,111,1988,2099,0.6630882,0.5884691,1.12
1,112,1988,2100,0.7050519,0.6365954,1.01
1,113,1988,2101,0.7481851,0.6869623,0.89
1,114,1988,2102,0.7923424,0.7394398,0.76
1,115,1988,2103,1.0000000,1.0000000,0.50
1,11,1989,2000,0.0002200,0.0003037,72.45
1,12,1989,2001,0.0002484,0.0003229,71.48
1,13,1989,2002,0.0002934,0.0003612,70.50
1,14,1989,2003,0.0003624,0.0004258,69.52
1,15,1989,2004,0.0004596,0.0005202,68.55
1,16,1989,2005,0.0005802,0.0006384,67.59
1,17,1989,2006,0.0007098,0.0007660,66.63
1,18,1989,2007,0.0008321,0.0008861,65.68
1,19,1989,2008,0.0009391,0.0009891,64.74
1,20,1989,2009,0.0010297,0.0010725,63.80
1,21,1989,2010,0.0011033,0.0011360,62.87
1,22,1989,2011,0.0011584,0.0011794,61.94
1,23,1989,2012,0.0011978,0.0012065,61.02
1,24,1989,2013,0.0012275,0.0012246,60.09
1,25,1989,2014,0.0012521,0.0012370,59.16
1,26,1989,2015,0.0012759,0.0012468,58.23
1,27,1989,2016,0.0013058,0.0012617,57.31
1,28,1989,2017,0.0013446,0.0012873,56.38
1,29,1989,2018,0.0013859,0.0013153,55.45
1,30,1989,2019,0.0014216,0.0013348,54.52
1,31,1989,2020,0.0014530,0.0013475,53.59
1,32,1989,2021,0.0014859,0.0013603,52.67
1,33,1989,2022,0.0015203,0.0013724,51.74
1,34,1989,2023,0.0015540,0.0013805,50.81
1,35,1989,2024,0.0015941,0.0013887,49.88
1,36,1989,2025,0.0016525,0.0014113,48.95
1,37,1989,2026,0.0017318,0.0014506,48.01
1,38,1989,2027,0.0018255,0.0015072,47.08
1,39,1989,2028,0.0019305,0.0015790,46.15
1,40,1989,2029,0.0020513,0.0016660,45.23
1,41,1989,2030,0.0021897,0.0017670,44.30
1,42,1989,2031,0.0023342,0.0018706,43.38
1,43,1989,2032,0.0024669,0.0019601,42.46
1,44,1989,2033,0.0025867,0.0020313,41.54
1,45,1989,2034,0.0027191,0.0020972,40.62
1,46,1989,2035,0.0028925,0.0021965,39.71
1,47,1989,2036,0.0031101,0.0023323,38.79
1,48,1989,2037,0.0033571,0.0024976,37.88
1,49,1989,2038,0.0036304,0.0026810,36.98
1,50,1989,2039,0.0039379,0.0028748,36.08
1,51,1989,2040,0.0042708,0.0030747,35.18
1,52,1989,2041,0.0046082,0.0032671,34.29
1,53,1989,2042,0.0049489,0.0034443,33.40
1,54,1989,2043,0.0053157,0.0036380,32.51
1,55,1989,2044,0.0057365,0.0038630,31.63
1,56,1989,2045,0.0062406,0.0041567,30.75
1,57,1989,2046,0.0068502,0.0045365,29.87
1,58,1989,2047,0.0075521,0.0049997,29.01
1,59,1989,2048,0.0083035,0.0054901,28.15
1,60,1989,2049,0.0090849,0.0059679,27.30
1,61,1989,2050,0.0099105,0.0064388,26.46
1,62,1989,2051,0.0107829,0.0069072,25.63
1,63,1989,2052,0.0116995,0.0073876,24.81
1,64,1989,2053,0.0126957,0.0079252,23.99
1,65,1989,2054,0.0138071,0.0085301,23.18
1,66,1989,2055,0.0150054,0.0091699,22.37
1,67,1989,2056,0.0162315,0.0097616,21.57
1,68,1989,2057,0.0174919,0.0103111,20.78
1,69,1989,2058,0.0188954,0.0109366,19.99
1,70,1989,2059,0.0205786,0.0117470,19.21
1,71,1989,2060,0.0226142,0.0128360,18.43
1,72,1989,2061,0.0250119,0.0142437,17.66
1,73,1989,2062,0.0277519,0.0159663,16.91
1,74,1989,2063,0.0307579,0.0179437,16.18
1,75,1989,2064,0.0339099,0.0199888,15.46
1,76,1989,2065,0.0371478,0.0219739,14.77
1,77,1989,2066,0.0405123,0.0239044,14.09
1,78,1989,2067,0.0440886,0.0258672,13.42
1,79,1989,2068,0.0480027,0.0279995,12.77
1,80,1989,2069,0.0536037,0.0321049,12.12
1,81,1989,2070,0.0586892,0.0351200,11.51
1,82,1989,2071,0.0642414,0.0384048,10.91
1,83,1989,2072,0.0702997,0.0420605,10.32
1,84,1989,2073,0.0769067,0.0461796,9.75
1,85,1989,2074,0.0841076,0.0507590,9.20
1,86,1989,2075,0.0919504,0.0558232,8.67
1,87,1989,2076,0.1004863,0.0614505,8.15
1,88,1989,2077,0.1097689,0.0677448,7.65
1,89,1989,2078,0.1198550,0.0747749,7.17
1,90,1989,2079,0.1308036,0.0825343,6.71
1,91,1989,2080,0.1426766,0.0910482,6.27
1,92,1989,2081,0.1555375,0.1004288,5.84
1,93,1989,2082,0.1694519,0.1108197,5.44
1,94,1989,2083,0.1844867,0.1223306,5.06
1,95,1989,2084,0.2007091,0.1349956,4.69
1,96,1989,2085,0.2181866,0.1488673,4.35
1,97,1989,2086,0.2369856,0.1640975,4.02
1,98,1989,2087,0.2571705,0.1808758,3.71
1,99,1989,2088,0.2788028,0.1993395,3.42
1,100,1989,2089,0.3019394,0.2195277,3.14
1,101,1989,2090,0.3266317,0.2415055,2.89
1,102,1989,2091,0.3529236,0.2654528,2.65
1,103,1989,2092,0.3808502,0.2915785,2.42
1,104,1989,2093,0.4104359,0.3200133,2.21
1,105,1989,2094,0.4416930,0.3507638,2.02
1,106,1989,2095,0.4746198,0.3838573,1.84
1,107,1989,2096,0.5091990,0.4194298,1.67
1,108,1989,2097,0.5453968,0.4576179,1.52
1,109,1989,2098,0.5831612,0.4984498,1.37
1,110,1989,2099,0.6224217,0.5418137,1.24
1,111,1989,2100,0.6630882,0.5876042,1.12
1,112,1989,2101,0.7050519,0.6357864,1.01
1,113,1989,2102,0.7481851,0.6862840,0.90
1,114,1989,2103,0.7923424,0.7388979,0.76
1,115,1989,2104,1.0000000,1.0000000,0.50
1,10,1990,2000,0.0002017,0.0002873,73.55
1,11,1990,2001,0.0002200,0.0002936,72.57
1,12,1990,2002,0.0002484,0.0003140,71.60
1,13,1990,2003,0.0002934,0.0003542,70.62
1,14,1990,2004,0.0003624,0.0004205,69.64
1,15,1990,2005,0.0004596,0.0005150,68.67
1,16,1990,2006,0.0005802,0.0006330,67.71
1,17,1990,2007,0.0007098,0.0007604,66.75
1,18,1990,2008,0.0008321,0.0008792,65.80
1,19,1990,2009,0.0009391,0.0009795,64.86
1,20,1990,2010,0.0010297,0.0010606,63.92
1,21,1990,2011,0.0011033,0.0011233,62.99
1,22,1990,2012,0.0011584,0.0011670,62.06
1,23,1990,2013,0.0011978,0.0011949,61.13
1,24,1990,2014,0.0012275,0.0012129,60.20
1,25,1990,2015,0.0012521,0.0012240,59.27
1,26,1990,2016,0.0012759,0.0012331,58.35
1,27,1990,2017,0.0013058,0.0012486,57.42
1,28,1990,2018,0.0013446,0.0012752,56.49
1,29,1990,2019,0.0013859,0.0013028,55.56
1,30,1990,2020,0.0014216,0.0013207,54.63
1,31,1990,2021,0.0014530,0.0013326,53.70
1,32,1990,2022,0.0014859,0.0013458,52.78
1,33,1990,2023,0.0015203,0.0013584,51.85
1,34,1990,2024,0.0015540,0.0013653,50.92
1,35,1990,2025,0.0015941,0.0013710,49.98
1,36,1990,2026,0.0016525,0.0013920,49.05
1,37,1990,2027,0.0017318,0.0014313,48.12
1,38,1990,2028,0.0018255,0.0014885,47.19
1,39,1990,2029,0.0019305,0.0015593,46.26
1,40,1990,2030,0.0020513,0.0016439,45.33
1,41,1990,2031,0.0021897,0.0017438,44.40
1,42,1990,2032,0.0023342,0.0018481,43.48
1,43,1990,2033,0.0024669,0.0019386,42.56
1,44,1990,2034,0.0025867,0.0020085,41.64
1,45,1990,2035,0.0027191,0.0020709,40.72
1,46,1990,2036,0.0028925,0.0021681,39.81
1,47,1990,2037,0.0031101,0.0023039,38.89
1,48,1990,2038,0.0033571,0.0024698,37.98
1,49,1990,2039,0.0036304,0.0026507,37.07
1,50,1990,2040,0.0039379,0.0028395,36.17
1,51,1990,2041,0.0042708,0.0030357,35.27
1,52,1990,2042,0.0046082,0.0032278,34.38
1,53,1990,2043,0.0049489,0.0034054,33.49
1,54,1990,2044,0.0053157,0.0035954,32.60
1,55,1990,2045,0.0057365,0.0038133,31.72
1,56,1990,2046,0.0062406,0.0041022,30.84
1,57,1990,2047,0.0068502,0.0044814,29.96
1,58,1990,2048,0.0075521,0.0049450,29.09
1,59,1990,2049,0.0083035,0.0054298,28.24
1,60,1990,2050,0.0090849,0.0058971,27.39
1,61,1990,2051,0.0099105,0.0063608,26.55
1,62,1990,2052,0.0107829,0.0068279,25.71
1,63,1990,2053,0.0116995,0.0073078,24.89
1,64,1990,2054,0.0126957,0.0078361,24.07
1,65,1990,2055,0.0138071,0.0084254,23.25
1,66,1990,2056,0.0150054,0.0090550,22.45
1,67,1990,2057,0.0162315,0.0096455,21.65
1,68,1990,2058,0.0174919,0.0101960,20.85
1,69,1990,2059,0.0188954,0.0108102,20.06
1,70,1990,2060,0.0205786,0.0115987,19.28
1,71,1990,2061,0.0226142,0.0126720,18.50
1,72,1990,2062,0.0250119,0.0140769,17.73
1,73,1990,2063,0.0277519,0.0157996,16.97
1,74,1990,2064,0.0307579,0.0177598,16.24
1,75,1990,2065,0.0339099,0.0197740,15.52
1,76,1990,2066,0.0371478,0.0217385,14.83
1,77,1990,2067,0.0405123,0.0236665,14.14
1,78,1990,2068,0.0440886,0.0256291,13.47
1,79,1990,2069,0.0480027,0.0277346,12.82
1,80,1990,2070,0.0536037,0.0317947,12.17
1,81,1990,2071,0.0586892,0.0347782,11.55
1,82,1990,2072,0.0642414,0.0380588,10.95
1,83,1990,2073,0.0702997,0.0417186,10.36
1,84,1990,2074,0.0769067,0.0458079,9.79
1,85,1990,2075,0.0841076,0.0503270,9.24
1,86,1990,2076,0.0919504,0.0553500,8.70
1,87,1990,2077,0.1004863,0.0609740,8.18
1,88,1990,2078,0.1097689,0.0672711,7.68
1,89,1990,2079,0.1198550,0.0742530,7.20
1,90,1990,2080,0.1308036,0.0819283,6.73
1,91,1990,2081,0.1426766,0.0903903,6.29
1,92,1990,2082,0.1555375,0.0997728,5.87
1,93,1990,2083,0.1694519,0.1101786,5.46
1,94,1990,2084,0.1844867,0.1216394,5.08
1,95,1990,2085,0.2007091,0.1342044,4.71
1,96,1990,2086,0.2181866,0.1480175,4.36
1,97,1990,2087,0.2369856,0.1632599,4.03
1,98,1990,2088,0.2571705,0.1800648,3.72
1,99,1990,2089,0.2788028,0.1984727,3.43
1,100,1990,2090,0.3019394,0.2185499,3.15
1,101,1990,2091,0.3266317,0.2404750,2.90
1,102,1990,2092,0.3529236,0.2644587,2.65
1,103,1990,2093,0.3808502,0.2906400,2.43
1,104,1990,2094,0.4104359,0.3190390,2.22
1,105,1990,2095,0.4416930,0.3496978,2.02
1,106,1990,2096,0.4746198,0.3827707,1.84
1,107,1990,2097,0.5091990,0.4184205,1.67
1,108,1990,2098,0.5453968,0.4567075,1.52
1,109,1990,2099,0.5831612,0.4975533,1.38
1,110,1990,2100,0.6224217,0.5408875,1.25
1,111,1990,2101,0.6630882,0.5867193,1.12
1,112,1990,2102,0.7050519,0.6350245,1.01
1,113,1990,2103,0.7481851,0.6856538,0.90
1,114,1990,2104,0.7923424,0.7383397,0.76
1,115,1990,2105,1.0000000,1.0000000,0.50
1,9,1991,2000,0.0001904,0.0002800,74.65
1,10,1991,2001,0.0002017,0.0002769,73.67
1,11,1991,2002,0.0002200,0.0002847,72.69
1,12,1991,2003,0.0002484,0.0003072,71.71
1,13,1991,2004,0.0002934,0.0003491,70.74
1,14,1991,2005,0.0003624,0.0004155,69.76
1,15,1991,2006,0.0004596,0.0005098,68.79
1,16,1991,2007,0.0005802,0.0006277,67.82
1,17,1991,2008,0.0007098,0.0007539,66.87
1,18,1991,2009,0.0008321,0.0008702,65.92
1,19,1991,2010,0.0009391,0.0009683,64.97
1,20,1991,2011,0.0010297,0.0010486,64.04
1,21,1991,2012,0.0011033,0.0011115,63.10
1,22,1991,2013,0.0011584,0.0011556,62.17
1,23,1991,2014,0.0011978,0.0011832,61.24
1,24,1991,2015,0.0012275,0.0012002,60.32
1,25,1991,2016,0.0012521,0.0012108,59.39
1,26,1991,2017,0.0012759,0.0012204,58.46
1,27,1991,2018,0.0013058,0.0012366,57.53
1,28,1991,2019,0.0013446,0.0012630,56.60
1,29,1991,2020,0.0013859,0.0012894,55.67
1,30,1991,2021,0.0014216,0.0013065,54.74
1,31,1991,2022,0.0014530,0.0013188,53.81
1,32,1991,2023,0.0014859,0.0013326,52.88
1,33,1991,2024,0.0015203,0.0013442,51.95
1,34,1991,2025,0.0015540,0.0013489,51.02
1,35,1991,2026,0.0015941,0.0013531,50.09
1,36,1991,2027,0.0016525,0.0013741,49.16
1,37,1991,2028,0.0017318,0.0014137,48.23
1,38,1991,2029,0.0018255,0.0014697,47.29
1,39,1991,2030,0.0019305,0.0015381,46.36
1,40,1991,2031,0.0020513,0.0016216,45.43
1,41,1991,2032,0.0021897,0.0017222,44.51
1,42,1991,2033,0.0023342,0.0018275,43.58
1,43,1991,2034,0.0024669,0.0019169,42.66
1,44,1991,2035,0.0025867,0.0019840,41.74
1,45,1991,2036,0.0027191,0.0020444,40.82
1,46,1991,2037,0.0028925,0.0021416,39.91
1,47,1991,2038,0.0031101,0.0022778,38.99
1,48,1991,2039,0.0033571,0.0024415,38.08
1,49,1991,2040,0.0036304,0.0026181,37.17
1,50,1991,2041,0.0039379,0.0028037,36.27
1,51,1991,2042,0.0042708,0.0029995,35.37
1,52,1991,2043,0.0046082,0.0031920,34.47
1,53,1991,2044,0.0049489,0.0033661,33.58
1,54,1991,2045,0.0053157,0.0035497,32.69
1,55,1991,2046,0.0057365,0.0037631,31.81
1,56,1991,2047,0.0062406,0.0040515,30.93
1,57,1991,2048,0.0068502,0.0044310,30.05
1,58,1991,2049,0.0075521,0.0048893,29.18
1,59,1991,2050,0.0083035,0.0053647,28.32
1,60,1991,2051,0.0090849,0.0058256,27.47
1,61,1991,2052,0.0099105,0.0062881,26.63
1,62,1991,2053,0.0107829,0.0067546,25.79
1,63,1991,2054,0.0116995,0.0072258,24.97
1,64,1991,2055,0.0126957,0.0077397,24.14
1,65,1991,2056,0.0138071,0.0083195,23.33
1,66,1991,2057,0.0150054,0.0089481,22.52
1,67,1991,2058,0.0162315,0.0095395,21.72
1,68,1991,2059,0.0174919,0.0100796,20.92
1,69,1991,2060,0.0188954,0.0106742,20.13
1,70,1991,2061,0.0205786,0.0114487,19.34
1,71,1991,2062,0.0226142,0.0125195,18.56
1,72,1991,2063,0.0250119,0.0139241,17.79
1,73,1991,2064,0.0277519,0.0156305,17.04
1,74,1991,2065,0.0307579,0.0175617,16.30
1,75,1991,2066,0.0339099,0.0195566,15.58
1,76,1991,2067,0.0371478,0.0215189,14.88
1,77,1991,2068,0.0405123,0.0234470,14.20
1,78,1991,2069,0.0440886,0.0253851,13.53
1,79,1991,2070,0.0480027,0.0274480,12.87
1,80,1991,2071,0.0536037,0.0314802,12.21
1,81,1991,2072,0.0586892,0.0344597,11.60
1,82,1991,2073,0.0642414,0.0377436,10.99
1,83,1991,2074,0.0702997,0.0413753,10.40
1,84,1991,2075,0.0769067,0.0454082,9.83
1,85,1991,2076,0.0841076,0.0498884,9.27
1,86,1991,2077,0.0919504,0.0549074,8.73
1,87,1991,2078,0.1004863,0.0605330,8.21
1,88,1991,2079,0.1097689,0.0667842,7.71
1,89,1991,2080,0.1198550,0.0736866,7.23
1,90,1991,2081,0.1308036,0.0813122,6.76
1,91,1991,2082,0.1426766,0.0897748,6.31
1,92,1991,2083,0.1555375,0.0991699,5.89
1,93,1991,2084,0.1694519,0.1095270,5.48
1,94,1991,2085,0.1844867,0.1208915,5.09
1,95,1991,2086,0.2007091,0.1333987,4.73
1,96,1991,2087,0.2181866,0.1472208,4.38
1,97,1991,2088,0.2369856,0.1624856,4.05
1,98,1991,2089,0.2571705,0.1792338,3.73
1,99,1991,2090,0.2788028,0.1975312,3.44
1,100,1991,2091,0.3019394,0.2175528,3.16
1,101,1991,2092,0.3266317,0.2395077,2.90
1,102,1991,2093,0.3529236,0.2635399,2.66
1,103,1991,2094,0.3808502,0.2896795,2.44
1,104,1991,2095,0.4104359,0.3179800,2.22
1,105,1991,2096,0.4416930,0.3486090,2.03
1,106,1991,2097,0.4746198,0.3817495,1.85
1,107,1991,2098,0.5091990,0.4174890,1.68
1,108,1991,2099,0.5453968,0.4557785,1.52
1,109,1991,2100,0.5831612,0.4965792,1.38
1,110,1991,2101,0.6224217,0.5399403,1.25
1,111,1991,2102,0.6630882,0.5858861,1.13
1,112,1991,2103,0.7050519,0.6343167,1.01
1,113,1991,2104,0.7481851,0.6850048,0.90
1,114,1991,2105,0.7923424,0.7377309,0.76
1,115,1991,2106,1.0000000,1.0000000,0.50
1,8,1992,2000,0.0001845,0.0002796,75.75
1,9,1992,2001,0.0001904,0.0002690,74.77
1,10,1992,2002,0.0002017,0.0002677,73.79
1,11,1992,2003,0.0002200,0.0002779,72.81
1,12,1992,2004,0.0002484,0.0003021,71.83
1,13,1992,2005,0.0002934,0.0003442,70.85
1,14,1992,2006,0.0003624,0.0004104,69.88
1,15,1992,2007,0.0004596,0.0005047,68.91
1,16,1992,2008,0.0005802,0.0006216,67.94
1,17,1992,2009,0.0007098,0.0007454,66.98
1,18,1992,2010,0.0008321,0.0008596,66.03
1,19,1992,2011,0.0009391,0.0009569,65.09
1,20,1992,2012,0.0010297,0.0010374,64.15
1,21,1992,2013,0.0011033,0.0011006,63.22
1,22,1992,2014,0.0011584,0.0011442,62.29
1,23,1992,2015,0.0011978,0.0011706,61.36
1,24,1992,2016,0.0012275,0.0011873,60.43
1,25,1992,2017,0.0012521,0.0011985,59.50
1,26,1992,2018,0.0012759,0.0012087,58.57
1,27,1992,2019,0.0013058,0.0012244,57.64
1,28,1992,2020,0.0013446,0.0012498,56.71
1,29,1992,2021,0.0013859,0.0012758,55.78
1,30,1992,2022,0.0014216,0.0012933,54.85
1,31,1992,2023,0.0014530,0.0013061,53.92
1,32,1992,2024,0.0014859,0.0013191,52.99
1,33,1992,2025,0.0015203,0.0013289,52.06
1,34,1992,2026,0.0015540,0.0013324,51.13
1,35,1992,2027,0.0015941,0.0013364,50.20
1,36,1992,2028,0.0016525,0.0013577,49.26
1,37,1992,2029,0.0017318,0.0013959,48.33
1,38,1992,2030,0.0018255,0.0014494,47.40
1,39,1992,2031,0.0019305,0.0015167,46.46
1,40,1992,2032,0.0020513,0.0016009,45.53
1,41,1992,2033,0.0021897,0.0017025,44.61
1,42,1992,2034,0.0023342,0.0018068,43.68
1,43,1992,2035,0.0024669,0.0018936,42.76
1,44,1992,2036,0.0025867,0.0019592,41.84
1,45,1992,2037,0.0027191,0.0020196,40.92
1,46,1992,2038,0.0028925,0.0021173,40.00
1,47,1992,2039,0.0031101,0.0022514,39.09
1,48,1992,2040,0.0033571,0.0024111,38.17
1,49,1992,2041,0.0036304,0.0025851,37.27
1,50,1992,2042,0.0039379,0.0027704,36.36
1,51,1992,2043,0.0042708,0.0029665,35.46
1,52,1992,2044,0.0046082,0.0031558,34.56
1,53,1992,2045,0.0049489,0.0033239,33.67
1,54,1992,2046,0.0053157,0.0035035,32.78
1,55,1992,2047,0.0057365,0.0037164,31.90
1,56,1992,2048,0.0062406,0.0040051,31.01
1,57,1992,2049,0.0068502,0.0043797,30.14
1,58,1992,2050,0.0075521,0.0048294,29.27
1,59,1992,2051,0.0083035,0.0052989,28.41
1,60,1992,2052,0.0090849,0.0057589,27.55
1,61,1992,2053,0.0099105,0.0062209,26.71
1,62,1992,2054,0.0107829,0.0066792,25.88
1,63,1992,2055,0.0116995,0.0071370,25.05
1,64,1992,2056,0.0126957,0.0076423,24.22
1,65,1992,2057,0.0138071,0.0082210,23.41
1,66,1992,2058,0.0150054,0.0088503,22.60
1,67,1992,2059,0.0162315,0.0094323,21.79
1,68,1992,2060,0.0174919,0.0099545,21.00
1,69,1992,2061,0.0188954,0.0105368,20.20
1,70,1992,2062,0.0205786,0.0113092,19.41
1,71,1992,2063,0.0226142,0.0123797,18.63
1,72,1992,2064,0.0250119,0.0137692,17.85
1,73,1992,2065,0.0277519,0.0154482,17.10
1,74,1992,2066,0.0307579,0.0173610,16.36
1,75,1992,2067,0.0339099,0.0193537,15.64
1,76,1992,2068,0.0371478,0.0213162,14.94
1,77,1992,2069,0.0405123,0.0232221,14.25
1,78,1992,2070,0.0440886,0.0251213,13.58
1,79,1992,2071,0.0480027,0.0271576,12.91
1,80,1992,2072,0.0536037,0.0311871,12.26
1,81,1992,2073,0.0586892,0.0341696,11.64
1,82,1992,2074,0.0642414,0.0374273,11.03
1,83,1992,2075,0.0702997,0.0410061,10.44
1,84,1992,2076,0.0769067,0.0450024,9.87
1,85,1992,2077,0.0841076,0.0494782,9.31
1,86,1992,2078,0.0919504,0.0544979,8.77
1,87,1992,2079,0.1004863,0.0600799,8.25
1,88,1992,2080,0.1097689,0.0662559,7.74
1,89,1992,2081,0.1198550,0.0731110,7.25
1,90,1992,2082,0.1308036,0.0807361,6.79
1,91,1992,2083,0.1426766,0.0892094,6.34
1,92,1992,2084,0.1555375,0.0985574,5.91
1,93,1992,2085,0.1694519,0.1088221,5.50
1,94,1992,2086,0.1844867,0.1201301,5.11
1,95,1992,2087,0.2007091,0.1326436,4.74
1,96,1992,2088,0.2181866,0.1464845,4.39
1,97,1992,2089,0.2369856,0.1616925,4.06
1,98,1992,2090,0.2571705,0.1783316,3.75
1,99,1992,2091,0.2788028,0.1965713,3.45
1,100,1992,2092,0.3019394,0.2166170,3.17
1,101,1992,2093,0.3266317,0.2386139,2.91
1,102,1992,2094,0.3529236,0.2625997,2.67
1,103,1992,2095,0.3808502,0.2886359,2.44
1,104,1992,2096,0.4104359,0.3168987,2.23
1,105,1992,2097,0.4416930,0.3475861,2.03
1,106,1992,2098,0.4746198,0.3808073,1.85
1,107,1992,2099,0.5091990,0.4165387,1.68
1,108,1992,2100,0.5453968,0.4547692,1.53
1,109,1992,2101,0.5831612,0.4955831,1.38
1,110,1992,2102,0.6224217,0.5390484,1.25
1,111,1992,2103,0.6630882,0.5851122,1.13
1,112,1992,2104,0.7050519,0.6335879,1.01
1,113,1992,2105,0.7481851,0.6842970,0.90
1,114,1992,2106,0.7923424,0.7371076,0.76
1,115,1992,2107,1.0000000,1.0000000,0.50
1,7,1993,2000,0.0001828,0.0002851,76.85
1,8,1993,2001,0.0001845,0.0002678,75.87
1,9,1993,2002,0.0001904,0.0002592,74.89
1,10,1993,2003,0.0002017,0.0002607,73.91
1,11,1993,2004,0.0002200,0.0002729,72.93
1,12,1993,2005,0.0002484,0.0002974,71.95
1,13,1993,2006,0.0002934,0.0003393,70.97
1,14,1993,2007,0.0003624,0.0004055,70.00
1,15,1993,2008,0.0004596,0.0004989,69.02
1,16,1993,2009,0.0005802,0.0006136,68.06
1,17,1993,2010,0.0007098,0.0007355,67.10
1,18,1993,2011,0.0008321,0.0008489,66.15
1,19,1993,2012,0.0009391,0.0009464,65.20
1,20,1993,2013,0.0010297,0.0010272,64.27
1,21,1993,2014,0.0011033,0.0010897,63.33
1,22,1993,2015,0.0011584,0.0011318,62.40
1,23,1993,2016,0.0011978,0.0011579,61.47
1,24,1993,2017,0.0012275,0.0011753,60.54
1,25,1993,2018,0.0012521,0.0011872,59.61
1,26,1993,2019,0.0012759,0.0011969,58.68
1,27,1993,2020,0.0013058,0.0012112,57.75
1,28,1993,2021,0.0013446,0.0012365,56.82
1,29,1993,2022,0.0013859,0.0012631,55.89
1,30,1993,2023,0.0014216,0.0012811,54.96
1,31,1993,2024,0.0014530,0.0012931,54.03
1,32,1993,2025,0.0014859,0.0013046,53.10
1,33,1993,2026,0.0015203,0.0013134,52.17
1,34,1993,2027,0.0015540,0.0013170,51.24
1,35,1993,2028,0.0015941,0.0013212,50.30
1,36,1993,2029,0.0016525,0.0013411,49.37
1,37,1993,2030,0.0017318,0.0013767,48.43
1,38,1993,2031,0.0018255,0.0014289,47.50
1,39,1993,2032,0.0019305,0.0014968,46.57
1,40,1993,2033,0.0020513,0.0015820,45.64
1,41,1993,2034,0.0021897,0.0016826,44.71
1,42,1993,2035,0.0023342,0.0017845,43.78
1,43,1993,2036,0.0024669,0.0018700,42.86
1,44,1993,2037,0.0025867,0.0019361,41.94
1,45,1993,2038,0.0027191,0.0019970,41.02
1,46,1993,2039,0.0028925,0.0020927,40.10
1,47,1993,2040,0.0031101,0.0022230,39.18
1,48,1993,2041,0.0033571,0.0023804,38.27
1,49,1993,2042,0.0036304,0.0025544,37.36
1,50,1993,2043,0.0039379,0.0027400,36.46
1,51,1993,2044,0.0042708,0.0029331,35.55
1,52,1993,2045,0.0046082,0.0031170,34.66
1,53,1993,2046,0.0049489,0.0032813,33.76
1,54,1993,2047,0.0053157,0.0034605,32.87
1,55,1993,2048,0.0057365,0.0036736,31.99
1,56,1993,2049,0.0062406,0.0039579,31.10
1,57,1993,2050,0.0068502,0.0043245,30.22
1,58,1993,2051,0.0075521,0.0047688,29.35
1,59,1993,2052,0.0083035,0.0052376,28.49
1,60,1993,2053,0.0090849,0.0056972,27.64
1,61,1993,2054,0.0099105,0.0061518,26.79
1,62,1993,2055,0.0107829,0.0065977,25.96
1,63,1993,2056,0.0116995,0.0070473,25.13
1,64,1993,2057,0.0126957,0.0075516,24.30
1,65,1993,2058,0.0138071,0.0081310,23.48
1,66,1993,2059,0.0150054,0.0087515,22.67
1,67,1993,2060,0.0162315,0.0093170,21.87
1,68,1993,2061,0.0174919,0.0098280,21.07
1,69,1993,2062,0.0188954,0.0104089,20.27
1,70,1993,2063,0.0205786,0.0111815,19.48
1,71,1993,2064,0.0226142,0.0122381,18.69
1,72,1993,2065,0.0250119,0.0136024,17.92
1,73,1993,2066,0.0277519,0.0152639,17.16
1,74,1993,2067,0.0307579,0.0171740,16.42
1,75,1993,2068,0.0339099,0.0191665,15.69
1,76,1993,2069,0.0371478,0.0211086,14.99
1,77,1993,2070,0.0405123,0.0229789,14.30
1,78,1993,2071,0.0440886,0.0248539,13.63
1,79,1993,2072,0.0480027,0.0268872,12.96
1,80,1993,2073,0.0536037,0.0309201,12.31
1,81,1993,2074,0.0586892,0.0338785,11.68
1,82,1993,2075,0.0642414,0.0370872,11.08
1,83,1993,2076,0.0702997,0.0406315,10.48
1,84,1993,2077,0.0769067,0.0446230,9.91
1,85,1993,2078,0.0841076,0.0490987,9.35
1,86,1993,2079,0.0919504,0.0540772,8.80
1,87,1993,2080,0.1004863,0.0595884,8.28
1,88,1993,2081,0.1097689,0.0657193,7.77
1,89,1993,2082,0.1198550,0.0725729,7.28
1,90,1993,2083,0.1308036,0.0802070,6.81
1,91,1993,2084,0.1426766,0.0886350,6.36
1,92,1993,2085,0.1555375,0.0978950,5.93
1,93,1993,2086,0.1694519,0.1081049,5.52
1,94,1993,2087,0.1844867,0.1194168,5.13
1,95,1993,2088,0.2007091,0.1319459,4.76
1,96,1993,2089,0.2181866,0.1457305,4.41
1,97,1993,2090,0.2369856,0.1608316,4.08
1,98,1993,2091,0.2571705,0.1774120,3.76
1,99,1993,2092,0.2788028,0.1956708,3.46
1,100,1993,2093,0.3019394,0.2157525,3.18
1,101,1993,2094,0.3266317,0.2376996,2.92
1,102,1993,2095,0.3529236,0.2615786,2.68
1,103,1993,2096,0.3808502,0.2875706,2.45
1,104,1993,2097,0.4104359,0.3158832,2.24
1,105,1993,2098,0.4416930,0.3466425,2.04
1,106,1993,2099,0.4746198,0.3798462,1.86
1,107,1993,2100,0.5091990,0.4155066,1.69
1,108,1993,2101,0.5453968,0.4537374,1.53
1,109,1993,2102,0.5831612,0.4946454,1.39
1,110,1993,2103,0.6224217,0.5382203,1.25
1,111,1993,2104,0.6630882,0.5843155,1.13
1,112,1993,2105,0.7050519,0.6327933,1.01
1,113,1993,2106,0.7481851,0.6835727,0.90
1,114,1993,2107,0.7923424,0.7365206,0.76
1,115,1993,2108,1.0000000,1.0000000,0.50
1,6,1994,2000,0.0001837,0.0002962,77.95
1,7,1994,2001,0.0001828,0.0002722,76.97
1,8,1994,2002,0.0001845,0.0002573,75.99
1,9,1994,2003,0.0001904,0.0002518,75.01
1,10,1994,2004,0.0002017,0.0002555,74.03
1,11,1994,2005,0.0002200,0.0002682,73.05
1,12,1994,2006,0.0002484,0.0002927,72.07
1,13,1994,2007,0.0002934,0.0003346,71.09
1,14,1994,2008,0.0003624,0.0003999,70.11
1,15,1994,2009,0.0004596,0.0004913,69.14
1,16,1994,2010,0.0005802,0.0006043,68.17
1,17,1994,2011,0.0007098,0.0007255,67.22
1,18,1994,2012,0.0008321,0.0008390,66.26
1,19,1994,2013,0.0009391,0.0009367,65.32
1,20,1994,2014,0.0010297,0.0010168,64.38
1,21,1994,2015,0.0011033,0.0010778,63.44
1,22,1994,2016,0.0011584,0.0011193,62.51
1,23,1994,2017,0.0011978,0.0011460,61.58
1,24,1994,2018,0.0012275,0.0011643,60.65
1,25,1994,2019,0.0012521,0.0011757,59.72
1,26,1994,2020,0.0012759,0.0011841,58.79
1,27,1994,2021,0.0013058,0.0011980,57.86
1,28,1994,2022,0.0013446,0.0012240,56.93
1,29,1994,2023,0.0013859,0.0012515,56.00
1,30,1994,2024,0.0014216,0.0012687,55.07
1,31,1994,2025,0.0014530,0.0012792,54.14
1,32,1994,2026,0.0014859,0.0012898,53.21
1,33,1994,2027,0.0015203,0.0012989,52.27
1,34,1994,2028,0.0015540,0.0013029,51.34
1,35,1994,2029,0.0015941,0.0013058,50.41
1,36,1994,2030,0.0016525,0.0013233,49.47
1,37,1994,2031,0.0017318,0.0013573,48.54
1,38,1994,2032,0.0018255,0.0014099,47.60
1,39,1994,2033,0.0019305,0.0014787,46.67
1,40,1994,2034,0.0020513,0.0015629,45.74
1,41,1994,2035,0.0021897,0.0016612,44.81
1,42,1994,2036,0.0023342,0.0017619,43.88
1,43,1994,2037,0.0024669,0.0018480,42.96
1,44,1994,2038,0.0025867,0.0019150,42.04
1,45,1994,2039,0.0027191,0.0019740,41.12
1,46,1994,2040,0.0028925,0.0020662,40.20
1,47,1994,2041,0.0031101,0.0021942,39.28
1,48,1994,2042,0.0033571,0.0023518,38.37
1,49,1994,2043,0.0036304,0.0025264,37.46
1,50,1994,2044,0.0039379,0.0027093,36.55
1,51,1994,2045,0.0042708,0.0028973,35.65
1,52,1994,2046,0.0046082,0.0030777,34.75
1,53,1994,2047,0.0049489,0.0032416,33.85
1,54,1994,2048,0.0053157,0.0034211,32.96
1,55,1994,2049,0.0057365,0.0036301,32.07
1,56,1994,2050,0.0062406,0.0039071,31.19
1,57,1994,2051,0.0068502,0.0042686,30.31
1,58,1994,2052,0.0075521,0.0047123,29.44
1,59,1994,2053,0.0083035,0.0051809,28.58
1,60,1994,2054,0.0090849,0.0056338,27.72
1,61,1994,2055,0.0099105,0.0060771,26.88
1,62,1994,2056,0.0107829,0.0065152,26.04
1,63,1994,2057,0.0116995,0.0069638,25.20
1,64,1994,2058,0.0126957,0.0074688,24.38
1,65,1994,2059,0.0138071,0.0080400,23.56
1,66,1994,2060,0.0150054,0.0086453,22.74
1,67,1994,2061,0.0162315,0.0092004,21.94
1,68,1994,2062,0.0174919,0.0097103,21.14
1,69,1994,2063,0.0188954,0.0102918,20.34
1,70,1994,2064,0.0205786,0.0110520,19.55
1,71,1994,2065,0.0226142,0.0120856,18.76
1,72,1994,2066,0.0250119,0.0134337,17.98
1,73,1994,2067,0.0277519,0.0150920,17.22
1,74,1994,2068,0.0307579,0.0170015,16.48
1,75,1994,2069,0.0339099,0.0189749,15.75
1,76,1994,2070,0.0371478,0.0208842,15.05
1,77,1994,2071,0.0405123,0.0227325,14.36
1,78,1994,2072,0.0440886,0.0246050,13.68
1,79,1994,2073,0.0480027,0.0266411,13.01
1,80,1994,2074,0.0536037,0.0306523,12.36
1,81,1994,2075,0.0586892,0.0335655,11.73
1,82,1994,2076,0.0642414,0.0367421,11.12
1,83,1994,2077,0.0702997,0.0402813,10.53
1,84,1994,2078,0.0769067,0.0442722,9.95
1,85,1994,2079,0.0841076,0.0487090,9.38
1,86,1994,2080,0.0919504,0.0536210,8.84
1,87,1994,2081,0.1004863,0.0590892,8.31
1,88,1994,2082,0.1097689,0.0652178,7.80
1,89,1994,2083,0.1198550,0.0720788,7.31
1,90,1994,2084,0.1308036,0.0796696,6.84
1,91,1994,2085,0.1426766,0.0880140,6.39
1,92,1994,2086,0.1555375,0.0972211,5.96
1,93,1994,2087,0.1694519,0.1074330,5.54
1,94,1994,2088,0.1844867,0.1187579,5.15
1,95,1994,2089,0.2007091,0.1312317,4.78
1,96,1994,2090,0.2181866,0.1449123,4.42
1,97,1994,2091,0.2369856,0.1599545,4.09
1,98,1994,2092,0.2571705,0.1765496,3.77
1,99,1994,2093,0.2788028,0.1948393,3.47
1,100,1994,2094,0.3019394,0.2148686,3.19
1,101,1994,2095,0.3266317,0.2367069,2.93
1,102,1994,2096,0.3529236,0.2605365,2.69
1,103,1994,2097,0.3808502,0.2865704,2.46
1,104,1994,2098,0.4104359,0.3149467,2.24
1,105,1994,2099,0.4416930,0.3456803,2.04
1,106,1994,2100,0.4746198,0.3788027,1.86
1,107,1994,2101,0.5091990,0.4144517,1.69
1,108,1994,2102,0.5453968,0.4527664,1.53
1,109,1994,2103,0.5831612,0.4937750,1.39
1,110,1994,2104,0.6224217,0.5373680,1.25
1,111,1994,2105,0.6630882,0.5834470,1.13
1,112,1994,2106,0.7050519,0.6319802,1.02
1,113,1994,2107,0.7481851,0.6828904,0.90
1,114,1994,2108,0.7923424,0.7359756,0.76
1,115,1994,2109,1.0000000,1.0000000,0.50
1,5,1995,2000,0.0001870,0.0003123,79.04
1,6,1995,2001,0.0001837,0.0002818,78.07
1,7,1995,2002,0.0001828,0.0002609,77.09
1,8,1995,2003,0.0001845,0.0002494,76.11
1,9,1995,2004,0.0001904,0.0002464,75.13
1,10,1995,2005,0.0002017,0.0002507,74.15
1,11,1995,2006,0.0002200,0.0002635,73.17
1,12,1995,2007,0.0002484,0.0002881,72.19
1,13,1995,2008,0.0002934,0.0003292,71.21
1,14,1995,2009,0.0003624,0.0003926,70.23
1,15,1995,2010,0.0004596,0.0004824,69.26
1,16,1995,2011,0.0005802,0.0005949,68.29
1,17,1995,2012,0.0007098,0.0007162,67.33
1,18,1995,2013,0.0008321,0.0008299,66.38
1,19,1995,2014,0.0009391,0.0009269,65.43
1,20,1995,2015,0.0010297,0.0010056,64.49
1,21,1995,2016,0.0011033,0.0010659,63.56
1,22,1995,2017,0.0011584,0.0011076,62.63
1,23,1995,2018,0.0011978,0.0011351,61.69
1,24,1995,2019,0.0012275,0.0011532,60.76
1,25,1995,2020,0.0012521,0.0011634,59.83
1,26,1995,2021,0.0012759,0.0011712,58.90
1,27,1995,2022,0.0013058,0.0011856,57.97
1,28,1995,2023,0.0013446,0.0012126,57.04
1,29,1995,2024,0.0013859,0.0012396,56.11
1,30,1995,2025,0.0014216,0.0012553,55.18
1,31,1995,2026,0.0014530,0.0012650,54.25
1,32,1995,2027,0.0014859,0.0012761,53.31
1,33,1995,2028,0.0015203,0.0012857,52.38
1,34,1995,2029,0.0015540,0.0012886,51.45
1,35,1995,2030,0.0015941,0.0012892,50.51
1,36,1995,2031,0.0016525,0.0013053,49.58
1,37,1995,2032,0.0017318,0.0013394,48.64
1,38,1995,2033,0.0018255,0.0013925,47.71
1,39,1995,2034,0.0019305,0.0014604,46.77
1,40,1995,2035,0.0020513,0.0015424,45.84
1,41,1995,2036,0.0021897,0.0016396,44.91
1,42,1995,2037,0.0023342,0.0017409,43.98
1,43,1995,2038,0.0024669,0.0018279,43.06
1,44,1995,2039,0.0025867,0.0018935,42.14
1,45,1995,2040,0.0027191,0.0019493,41.22
1,46,1995,2041,0.0028925,0.0020394,40.30
1,47,1995,2042,0.0031101,0.0021675,39.38
1,48,1995,2043,0.0033571,0.0023257,38.46
1,49,1995,2044,0.0036304,0.0024981,37.55
1,50,1995,2045,0.0039379,0.0026764,36.64
1,51,1995,2046,0.0042708,0.0028610,35.74
1,52,1995,2047,0.0046082,0.0030411,34.84
1,53,1995,2048,0.0049489,0.0032052,33.95
1,54,1995,2049,0.0053157,0.0033810,33.05
1,55,1995,2050,0.0057365,0.0035833,32.16
1,56,1995,2051,0.0062406,0.0038558,31.28
1,57,1995,2052,0.0068502,0.0042166,30.40
1,58,1995,2053,0.0075521,0.0046601,29.52
1,59,1995,2054,0.0083035,0.0051226,28.66
1,60,1995,2055,0.0090849,0.0055652,27.80
1,61,1995,2056,0.0099105,0.0060015,26.96
1,62,1995,2057,0.0107829,0.0064385,26.12
1,63,1995,2058,0.0116995,0.0068875,25.28
1,64,1995,2059,0.0126957,0.0073850,24.45
1,65,1995,2060,0.0138071,0.0079421,23.63
1,66,1995,2061,0.0150054,0.0085378,22.82
1,67,1995,2062,0.0162315,0.0090918,22.01
1,68,1995,2063,0.0174919,0.0096024,21.21
1,69,1995,2064,0.0188954,0.0101731,20.41
1,70,1995,2065,0.0205786,0.0109126,19.61
1,71,1995,2066,0.0226142,0.0119315,18.82
1,72,1995,2067,0.0250119,0.0132765,18.05
1,73,1995,2068,0.0277519,0.0149336,17.28
1,74,1995,2069,0.0307579,0.0168249,16.54
1,75,1995,2070,0.0339099,0.0187677,15.81
1,76,1995,2071,0.0371478,0.0206568,15.10
1,77,1995,2072,0.0405123,0.0225031,14.41
1,78,1995,2073,0.0440886,0.0243785,13.73
1,79,1995,2074,0.0480027,0.0263943,13.06
1,80,1995,2075,0.0536037,0.0303645,12.40
1,81,1995,2076,0.0586892,0.0332481,11.77
1,82,1995,2077,0.0642414,0.0364196,11.16
1,83,1995,2078,0.0702997,0.0399575,10.57
1,84,1995,2079,0.0769067,0.0439118,9.98
1,85,1995,2080,0.0841076,0.0482865,9.42
1,86,1995,2081,0.0919504,0.0531578,8.87
1,87,1995,2082,0.1004863,0.0586229,8.34
1,88,1995,2083,0.1097689,0.0647573,7.83
1,89,1995,2084,0.1198550,0.0715771,7.34
1,90,1995,2085,0.1308036,0.0790888,6.87
1,91,1995,2086,0.1426766,0.0873825,6.41
1,92,1995,2087,0.1555375,0.0965901,5.98
1,93,1995,2088,0.1694519,0.1068127,5.57
1,94,1995,2089,0.1844867,0.1180836,5.17
1,95,1995,2090,0.2007091,0.1304570,4.80
1,96,1995,2091,0.2181866,0.1440790,4.44
1,97,1995,2092,0.2369856,0.1591321,4.10
1,98,1995,2093,0.2571705,0.1757534,3.79
1,99,1995,2094,0.2788028,0.1939892,3.49
1,100,1995,2095,0.3019394,0.2139091,3.21
1,101,1995,2096,0.3266317,0.2356941,2.94
1,102,1995,2097,0.3529236,0.2595585,2.69
1,103,1995,2098,0.3808502,0.2856483,2.46
1,104,1995,2099,0.4104359,0.3139920,2.25
1,105,1995,2100,0.4416930,0.3446359,2.05
1,106,1995,2101,0.4746198,0.3777365,1.87
1,107,1995,2102,0.5091990,0.4134594,1.69
1,108,1995,2103,0.5453968,0.4518653,1.54
1,109,1995,2104,0.5831612,0.4928792,1.39
1,110,1995,2105,0.6224217,0.5364390,1.26
1,111,1995,2106,0.6630882,0.5825586,1.13
1,112,1995,2107,0.7050519,0.6312146,1.02
1,113,1995,2108,0.7481851,0.6822571,0.90
1,114,1995,2109,0.7923424,0.7354149,0.76
1,115,1995,2110,1.0000000,1.0000000,0.50
1,4,1996,2000,0.0001930,0.0003370,80.14
1,5,1996,2001,0.0001870,0.0002961,79.17
1,6,1996,2002,0.0001837,0.0002693,78.19
1,7,1996,2003,0.0001828,0.0002523,77.21
1,8,1996,2004,0.0001845,0.0002436,76.23
1,9,1996,2005,0.0001904,0.0002413,75.25
1,10,1996,2006,0.0002017,0.0002459,74.27
1,11,1996,2007,0.0002200,0.0002589,73.28
1,12,1996,2008,0.0002484,0.0002829,72.30
1,13,1996,2009,0.0002934,0.0003221,71.32
1,14,1996,2010,0.0003624,0.0003841,70.35
1,15,1996,2011,0.0004596,0.0004735,69.37
1,16,1996,2012,0.0005802,0.0005862,68.41
1,17,1996,2013,0.0007098,0.0007077,67.45
1,18,1996,2014,0.0008321,0.0008207,66.49
1,19,1996,2015,0.0009391,0.0009164,65.55
1,20,1996,2016,0.0010297,0.0009943,64.61
1,21,1996,2017,0.0011033,0.0010547,63.67
1,22,1996,2018,0.0011584,0.0010969,62.74
1,23,1996,2019,0.0011978,0.0011240,61.81
1,24,1996,2020,0.0012275,0.0011412,60.88
1,25,1996,2021,0.0012521,0.0011509,59.94
1,26,1996,2022,0.0012759,0.0011591,59.01
1,27,1996,2023,0.0013058,0.0011742,58.08
1,28,1996,2024,0.0013446,0.0012009,57.15
1,29,1996,2025,0.0013859,0.0012268,56.22
1,30,1996,2026,0.0014216,0.0012418,55.28
1,31,1996,2027,0.0014530,0.0012519,54.35
1,32,1996,2028,0.0014859,0.0012636,53.42
1,33,1996,2029,0.0015203,0.0012723,52.49
1,34,1996,2030,0.0015540,0.0012732,51.55
1,35,1996,2031,0.0015941,0.0012724,50.62
1,36,1996,2032,0.0016525,0.0012885,49.68
1,37,1996,2033,0.0017318,0.0013230,48.75
1,38,1996,2034,0.0018255,0.0013750,47.81
1,39,1996,2035,0.0019305,0.0014407,46.87
1,40,1996,2036,0.0020513,0.0015217,45.94
1,41,1996,2037,0.0021897,0.0016195,45.01
1,42,1996,2038,0.0023342,0.0017217,44.08
1,43,1996,2039,0.0024669,0.0018075,43.16
1,44,1996,2040,0.0025867,0.0018704,42.24
1,45,1996,2041,0.0027191,0.0019243,41.31
1,46,1996,2042,0.0028925,0.0020145,40.39
1,47,1996,2043,0.0031101,0.0021431,39.47
1,48,1996,2044,0.0033571,0.0022993,38.56
1,49,1996,2045,0.0036304,0.0024678,37.64
1,50,1996,2046,0.0039379,0.0026431,36.74
1,51,1996,2047,0.0042708,0.0028273,35.83
1,52,1996,2048,0.0046082,0.0030076,34.93
1,53,1996,2049,0.0049489,0.0031682,34.04
1,54,1996,2050,0.0053157,0.0033379,33.14
1,55,1996,2051,0.0057365,0.0035360,32.25
1,56,1996,2052,0.0062406,0.0038080,31.37
1,57,1996,2053,0.0068502,0.0041686,30.48
1,58,1996,2054,0.0075521,0.0046064,29.61
1,59,1996,2055,0.0083035,0.0050596,28.74
1,60,1996,2056,0.0090849,0.0054958,27.89
1,61,1996,2057,0.0099105,0.0059311,27.04
1,62,1996,2058,0.0107829,0.0063684,26.20
1,63,1996,2059,0.0116995,0.0068104,25.36
1,64,1996,2060,0.0126957,0.0072949,24.53
1,65,1996,2061,0.0138071,0.0078431,23.71
1,66,1996,2062,0.0150054,0.0084378,22.89
1,67,1996,2063,0.0162315,0.0089924,22.08
1,68,1996,2064,0.0174919,0.0094931,21.28
1,69,1996,2065,0.0188954,0.0100454,20.48
1,70,1996,2066,0.0205786,0.0107717,19.68
1,71,1996,2067,0.0226142,0.0117879,18.89
1,72,1996,2068,0.0250119,0.0131317,18.11
1,73,1996,2069,0.0277519,0.0147716,17.34
1,74,1996,2070,0.0307579,0.0166341,16.60
1,75,1996,2071,0.0339099,0.0185579,15.87
1,76,1996,2072,0.0371478,0.0204451,15.16
1,77,1996,2073,0.0405123,0.0222943,14.46
1,78,1996,2074,0.0440886,0.0241513,13.78
1,79,1996,2075,0.0480027,0.0261292,13.11
1,80,1996,2076,0.0536037,0.0300725,12.45
1,81,1996,2077,0.0586892,0.0329514,11.82
1,82,1996,2078,0.0642414,0.0361214,11.21
1,83,1996,2079,0.0702997,0.0396250,10.61
1,84,1996,2080,0.0769067,0.0435214,10.02
1,85,1996,2081,0.0841076,0.0478576,9.46
1,86,1996,2082,0.0919504,0.0527252,8.91
1,87,1996,2083,0.1004863,0.0581949,8.38
1,88,1996,2084,0.1097689,0.0642901,7.86
1,89,1996,2085,0.1198550,0.0710352,7.37
1,90,1996,2086,0.1308036,0.0784984,6.89
1,91,1996,2087,0.1426766,0.0867913,6.44
1,92,1996,2088,0.1555375,0.0960076,6.00
1,93,1996,2089,0.1694519,0.1061780,5.59
1,94,1996,2090,0.1844867,0.1173524,5.19
1,95,1996,2091,0.2007091,0.1296681,4.81
1,96,1996,2092,0.2181866,0.1432979,4.46
1,97,1996,2093,0.2369856,0.1583731,4.12
1,98,1996,2094,0.2571705,0.1749397,3.80
1,99,1996,2095,0.2788028,0.1930666,3.50
1,100,1996,2096,0.3019394,0.2129306,3.22
1,101,1996,2097,0.3266317,0.2347439,2.95
1,102,1996,2098,0.3529236,0.2586570,2.70
1,103,1996,2099,0.3808502,0.2847085,2.47
1,104,1996,2100,0.4104359,0.3129559,2.26
1,105,1996,2101,0.4416930,0.3435691,2.06
1,106,1996,2102,0.4746198,0.3767338,1.87
1,107,1996,2103,0.5091990,0.4125385,1.70
1,108,1996,2104,0.5453968,0.4509381,1.54
1,109,1996,2105,0.5831612,0.4919032,1.39
1,110,1996,2106,0.6224217,0.5354888,1.26
1,111,1996,2107,0.6630882,0.5817220,1.14
1,112,1996,2108,0.7050519,0.6305039,1.02
1,113,1996,2109,0.7481851,0.6816058,0.90
1,114,1996,2110,0.7923424,0.7348037,0.77
1,115,1996,2111,1.0000000,1.0000000,0.50
1,3,1997,2000,0.0002291,0.0004114,81.23
1,4,1997,2001,0.0001930,0.0003180,80.26
1,5,1997,2002,0.0001870,0.0002819,79.29
1,6,1997,2003,0.0001837,0.0002597,78.31
1,7,1997,2004,0.0001828,0.0002460,77.33
1,8,1997,2005,0.0001845,0.0002382,76.35
1,9,1997,2006,0.0001904,0.0002363,75.37
1,10,1997,2007,0.0002017,0.0002412,74.38
1,11,1997,2008,0.0002200,0.0002538,73.40
1,12,1997,2009,0.0002484,0.0002760,72.42
1,13,1997,2010,0.0002934,0.0003140,71.44
1,14,1997,2011,0.0003624,0.0003756,70.46
1,15,1997,2012,0.0004596,0.0004652,69.49
1,16,1997,2013,0.0005802,0.0005783,68.52
1,17,1997,2014,0.0007098,0.0006991,67.56
1,18,1997,2015,0.0008321,0.0008108,66.61
1,19,1997,2016,0.0009391,0.0009057,65.66
1,20,1997,2017,0.0010297,0.0009838,64.72
1,21,1997,2018,0.0011033,0.0010445,63.78
1,22,1997,2019,0.0011584,0.0010861,62.85
1,23,1997,2020,0.0011978,0.0011121,61.92
1,24,1997,2021,0.0012275,0.0011291,60.99
1,25,1997,2022,0.0012521,0.0011393,60.05
1,26,1997,2023,0.0012759,0.0011481,59.12
1,27,1997,2024,0.0013058,0.0011626,58.19
1,28,1997,2025,0.0013446,0.0011884,57.26
1,29,1997,2026,0.0013859,0.0012138,56.32
1,30,1997,2027,0.0014216,0.0012292,55.39
1,31,1997,2028,0.0014530,0.0012398,54.46
1,32,1997,2029,0.0014859,0.0012508,53.53
1,33,1997,2030,0.0015203,0.0012578,52.59
1,34,1997,2031,0.0015540,0.0012577,51.66
1,35,1997,2032,0.0015941,0.0012568,50.72
1,36,1997,2033,0.0016525,0.0012733,49.79
1,37,1997,2034,0.0017318,0.0013064,48.85
1,38,1997,2035,0.0018255,0.0013562,47.91
1,39,1997,2036,0.0019305,0.0014209,46.98
1,40,1997,2037,0.0020513,0.0015025,46.04
1,41,1997,2038,0.0021897,0.0016011,45.11
1,42,1997,2039,0.0023342,0.0017021,44.18
1,43,1997,2040,0.0024669,0.0017855,43.26
1,44,1997,2041,0.0025867,0.0018470,42.33
1,45,1997,2042,0.0027191,0.0019011,41.41
1,46,1997,2043,0.0028925,0.0019918,40.49
1,47,1997,2044,0.0031101,0.0021184,39.57
1,48,1997,2045,0.0033571,0.0022710,38.65
1,49,1997,2046,0.0036304,0.0024371,37.74
1,50,1997,2047,0.0039379,0.0026120,36.83
1,51,1997,2048,0.0042708,0.0027963,35.92
1,52,1997,2049,0.0046082,0.0029735,35.02
1,53,1997,2050,0.0049489,0.0031284,34.13
1,54,1997,2051,0.0053157,0.0032943,33.23
1,55,1997,2052,0.0057365,0.0034919,32.34
1,56,1997,2053,0.0062406,0.0037638,31.45
1,57,1997,2054,0.0068502,0.0041192,30.57
1,58,1997,2055,0.0075521,0.0045484,29.69
1,59,1997,2056,0.0083035,0.0049958,28.83
1,60,1997,2057,0.0090849,0.0054313,27.97
1,61,1997,2058,0.0099105,0.0058668,27.12
1,62,1997,2059,0.0107829,0.0062975,26.28
1,63,1997,2060,0.0116995,0.0067275,25.44
1,64,1997,2061,0.0126957,0.0072039,24.61
1,65,1997,2062,0.0138071,0.0077509,23.78
1,66,1997,2063,0.0150054,0.0083462,22.97
1,67,1997,2064,0.0162315,0.0088917,22.15
1,68,1997,2065,0.0174919,0.0093755,21.35
1,69,1997,2066,0.0188954,0.0099162,20.55
1,70,1997,2067,0.0205786,0.0106406,19.75
1,71,1997,2068,0.0226142,0.0116557,18.95
1,72,1997,2069,0.0250119,0.0129836,18.17
1,73,1997,2070,0.0277519,0.0145966,17.40
1,74,1997,2071,0.0307579,0.0164410,16.65
1,75,1997,2072,0.0339099,0.0183627,15.92
1,76,1997,2073,0.0371478,0.0202526,15.21
1,77,1997,2074,0.0405123,0.0220850,14.52
1,78,1997,2075,0.0440886,0.0239074,13.83
1,79,1997,2076,0.0480027,0.0258606,13.16
1,80,1997,2077,0.0536037,0.0297997,12.50
1,81,1997,2078,0.0586892,0.0326772,11.86
1,82,1997,2079,0.0642414,0.0358153,11.25
1,83,1997,2080,0.0702997,0.0392648,10.65
1,84,1997,2081,0.0769067,0.0431251,10.06
1,85,1997,2082,0.0841076,0.0474571,9.49
1,86,1997,2083,0.0919504,0.0523282,8.94
1,87,1997,2084,0.1004863,0.0577606,8.41
1,88,1997,2085,0.1097689,0.0637853,7.89
1,89,1997,2086,0.1198550,0.0704843,7.40
1,90,1997,2087,0.1308036,0.0779459,6.92
1,91,1997,2088,0.1426766,0.0862458,6.46
1,92,1997,2089,0.1555375,0.0954118,6.02
1,93,1997,2090,0.1694519,0.1054898,5.61
1,94,1997,2091,0.1844867,0.1166080,5.21
1,95,1997,2092,0.2007091,0.1289289,4.83
1,96,1997,2093,0.2181866,0.1425773,4.47
1,97,1997,2094,0.2369856,0.1575977,4.13
1,98,1997,2095,0.2571705,0.1740570,3.81
1,99,1997,2096,0.2788028,0.1921261,3.51
1,100,1997,2097,0.3019394,0.2120127,3.23
1,101,1997,2098,0.3266317,0.2338683,2.96
1,102,1997,2099,0.3529236,0.2577386,2.71
1,103,1997,2100,0.3808502,0.2836890,2.48
1,104,1997,2101,0.4104359,0.3118980,2.26
1,105,1997,2102,0.4416930,0.3425660,2.06
1,106,1997,2103,0.4746198,0.3758035,1.87
1,107,1997,2104,0.5091990,0.4115914,1.70
1,108,1997,2105,0.5453968,0.4499281,1.54
1,109,1997,2106,0.5831612,0.4909051,1.40
1,110,1997,2107,0.6224217,0.5345944,1.26
1,111,1997,2108,0.6630882,0.5809457,1.14
1,112,1997,2109,0.7050519,0.6297731,1.02
1,113,1997,2110,0.7481851,0.6808957,0.90
1,114,1997,2111,0.7923424,0.7341781,0.77
1,115,1997,2112,1.0000000,1.0000000,0.50
1,2,1998,2000,0.0003367,0.0006163,82.30
1,3,1998,2001,0.0002291,0.0003871,81.35
1,4,1998,2002,0.0001930,0.0003015,80.38
1,5,1998,2003,0.0001870,0.0002713,79.41
1,6,1998,2004,0.0001837,0.0002528,78.43
1,7,1998,2005,0.0001828,0.0002402,77.45
1,8,1998,2006,0.0001845,0.0002329,76.47
1,9,1998,2007,0.0001904,0.0002314,75.48
1,10,1998,2008,0.0002017,0.0002360,74.50
1,11,1998,2009,0.0002200,0.0002470,73.52
1,12,1998,2010,0.0002484,0.0002682,72.54
1,13,1998,2011,0.0002934,0.0003059,71.56
1,14,1998,2012,0.0003624,0.0003677,70.58
1,15,1998,2013,0.0004596,0.0004578,69.60
1,16,1998,2014,0.0005802,0.0005703,68.64
1,17,1998,2015,0.0007098,0.0006898,67.67
1,18,1998,2016,0.0008321,0.0008008,66.72
1,19,1998,2017,0.0009391,0.0008958,65.77
1,20,1998,2018,0.0010297,0.0009742,64.83
1,21,1998,2019,0.0011033,0.0010342,63.90
1,22,1998,2020,0.0011584,0.0010744,62.96
1,23,1998,2021,0.0011978,0.0011000,62.03
1,24,1998,2022,0.0012275,0.0011177,61.10
1,25,1998,2023,0.0012521,0.0011286,60.16
1,26,1998,2024,0.0012759,0.0011368,59.23
1,27,1998,2025,0.0013058,0.0011501,58.30
1,28,1998,2026,0.0013446,0.0011756,57.36
1,29,1998,2027,0.0013859,0.0012017,56.43
1,30,1998,2028,0.0014216,0.0012176,55.50
1,31,1998,2029,0.0014530,0.0012275,54.57
1,32,1998,2030,0.0014859,0.0012371,53.63
1,33,1998,2031,0.0015203,0.0012432,52.70
1,34,1998,2032,0.0015540,0.0012432,51.76
1,35,1998,2033,0.0015941,0.0012425,50.83
1,36,1998,2034,0.0016525,0.0012578,49.89
1,37,1998,2035,0.0017318,0.0012887,48.95
1,38,1998,2036,0.0018255,0.0013373,48.01
1,39,1998,2037,0.0019305,0.0014024,47.08
1,40,1998,2038,0.0020513,0.0014848,46.14
1,41,1998,2039,0.0021897,0.0015824,45.21
1,42,1998,2040,0.0023342,0.0016811,44.28
1,43,1998,2041,0.0024669,0.0017633,43.36
1,44,1998,2042,0.0025867,0.0018253,42.43
1,45,1998,2043,0.0027191,0.0018799,41.51
1,46,1998,2044,0.0028925,0.0019689,40.59
1,47,1998,2045,0.0031101,0.0020920,39.66
1,48,1998,2046,0.0033571,0.0022424,38.75
1,49,1998,2047,0.0036304,0.0024085,37.83
1,50,1998,2048,0.0039379,0.0025836,36.92
1,51,1998,2049,0.0042708,0.0027649,36.02
1,52,1998,2050,0.0046082,0.0029367,35.12
1,53,1998,2051,0.0049489,0.0030881,34.22
1,54,1998,2052,0.0053157,0.0032538,33.32
1,55,1998,2053,0.0057365,0.0034512,32.43
1,56,1998,2054,0.0062406,0.0037184,31.54
1,57,1998,2055,0.0068502,0.0040659,30.66
1,58,1998,2056,0.0075521,0.0044898,29.78
1,59,1998,2057,0.0083035,0.0049365,28.91
1,60,1998,2058,0.0090849,0.0053723,28.05
1,61,1998,2059,0.0099105,0.0058018,27.20
1,62,1998,2060,0.0107829,0.0062213,26.36
1,63,1998,2061,0.0116995,0.0066436,25.52
1,64,1998,2062,0.0126957,0.0071191,24.69
1,65,1998,2063,0.0138071,0.0076665,23.86
1,66,1998,2064,0.0150054,0.0082533,23.04
1,67,1998,2065,0.0162315,0.0087831,22.23
1,68,1998,2066,0.0174919,0.0092565,21.42
1,69,1998,2067,0.0188954,0.0097960,20.61
1,70,1998,2068,0.0205786,0.0105198,19.81
1,71,1998,2069,0.0226142,0.0115206,19.02
1,72,1998,2070,0.0250119,0.0128237,18.23
1,73,1998,2071,0.0277519,0.0144196,17.47
1,74,1998,2072,0.0307579,0.0162613,16.71
1,75,1998,2073,0.0339099,0.0181851,15.98
1,76,1998,2074,0.0371478,0.0200595,15.27
1,77,1998,2075,0.0405123,0.0218602,14.57
1,78,1998,2076,0.0440886,0.0236601,13.88
1,79,1998,2077,0.0480027,0.0256097,13.21
1,80,1998,2078,0.0536037,0.0295476,12.54
1,81,1998,2079,0.0586892,0.0323957,11.91
1,82,1998,2080,0.0642414,0.0354837,11.29
1,83,1998,2081,0.0702997,0.0388993,10.69
1,84,1998,2082,0.0769067,0.0427551,10.10
1,85,1998,2083,0.0841076,0.0470898,9.53
1,86,1998,2084,0.0919504,0.0519256,8.98
1,87,1998,2085,0.1004863,0.0572917,8.44
1,88,1998,2086,0.1097689,0.0632725,7.92
1,89,1998,2087,0.1198550,0.0699690,7.42
1,90,1998,2088,0.1308036,0.0774361,6.95
1,91,1998,2089,0.1426766,0.0856880,6.49
1,92,1998,2090,0.1555375,0.0947661,6.05
1,93,1998,2091,0.1694519,0.1047896,5.63
1,94,1998,2092,0.1844867,0.1159108,5.23
1,95,1998,2093,0.2007091,0.1282471,4.85
1,96,1998,2094,0.2181866,0.1418412,4.49
1,97,1998,2095,0.2369856,0.1567567,4.15
1,98,1998,2096,0.2571705,0.1731573,3.83
1,99,1998,2097,0.2788028,0.1912442,3.52
1,100,1998,2098,0.3019394,0.2111672,3.24
1,101,1998,2099,0.3266317,0.2329765,2.97
1,102,1998,2100,0.3529236,0.2567424,2.72
1,103,1998,2101,0.3808502,0.2826482,2.49
1,104,1998,2102,0.4104359,0.3109035,2.27
1,105,1998,2103,0.4416930,0.3416357,2.07
1,106,1998,2104,0.4746198,0.3748470,1.88
1,107,1998,2105,0.5091990,0.4105598,1.71
1,108,1998,2106,0.5453968,0.4488956,1.55
1,109,1998,2107,0.5831612,0.4899659,1.40
1,110,1998,2108,0.6224217,0.5337647,1.26
1,111,1998,2109,0.6630882,0.5801476,1.14
1,112,1998,2110,0.7050519,0.6289766,1.02
1,113,1998,2111,0.7481851,0.6801692,0.91
1,114,1998,2112,0.7923424,0.7335894,0.77
1,115,1998,2113,1.0000000,1.0000000,0.50
1,1,1999,2000,0.0006668,0.0012729,83.32
1,2,1999,2001,0.0003367,0.0005788,82.43
1,3,1999,2002,0.0002291,0.0003660,81.47
1,4,1999,2003,0.0001930,0.0002891,80.50
1,5,1999,2004,0.0001870,0.0002635,79.53
1,6,1999,2005,0.0001837,0.0002464,78.55
1,7,1999,2006,0.0001828,0.0002344,77.57
1,8,1999,2007,0.0001845,0.0002277,76.58
1,9,1999,2008,0.0001904,0.0002259,75.60
1,10,1999,2009,0.0002017,0.0002291,74.62
1,11,1999,2010,0.0002200,0.0002393,73.64
1,12,1999,2011,0.0002484,0.0002604,72.65
1,13,1999,2012,0.0002934,0.0002984,71.67
1,14,1999,2013,0.0003624,0.0003606,70.69
1,15,1999,2014,0.0004596,0.0004502,69.72
1,16,1999,2015,0.0005802,0.0005617,68.75
1,17,1999,2016,0.0007098,0.0006805,67.79
1,18,1999,2017,0.0008321,0.0007915,66.83
1,19,1999,2018,0.0009391,0.0008867,65.89
1,20,1999,2019,0.0010297,0.0009644,64.94
1,21,1999,2020,0.0011033,0.0010231,64.01
1,22,1999,2021,0.0011584,0.0010626,63.07
1,23,1999,2022,0.0011978,0.0010888,62.14
1,24,1999,2023,0.0012275,0.0011073,61.21
1,25,1999,2024,0.0012521,0.0011177,60.27
1,26,1999,2025,0.0012759,0.0011246,59.34
1,27,1999,2026,0.0013058,0.0011374,58.41
1,28,1999,2027,0.0013446,0.0011638,57.47
1,29,1999,2028,0.0013859,0.0011906,56.54
1,30,1999,2029,0.0014216,0.0012058,55.61
1,31,1999,2030,0.0014530,0.0012143,54.67
1,32,1999,2031,0.0014859,0.0012232,53.74
1,33,1999,2032,0.0015203,0.0012296,52.80
1,34,1999,2033,0.0015540,0.0012300,51.87
1,35,1999,2034,0.0015941,0.0012282,50.93
1,36,1999,2035,0.0016525,0.0012413,49.99
1,37,1999,2036,0.0017318,0.0012708,49.05
1,38,1999,2037,0.0018255,0.0013196,48.12
1,39,1999,2038,0.0019305,0.0013856,47.18
1,40,1999,2039,0.0020513,0.0014670,46.24
1,41,1999,2040,0.0021897,0.0015623,45.31
1,42,1999,2041,0.0023342,0.0016598,44.38
1,43,1999,2042,0.0024669,0.0017426,43.45
1,44,1999,2043,0.0025867,0.0018054,42.53
1,45,1999,2044,0.0027191,0.0018585,41.60
1,46,1999,2045,0.0028925,0.0019443,40.68
1,47,1999,2046,0.0031101,0.0020653,39.76
1,48,1999,2047,0.0033571,0.0022158,38.84
1,49,1999,2048,0.0036304,0.0023822,37.93
1,50,1999,2049,0.0039379,0.0025547,37.02
1,51,1999,2050,0.0042708,0.0027310,36.11
1,52,1999,2051,0.0046082,0.0028996,35.21
1,53,1999,2052,0.0049489,0.0030506,34.31
1,54,1999,2053,0.0053157,0.0032163,33.41
1,55,1999,2054,0.0057365,0.0034094,32.52
1,56,1999,2055,0.0062406,0.0036694,31.63
1,57,1999,2056,0.0068502,0.0040120,30.74
1,58,1999,2057,0.0075521,0.0044353,29.86
1,59,1999,2058,0.0083035,0.0048823,28.99
1,60,1999,2059,0.0090849,0.0053126,28.13
1,61,1999,2060,0.0099105,0.0057319,27.28
1,62,1999,2061,0.0107829,0.0061442,26.44
1,63,1999,2062,0.0116995,0.0065655,25.60
1,64,1999,2063,0.0126957,0.0070414,24.76
1,65,1999,2064,0.0138071,0.0075810,23.93
1,66,1999,2065,0.0150054,0.0081532,23.11
1,67,1999,2066,0.0162315,0.0086734,22.30
1,68,1999,2067,0.0174919,0.0091457,21.49
1,69,1999,2068,0.0188954,0.0096852,20.68
1,70,1999,2069,0.0205786,0.0103963,19.88
1,71,1999,2070,0.0226142,0.0113747,19.08
1,72,1999,2071,0.0250119,0.0126621,18.30
1,73,1999,2072,0.0277519,0.0142550,17.53
1,74,1999,2073,0.0307579,0.0160980,16.77
1,75,1999,2074,0.0339099,0.0180071,16.04
1,76,1999,2075,0.0371478,0.0198522,15.32
1,77,1999,2076,0.0405123,0.0216324,14.62
1,78,1999,2077,0.0440886,0.0234293,13.94
1,79,1999,2078,0.0480027,0.0253780,13.26
1,80,1999,2079,0.0536037,0.0292889,12.59
1,81,1999,2080,0.0586892,0.0320908,11.96
1,82,1999,2081,0.0642414,0.0351473,11.33
1,83,1999,2082,0.0702997,0.0385582,10.73
1,84,1999,2083,0.0769067,0.0424158,10.14
1,85,1999,2084,0.0841076,0.0467172,9.57
1,86,1999,2085,0.0919504,0.0514909,9.01
1,87,1999,2086,0.1004863,0.0568154,8.47
1,88,1999,2087,0.1097689,0.0627929,7.95
1,89,1999,2088,0.1198550,0.0694937,7.45
1,90,1999,2089,0.1308036,0.0769151,6.97
1,91,1999,2090,0.1426766,0.0850835,6.51
1,92,1999,2091,0.1555375,0.0941092,6.07
1,93,1999,2092,0.1694519,0.1041340,5.65
1,94,1999,2093,0.1844867,0.1152679,5.25
1,95,1999,2094,0.2007091,0.1275510,4.87
1,96,1999,2095,0.2181866,0.1410432,4.50
1,97,1999,2096,0.2369856,0.1558999,4.16
1,98,1999,2097,0.2571705,0.1723140,3.84
1,99,1999,2098,0.2788028,0.1904320,3.53
1,100,1999,2099,0.3019394,0.2103062,3.25
1,101,1999,2100,0.3266317,0.2320095,2.98
1,102,1999,2101,0.3529236,0.2557259,2.73
1,103,1999,2102,0.3808502,0.2816702,2.49
1,104,1999,2103,0.4104359,0.3099815,2.27
1,105,1999,2104,0.4416930,0.3406794,2.07
1,106,1999,2105,0.4746198,0.3738055,1.88
1,107,1999,2106,0.5091990,0.4095056,1.71
1,108,1999,2107,0.5453968,0.4479241,1.55
1,109,1999,2108,0.5831612,0.4890947,1.40
1,110,1999,2109,0.6224217,0.5329117,1.27
1,111,1999,2110,0.6630882,0.5792779,1.14
1,112,1999,2111,0.7050519,0.6281617,1.02
1,113,1999,2112,0.7481851,0.6794854,0.91
1,114,1999,2113,0.7923424,0.7330458,0.77
1,115,1999,2114,1.0000000,1.0000000,0.50
1,0,2000,2000,0.0091954,0.0145387,83.23
1,1,2000,2001,0.0006668,0.0011901,83.45
1,2,2000,2002,0.0003367,0.0005462,82.55
1,3,2000,2003,0.0002291,0.0003502,81.59
1,4,2000,2004,0.0001930,0.0002802,80.62
1,5,2000,2005,0.0001870,0.0002564,79.65
1,6,2000,2006,0.0001837,0.0002401,78.67
1,7,2000,2007,0.0001828,0.0002289,77.68
1,8,2000,2008,0.0001845,0.0002219,76.70
1,9,2000,2009,0.0001904,0.0002187,75.72
1,10,2000,2010,0.0002017,0.0002213,74.74
1,11,2000,2011,0.0002200,0.0002317,73.75
1,12,2000,2012,0.0002484,0.0002533,72.77
1,13,2000,2013,0.0002934,0.0002917,71.79
1,14,2000,2014,0.0003624,0.0003535,70.81
1,15,2000,2015,0.0004596,0.0004421,69.83
1,16,2000,2016,0.0005802,0.0005530,68.86
1,17,2000,2017,0.0007098,0.0006718,67.90
1,18,2000,2018,0.0008321,0.0007830,66.95
1,19,2000,2019,0.0009391,0.0008775,66.00
1,20,2000,2020,0.0010297,0.0009539,65.06
1,21,2000,2021,0.0011033,0.0010118,64.12
1,22,2000,2022,0.0011584,0.0010516,63.18
1,23,2000,2023,0.0011978,0.0010785,62.25
1,24,2000,2024,0.0012275,0.0010967,61.31
1,25,2000,2025,0.0012521,0.0011059,60.38
1,26,2000,2026,0.0012759,0.0011123,59.45
1,27,2000,2027,0.0013058,0.0011256,58.51
1,28,2000,2028,0.0013446,0.0011529,57.58
1,29,2000,2029,0.0013859,0.0011793,56.64
1,30,2000,2030,0.0014216,0.0011932,55.71
1,31,2000,2031,0.0014530,0.0012010,54.78
1,32,2000,2032,0.0014859,0.0012102,53.84
1,33,2000,2033,0.0015203,0.0012172,52.91
1,34,2000,2034,0.0015540,0.0012166,51.97
1,35,2000,2035,0.0015941,0.0012127,51.03
1,36,2000,2036,0.0016525,0.0012246,50.09
1,37,2000,2037,0.0017318,0.0012541,49.16
1,38,2000,2038,0.0018255,0.0013035,48.22
1,39,2000,2039,0.0019305,0.0013684,47.28
1,40,2000,2040,0.0020513,0.0014477,46.34
1,41,2000,2041,0.0021897,0.0015420,45.41
1,42,2000,2042,0.0023342,0.0016401,44.48
1,43,2000,2043,0.0024669,0.0017237,43.55
1,44,2000,2044,0.0025867,0.0017854,42.63
1,45,2000,2045,0.0027191,0.0018355,41.70
1,46,2000,2046,0.0028925,0.0019194,40.78
1,47,2000,2047,0.0031101,0.0020404,39.85
1,48,2000,2048,0.0033571,0.0021914,38.93
1,49,2000,2049,0.0036304,0.0023556,38.02
1,50,2000,2050,0.0039379,0.0025235,37.11
1,51,2000,2051,0.0042708,0.0026967,36.20
1,52,2000,2052,0.0046082,0.0028650,35.30
1,53,2000,2053,0.0049489,0.0030160,34.40
1,54,2000,2054,0.0053157,0.0031777,33.50
1,55,2000,2055,0.0057365,0.0033643,32.60
1,56,2000,2056,0.0062406,0.0036199,31.71
1,57,2000,2057,0.0068502,0.0039618,30.83
1,58,2000,2058,0.0075521,0.0043854,29.95
1,59,2000,2059,0.0083035,0.0048276,29.08
1,60,2000,2060,0.0090849,0.0052485,28.22
1,61,2000,2061,0.0099105,0.0056612,27.36
1,62,2000,2062,0.0107829,0.0060725,26.51
1,63,2000,2063,0.0116995,0.0064940,25.67
1,64,2000,2064,0.0126957,0.0069627,24.84
1,65,2000,2065,0.0138071,0.0074888,24.01
1,66,2000,2066,0.0150054,0.0080521,23.19
1,67,2000,2067,0.0162315,0.0085712,22.37
1,68,2000,2068,0.0174919,0.0090437,21.56
1,69,2000,2069,0.0188954,0.0095721,20.75
1,70,2000,2070,0.0205786,0.0102631,19.95
1,71,2000,2071,0.0226142,0.0112273,19.15
1,72,2000,2072,0.0250119,0.0125119,18.36
1,73,2000,2073,0.0277519,0.0141054,17.59
1,74,2000,2074,0.0307579,0.0159344,16.83
1,75,2000,2075,0.0339099,0.0178160,16.10
1,76,2000,2076,0.0371478,0.0196422,15.38
1,77,2000,2077,0.0405123,0.0214197,14.68
1,78,2000,2078,0.0440886,0.0232161,13.99
1,79,2000,2079,0.0480027,0.0251404,13.31
1,80,2000,2080,0.0536037,0.0290087,12.64
1,81,2000,2081,0.0586892,0.0317816,12.00
1,82,2000,2082,0.0642414,0.0348334,11.38
1,83,2000,2083,0.0702997,0.0382454,10.77
1,84,2000,2084,0.0769067,0.0420718,10.18
1,85,2000,2085,0.0841076,0.0463151,9.60
1,86,2000,2086,0.0919504,0.0510494,9.05
1,87,2000,2087,0.1004863,0.0563700,8.51
1,88,2000,2088,0.1097689,0.0623507,7.98
1,89,2000,2089,0.1198550,0.0690080,7.48
1,90,2000,2090,0.1308036,0.0763506,7.00
1,91,2000,2091,0.1426766,0.0844689,6.54
1,92,2000,2092,0.1555375,0.0934944,6.09
1,93,2000,2093,0.1694519,0.1035296,5.67
1,94,2000,2094,0.1844867,0.1146117,5.27
1,95,2000,2095,0.2007091,0.1267964,4.88
1,96,2000,2096,0.2181866,0.1402304,4.52
1,97,2000,2097,0.2369856,0.1550970,4.18
1,98,2000,2098,0.2571705,0.1715376,3.85
1,99,2000,2099,0.2788028,0.1896053,3.55
1,100,2000,2100,0.3019394,0.2093730,3.26
1,101,2000,2101,0.3266317,0.2310230,2.99
1,102,2000,2102,0.3529236,0.2547710,2.74
1,103,2000,2103,0.3808502,0.2807637,2.50
1,104,2000,2104,0.4104359,0.3090340,2.28
1,105,2000,2105,0.4416930,0.3396384,2.08
1,106,2000,2106,0.4746198,0.3727414,1.89
1,107,2000,2107,0.5091990,0.4085140,1.71
1,108,2000,2108,0.5453968,0.4470233,1.55
1,109,2000,2109,0.5831612,0.4881993,1.41
1,110,2000,2110,0.6224217,0.5319824,1.27
1,111,2000,2111,0.6630882,0.5783883,1.14
1,112,2000,2112,0.7050519,0.6273950,1.02
1,113,2000,2113,0.7481851,0.6788544,0.91
1,114,2000,2114,0.7923424,0.7324918,0.77
1,115,2000,2115,1.0000000,1.0000000,0.50
1,0,2001,2001,0.0091953,0.0138631,83.41
1,1,2001,2002,0.0006668,0.0011187,83.58
1,2,2001,2003,0.0003367,0.0005219,82.67
1,3,2001,2004,0.0002291,0.0003388,81.71
1,4,2001,2005,0.0001930,0.0002719,80.74
1,5,2001,2006,0.0001870,0.0002492,79.76
1,6,2001,2007,0.0001837,0.0002339,78.78
1,7,2001,2008,0.0001828,0.0002226,77.80
1,8,2001,2009,0.0001845,0.0002143,76.82
1,9,2001,2010,0.0001904,0.0002106,75.84
1,10,2001,2011,0.0002017,0.0002135,74.85
1,11,2001,2012,0.0002200,0.0002247,73.87
1,12,2001,2013,0.0002484,0.0002468,72.88
1,13,2001,2014,0.0002934,0.0002850,71.90
1,14,2001,2015,0.0003624,0.0003459,70.92
1,15,2001,2016,0.0004596,0.0004340,69.95
1,16,2001,2017,0.0005802,0.0005450,68.98
1,17,2001,2018,0.0007098,0.0006639,68.01
1,18,2001,2019,0.0008321,0.0007744,67.06
1,19,2001,2020,0.0009391,0.0008676,66.11
1,20,2001,2021,0.0010297,0.0009432,65.17
1,21,2001,2022,0.0011033,0.0010013,64.23
1,22,2001,2023,0.0011584,0.0010415,63.29
1,23,2001,2024,0.0011978,0.0010679,62.36
1,24,2001,2025,0.0012275,0.0010852,61.42
1,25,2001,2026,0.0012521,0.0010940,60.49
1,26,2001,2027,0.0012759,0.0011009,59.56
1,27,2001,2028,0.0013058,0.0011148,58.62
1,28,2001,2029,0.0013446,0.0011418,57.69
1,29,2001,2030,0.0013859,0.0011672,56.75
1,30,2001,2031,0.0014216,0.0011804,55.82
1,31,2001,2032,0.0014530,0.0011885,54.88
1,32,2001,2033,0.0014859,0.0011984,53.95
1,33,2001,2034,0.0015203,0.0012046,53.01
1,34,2001,2035,0.0015540,0.0012022,52.07
1,35,2001,2036,0.0015941,0.0011971,51.14
1,36,2001,2037,0.0016525,0.0012090,50.20
1,37,2001,2038,0.0017318,0.0012388,49.26
1,38,2001,2039,0.0018255,0.0012872,48.32
1,39,2001,2040,0.0019305,0.0013500,47.38
1,40,2001,2041,0.0020513,0.0014283,46.44
1,41,2001,2042,0.0021897,0.0015231,45.51
1,42,2001,2043,0.0023342,0.0016220,44.58
1,43,2001,2044,0.0024669,0.0017046,43.65
1,44,2001,2045,0.0025867,0.0017639,42.72
1,45,2001,2046,0.0027191,0.0018122,41.80
1,46,2001,2047,0.0028925,0.0018962,40.87
1,47,2001,2048,0.0031101,0.0020175,39.95
1,48,2001,2049,0.0033571,0.0021665,39.03
1,49,2001,2050,0.0036304,0.0023268,38.11
1,50,2001,2051,0.0039379,0.0024920,37.20
1,51,2001,2052,0.0042708,0.0026648,36.29
1,52,2001,2053,0.0046082,0.0028330,35.39
1,53,2001,2054,0.0049489,0.0029804,34.49
1,54,2001,2055,0.0053157,0.0031361,33.59
1,55,2001,2056,0.0057365,0.0033186,32.69
1,56,2001,2057,0.0062406,0.0035739,31.80
1,57,2001,2058,0.0068502,0.0039161,30.91
1,58,2001,2059,0.0075521,0.0043351,30.03
1,59,2001,2060,0.0083035,0.0047686,29.16
1,60,2001,2061,0.0090849,0.0051836,28.30
1,61,2001,2062,0.0099105,0.0055954,27.44
1,62,2001,2063,0.0107829,0.0060067,26.59
1,63,2001,2064,0.0116995,0.0064214,25.75
1,64,2001,2065,0.0126957,0.0068779,24.91
1,65,2001,2066,0.0138071,0.0073956,24.08
1,66,2001,2067,0.0150054,0.0079578,23.26
1,67,2001,2068,0.0162315,0.0084770,22.44
1,68,2001,2069,0.0174919,0.0089394,21.63
1,69,2001,2070,0.0188954,0.0094499,20.82
1,70,2001,2071,0.0205786,0.0101285,20.01
1,71,2001,2072,0.0226142,0.0110903,19.21
1,72,2001,2073,0.0250119,0.0123754,18.42
1,73,2001,2074,0.0277519,0.0139556,17.65
1,74,2001,2075,0.0307579,0.0157588,16.89
1,75,2001,2076,0.0339099,0.0176225,16.15
1,76,2001,2077,0.0371478,0.0194461,15.43
1,77,2001,2078,0.0405123,0.0212233,14.73
1,78,2001,2079,0.0440886,0.0229974,14.04
1,79,2001,2080,0.0480027,0.0248832,13.36
1,80,2001,2081,0.0536037,0.0287245,12.68
1,81,2001,2082,0.0586892,0.0314931,12.05
1,82,2001,2083,0.0642414,0.0345456,11.42
1,83,2001,2084,0.0702997,0.0379283,10.81
1,84,2001,2085,0.0769067,0.0417006,10.22
1,85,2001,2086,0.0841076,0.0459069,9.64
1,86,2001,2087,0.0919504,0.0506368,9.08
1,87,2001,2088,0.1004863,0.0559595,8.54
1,88,2001,2089,0.1097689,0.0618989,8.01
1,89,2001,2090,0.1198550,0.0684820,7.51
1,90,2001,2091,0.1308036,0.0757768,7.03
1,91,2001,2092,0.1426766,0.0838937,6.56
1,92,2001,2093,0.1555375,0.0929277,6.12
1,93,2001,2094,0.1694519,0.1029128,5.69
1,94,2001,2095,0.1844867,0.1139006,5.29
1,95,2001,2096,0.2007091,0.1260281,4.90
1,96,2001,2097,0.2181866,0.1394689,4.54
1,97,2001,2098,0.2369856,0.1543580,4.19
1,98,2001,2099,0.2571705,0.1707475,3.86
1,99,2001,2100,0.2788028,0.1887094,3.56
1,100,2001,2101,0.3019394,0.2084213,3.27
1,101,2001,2102,0.3266317,0.2300966,3.00
1,102,2001,2103,0.3529236,0.2538861,2.74
1,103,2001,2104,0.3808502,0.2798323,2.51
1,104,2001,2105,0.4104359,0.3080028,2.29
1,105,2001,2106,0.4416930,0.3385751,2.08
1,106,2001,2107,0.4746198,0.3717407,1.89
1,107,2001,2108,0.5091990,0.4075946,1.72
1,108,2001,2109,0.5453968,0.4460977,1.56
1,109,2001,2110,0.5831612,0.4872241,1.41
1,110,2001,2111,0.6224217,0.5310321,1.27
1,111,2001,2112,0.6630882,0.5775515,1.14
1,112,2001,2113,0.7050519,0.6266876,1.03
1,113,2001,2114,0.7481851,0.6782112,0.91
1,114,2001,2115,0.7923424,0.7318896,0.77
1,115,2001,2116,1.0000000,1.0000000,0.50
1,0,2002,2002,0.0091952,0.0132696,83.58
1,1,2002,2003,0.0006668,0.0010655,83.70
1,2,2002,2004,0.0003367,0.0005044,82.79
1,3,2002,2005,0.0002291,0.0003284,81.83
1,4,2002,2006,0.0001930,0.0002637,80.86
1,5,2002,2007,0.0001870,0.0002424,79.88
1,6,2002,2008,0.0001837,0.0002271,78.90
1,7,2002,2009,0.0001828,0.0002145,77.92
1,8,2002,2010,0.0001845,0.0002057,76.94
1,9,2002,2011,0.0001904,0.0002026,75.95
1,10,2002,2012,0.0002017,0.0002065,74.97
1,11,2002,2013,0.0002200,0.0002184,73.98
1,12,2002,2014,0.0002484,0.0002404,73.00
1,13,2002,2015,0.0002934,0.0002779,72.02
1,14,2002,2016,0.0003624,0.0003383,71.04
1,15,2002,2017,0.0004596,0.0004265,70.06
1,16,2002,2018,0.0005802,0.0005377,69.09
1,17,2002,2019,0.0007098,0.0006559,68.13
1,18,2002,2020,0.0008321,0.0007651,67.17
1,19,2002,2021,0.0009391,0.0008576,66.22
1,20,2002,2022,0.0010297,0.0009333,65.28
1,21,2002,2023,0.0011033,0.0009916,64.34
1,22,2002,2024,0.0011584,0.0010312,63.40
1,23,2002,2025,0.0011978,0.0010566,62.47
1,24,2002,2026,0.0012275,0.0010736,61.53
1,25,2002,2027,0.0012521,0.0010829,60.60
1,26,2002,2028,0.0012759,0.0010903,59.66
1,27,2002,2029,0.0013058,0.0011038,58.73
1,28,2002,2030,0.0013446,0.0011299,57.79
1,29,2002,2031,0.0013859,0.0011549,56.86
1,30,2002,2032,0.0014216,0.0011684,55.92
1,31,2002,2033,0.0014530,0.0011771,54.99
1,32,2002,2034,0.0014859,0.0011864,54.05
1,33,2002,2035,0.0015203,0.0011911,53.11
1,34,2002,2036,0.0015540,0.0011877,52.18
1,35,2002,2037,0.0015941,0.0011826,51.24
1,36,2002,2038,0.0016525,0.0011948,50.30
1,37,2002,2039,0.0017318,0.0012234,49.36
1,38,2002,2040,0.0018255,0.0012696,48.42
1,39,2002,2041,0.0019305,0.0013314,47.48
1,40,2002,2042,0.0020513,0.0014102,46.54
1,41,2002,2043,0.0021897,0.0015059,45.61
1,42,2002,2044,0.0023342,0.0016038,44.67
1,43,2002,2045,0.0024669,0.0016841,43.75
1,44,2002,2046,0.0025867,0.0017421,42.82
1,45,2002,2047,0.0027191,0.0017906,41.89
1,46,2002,2048,0.0028925,0.0018750,40.97
1,47,2002,2049,0.0031101,0.0019944,40.04
1,48,2002,2050,0.0033571,0.0021398,39.12
1,49,2002,2051,0.0036304,0.0022978,38.20
1,50,2002,2052,0.0039379,0.0024626,37.29
1,51,2002,2053,0.0042708,0.0026353,36.38
1,52,2002,2054,0.0046082,0.0028002,35.48
1,53,2002,2055,0.0049489,0.0029419,34.58
1,54,2002,2056,0.0053157,0.0030941,33.68
1,55,2002,2057,0.0057365,0.0032762,32.78
1,56,2002,2058,0.0062406,0.0035318,31.88
1,57,2002,2059,0.0068502,0.0038698,31.00
1,58,2002,2060,0.0075521,0.0042810,30.11
1,59,2002,2061,0.0083035,0.0047091,29.24
1,60,2002,2062,0.0090849,0.0051232,28.38
1,61,2002,2063,0.0099105,0.0055351,27.52
1,62,2002,2064,0.0107829,0.0059400,26.67
1,63,2002,2065,0.0116995,0.0063434,25.83
1,64,2002,2066,0.0126957,0.0067921,24.99
1,65,2002,2067,0.0138071,0.0073088,24.16
1,66,2002,2068,0.0150054,0.0078710,23.33
1,67,2002,2069,0.0162315,0.0083808,22.51
1,68,2002,2070,0.0174919,0.0088268,21.70
1,69,2002,2071,0.0188954,0.0093265,20.89
1,70,2002,2072,0.0205786,0.0100034,20.08
1,71,2002,2073,0.0226142,0.0109660,19.28
1,72,2002,2074,0.0250119,0.0122388,18.49
1,73,2002,2075,0.0277519,0.0137949,17.71
1,74,2002,2076,0.0307579,0.0155810,16.95
1,75,2002,2077,0.0339099,0.0174419,16.21
1,76,2002,2078,0.0371478,0.0192651,15.49
1,77,2002,2079,0.0405123,0.0210219,14.78
1,78,2002,2080,0.0440886,0.0227608,14.09
1,79,2002,2081,0.0480027,0.0246226,13.41
1,80,2002,2082,0.0536037,0.0284595,12.73
1,81,2002,2083,0.0586892,0.0312286,12.09
1,82,2002,2084,0.0642414,0.0342539,11.46
1,83,2002,2085,0.0702997,0.0375862,10.85
1,84,2002,2086,0.0769067,0.0413238,10.26
1,85,2002,2087,0.0841076,0.0455255,9.68
1,86,2002,2088,0.0919504,0.0502566,9.11
1,87,2002,2089,0.1004863,0.0555402,8.57
1,88,2002,2090,0.1097689,0.0614097,8.05
1,89,2002,2091,0.1198550,0.0679474,7.54
1,90,2002,2092,0.1308036,0.0752400,7.05
1,91,2002,2093,0.1426766,0.0833638,6.59
1,92,2002,2094,0.1555375,0.0923496,6.14
1,93,2002,2095,0.1694519,0.1022447,5.71
1,94,2002,2096,0.1844867,0.1131768,5.31
1,95,2002,2097,0.2007091,0.1253086,4.92
1,96,2002,2098,0.2181866,0.1387683,4.55
1,97,2002,2099,0.2369856,0.1536062,4.21
1,98,2002,2100,0.2571705,0.1698916,3.88
1,99,2002,2101,0.2788028,0.1877961,3.57
1,100,2002,2102,0.3019394,0.2075278,3.28
1,101,2002,2103,0.3266317,0.2292384,3.01
1,102,2002,2104,0.3529236,0.2529772,2.75
1,103,2002,2105,0.3808502,0.2788190,2.52
1,104,2002,2106,0.4104359,0.3069499,2.29
1,105,2002,2107,0.4416930,0.3375756,2.09
1,106,2002,2108,0.4746198,0.3708133,1.90
1,107,2002,2109,0.5091990,0.4066503,1.72
1,108,2002,2110,0.5453968,0.4450898,1.56
1,109,2002,2111,0.5831612,0.4862270,1.41
1,110,2002,2112,0.6224217,0.5301383,1.27
1,111,2002,2113,0.6630882,0.5767794,1.15
1,112,2002,2114,0.7050519,0.6259665,1.03
1,113,2002,2115,0.7481851,0.6775121,0.91
1,114,2002,2116,0.7923424,0.7312732,0.77
1,115,2002,2117,1.0000000,1.0000000,0.50
1,0,2003,2003,0.0091952,0.0128197,83.74
1,1,2003,2004,0.0006668,0.0010273,83.83
1,2,2003,2005,0.0003367,0.0004883,82.91
1,3,2003,2006,0.0002291,0.0003180,81.95
1,4,2003,2007,0.0001930,0.0002559,80.98
1,5,2003,2008,0.0001870,0.0002348,80.00
1,6,2003,2009,0.0001837,0.0002182,79.02
1,7,2003,2010,0.0001828,0.0002053,78.04
1,8,2003,2011,0.0001845,0.0001973,77.05
1,9,2003,2012,0.0001904,0.0001953,76.07
1,10,2003,2013,0.0002017,0.0002002,75.08
1,11,2003,2014,0.0002200,0.0002122,74.10
1,12,2003,2015,0.0002484,0.0002337,73.11
1,13,2003,2016,0.0002934,0.0002707,72.13
1,14,2003,2017,0.0003624,0.0003313,71.15
1,15,2003,2018,0.0004596,0.0004197,70.17
1,16,2003,2019,0.0005802,0.0005303,69.20
1,17,2003,2020,0.0007098,0.0006473,68.24
1,18,2003,2021,0.0008321,0.0007557,67.28
1,19,2003,2022,0.0009391,0.0008482,66.33
1,20,2003,2023,0.0010297,0.0009242,65.39
1,21,2003,2024,0.0011033,0.0009817,64.45
1,22,2003,2025,0.0011584,0.0010200,63.51
1,23,2003,2026,0.0011978,0.0010451,62.57
1,24,2003,2027,0.0012275,0.0010628,61.64
1,25,2003,2028,0.0012521,0.0010727,60.70
1,26,2003,2029,0.0012759,0.0010797,59.77
1,27,2003,2030,0.0013058,0.0010920,58.83
1,28,2003,2031,0.0013446,0.0011179,57.90
1,29,2003,2032,0.0013859,0.0011434,56.96
1,30,2003,2033,0.0014216,0.0011575,56.03
1,31,2003,2034,0.0014530,0.0011656,55.09
1,32,2003,2035,0.0014859,0.0011735,54.15
1,33,2003,2036,0.0015203,0.0011774,53.22
1,34,2003,2037,0.0015540,0.0011742,52.28
1,35,2003,2038,0.0015941,0.0011693,51.34
1,36,2003,2039,0.0016525,0.0011804,50.40
1,37,2003,2040,0.0017318,0.0012068,49.46
1,38,2003,2041,0.0018255,0.0012518,48.52
1,39,2003,2042,0.0019305,0.0013142,47.58
1,40,2003,2043,0.0020513,0.0013938,46.64
1,41,2003,2044,0.0021897,0.0014885,45.70
1,42,2003,2045,0.0023342,0.0015842,44.77
1,43,2003,2046,0.0024669,0.0016634,43.84
1,44,2003,2047,0.0025867,0.0017218,42.91
1,45,2003,2048,0.0027191,0.0017707,41.99
1,46,2003,2049,0.0028925,0.0018534,41.06
1,47,2003,2050,0.0031101,0.0019694,40.14
1,48,2003,2051,0.0033571,0.0021128,39.21
1,49,2003,2052,0.0036304,0.0022707,38.30
1,50,2003,2053,0.0039379,0.0024355,37.38
1,51,2003,2054,0.0042708,0.0026050,36.47
1,52,2003,2055,0.0046082,0.0027647,35.57
1,53,2003,2056,0.0049489,0.0029030,34.66
1,54,2003,2057,0.0053157,0.0030550,33.76
1,55,2003,2058,0.0057365,0.0032375,32.87
1,56,2003,2059,0.0062406,0.0034894,31.97
1,57,2003,2060,0.0068502,0.0038201,31.08
1,58,2003,2061,0.0075521,0.0042262,30.20
1,59,2003,2062,0.0083035,0.0046536,29.32
1,60,2003,2063,0.0090849,0.0050679,28.46
1,61,2003,2064,0.0099105,0.0054739,27.60
1,62,2003,2065,0.0107829,0.0058683,26.75
1,63,2003,2066,0.0116995,0.0062644,25.91
1,64,2003,2067,0.0126957,0.0067123,25.07
1,65,2003,2068,0.0138071,0.0072289,24.23
1,66,2003,2069,0.0150054,0.0077822,23.40
1,67,2003,2070,0.0162315,0.0082768,22.58
1,68,2003,2071,0.0174919,0.0087130,21.77
1,69,2003,2072,0.0188954,0.0092118,20.96
1,70,2003,2073,0.0205786,0.0098899,20.15
1,71,2003,2074,0.0226142,0.0108415,19.34
1,72,2003,2075,0.0250119,0.0120924,18.55
1,73,2003,2076,0.0277519,0.0136323,17.77
1,74,2003,2077,0.0307579,0.0154152,17.01
1,75,2003,2078,0.0339099,0.0172752,16.27
1,76,2003,2079,0.0371478,0.0190795,15.54
1,77,2003,2080,0.0405123,0.0208039,14.84
1,78,2003,2081,0.0440886,0.0225210,14.14
1,79,2003,2082,0.0480027,0.0243796,13.45
1,80,2003,2083,0.0536037,0.0282165,12.78
1,81,2003,2084,0.0586892,0.0309606,12.13
1,82,2003,2085,0.0642414,0.0339392,11.51
1,83,2003,2086,0.0702997,0.0372391,10.89
1,84,2003,2087,0.0769067,0.0409718,10.30
1,85,2003,2088,0.0841076,0.0451740,9.71
1,86,2003,2089,0.0919504,0.0498683,9.15
1,87,2003,2090,0.1004863,0.0550864,8.60
1,88,2003,2091,0.1097689,0.0609128,8.08
1,89,2003,2092,0.1198550,0.0674475,7.57
1,90,2003,2093,0.1308036,0.0747456,7.08
1,91,2003,2094,0.1426766,0.0828233,6.61
1,92,2003,2095,0.1555375,0.0917236,6.16
1,93,2003,2096,0.1694519,0.1015648,5.73
1,94,2003,2097,0.1844867,0.1124992,5.33
1,95,2003,2098,0.2007091,0.1246468,4.94
1,96,2003,2099,0.2181866,0.1380558,4.57
1,97,2003,2100,0.2369856,0.1527920,4.22
1,98,2003,2101,0.2571705,0.1690193,3.89
1,99,2003,2102,0.2788028,0.1869389,3.58
1,100,2003,2103,0.3019394,0.2067004,3.29
1,101,2003,2104,0.3266317,0.2283572,3.02
1,102,2003,2105,0.3529236,0.2519886,2.76
1,103,2003,2106,0.3808502,0.2777847,2.52
1,104,2003,2107,0.4104359,0.3059603,2.30
1,105,2003,2108,0.4416930,0.3366493,2.09
1,106,2003,2109,0.4746198,0.3698609,1.90
1,107,2003,2110,0.5091990,0.4056223,1.73
1,108,2003,2111,0.5453968,0.4440596,1.56
1,109,2003,2112,0.5831612,0.4852895,1.41
1,110,2003,2113,0.6224217,0.5293139,1.28
1,111,2003,2114,0.6630882,0.5759928,1.15
1,112,2003,2115,0.7050519,0.6251831,1.03
1,113,2003,2116,0.7481851,0.6767968,0.91
1,114,2003,2117,0.7923424,0.7306923,0.77
1,115,2003,2118,1.0000000,1.0000000,0.50
1,0,2004,2004,0.0091951,0.0124926,83.89
1,1,2004,2005,0.0006668,0.0009923,83.95
1,2,2004,2006,0.0003367,0.0004724,83.03
1,3,2004,2007,0.0002291,0.0003081,82.07
1,4,2004,2008,0.0001930,0.0002471,81.10
1,5,2004,2009,0.0001870,0.0002250,80.12
1,6,2004,2010,0.0001837,0.0002082,79.14
1,7,2004,2011,0.0001828,0.0001963,78.15
1,8,2004,2012,0.0001845,0.0001897,77.17
1,9,2004,2013,0.0001904,0.0001888,76.18
1,10,2004,2014,0.0002017,0.0001939,75.20
1,11,2004,2015,0.0002200,0.0002056,74.21
1,12,2004,2016,0.0002484,0.0002269,73.23
1,13,2004,2017,0.0002934,0.0002642,72.24
1,14,2004,2018,0.0003624,0.0003249,71.26
1,15,2004,2019,0.0004596,0.0004128,70.28
1,16,2004,2020,0.0005802,0.0005224,69.31
1,17,2004,2021,0.0007098,0.0006386,68.35
1,18,2004,2022,0.0008321,0.0007470,67.39
1,19,2004,2023,0.0009391,0.0008397,66.44
1,20,2004,2024,0.0010297,0.0009149,65.50
1,21,2004,2025,0.0011033,0.0009711,64.56
1,22,2004,2026,0.0011584,0.0010088,63.62
1,23,2004,2027,0.0011978,0.0010344,62.68
1,24,2004,2028,0.0012275,0.0010529,61.75
1,25,2004,2029,0.0012521,0.0010624,60.81
1,26,2004,2030,0.0012759,0.0010682,59.88
1,27,2004,2031,0.0013058,0.0010800,58.94
1,28,2004,2032,0.0013446,0.0011066,58.00
1,29,2004,2033,0.0013859,0.0011329,57.07
1,30,2004,2034,0.0014216,0.0011464,56.13
1,31,2004,2035,0.0014530,0.0011532,55.19
1,32,2004,2036,0.0014859,0.0011604,54.26
1,33,2004,2037,0.0015203,0.0011646,53.32
1,34,2004,2038,0.0015540,0.0011618,52.38
1,35,2004,2039,0.0015941,0.0011558,51.44
1,36,2004,2040,0.0016525,0.0011648,50.50
1,37,2004,2041,0.0017318,0.0011900,49.56
1,38,2004,2042,0.0018255,0.0012353,48.62
1,39,2004,2043,0.0019305,0.0012984,47.68
1,40,2004,2044,0.0020513,0.0013772,46.74
1,41,2004,2045,0.0021897,0.0014698,45.80
1,42,2004,2046,0.0023342,0.0015645,44.87
1,43,2004,2047,0.0024669,0.0016441,43.94
1,44,2004,2048,0.0025867,0.0017032,43.01
1,45,2004,2049,0.0027191,0.0017505,42.08
1,46,2004,2050,0.0028925,0.0018301,41.16
1,47,2004,2051,0.0031101,0.0019441,40.23
1,48,2004,2052,0.0033571,0.0020876,39.31
1,49,2004,2053,0.0036304,0.0022457,38.39
1,50,2004,2054,0.0039379,0.0024076,37.47
1,51,2004,2055,0.0042708,0.0025722,36.56
1,52,2004,2056,0.0046082,0.0027288,35.66
1,53,2004,2057,0.0049489,0.0028668,34.75
1,54,2004,2058,0.0053157,0.0030193,33.85
1,55,2004,2059,0.0057365,0.0031984,32.95
1,56,2004,2060,0.0062406,0.0034437,32.06
1,57,2004,2061,0.0068502,0.0037699,31.16
1,58,2004,2062,0.0075521,0.0041753,30.28
1,59,2004,2063,0.0083035,0.0046028,29.41
1,60,2004,2064,0.0090849,0.0050118,28.54
1,61,2004,2065,0.0099105,0.0054081,27.68
1,62,2004,2066,0.0107829,0.0057957,26.83
1,63,2004,2067,0.0116995,0.0061909,25.98
1,64,2004,2068,0.0126957,0.0066387,25.14
1,65,2004,2069,0.0138071,0.0071471,24.31
1,66,2004,2070,0.0150054,0.0076864,23.48
1,67,2004,2071,0.0162315,0.0081717,22.65
1,68,2004,2072,0.0174919,0.0086073,21.84
1,69,2004,2073,0.0188954,0.0091077,21.02
1,70,2004,2074,0.0205786,0.0097763,20.21
1,71,2004,2075,0.0226142,0.0107082,19.41
1,72,2004,2076,0.0250119,0.0119443,18.61
1,73,2004,2077,0.0277519,0.0134807,17.83
1,74,2004,2078,0.0307579,0.0152622,17.07
1,75,2004,2079,0.0339099,0.0171043,16.32
1,76,2004,2080,0.0371478,0.0188787,15.60
1,77,2004,2081,0.0405123,0.0205831,14.89
1,78,2004,2082,0.0440886,0.0222975,14.19
1,79,2004,2083,0.0480027,0.0241571,13.50
1,80,2004,2084,0.0536037,0.0279703,12.83
1,81,2004,2085,0.0586892,0.0306716,12.18
1,82,2004,2086,0.0642414,0.0336200,11.55
1,83,2004,2087,0.0702997,0.0369148,10.93
1,84,2004,2088,0.0769067,0.0406476,10.33
1,85,2004,2089,0.0841076,0.0448152,9.75
1,86,2004,2090,0.0919504,0.0494482,9.18
1,87,2004,2091,0.1004863,0.0546254,8.64
1,88,2004,2092,0.1097689,0.0604482,8.11
1,89,2004,2093,0.1198550,0.0669872,7.60
1,90,2004,2094,0.1308036,0.0742415,7.11
1,91,2004,2095,0.1426766,0.0822382,6.64
1,92,2004,2096,0.1555375,0.0910868,6.18
1,93,2004,2097,0.1694519,0.1009286,5.75
1,94,2004,2098,0.1844867,0.1118761,5.34
1,95,2004,2099,0.2007091,0.1239740,4.95
1,96,2004,2100,0.2181866,0.1372844,4.58
1,97,2004,2101,0.2369856,0.1519625,4.24
1,98,2004,2102,0.2571705,0.1682008,3.90
1,99,2004,2103,0.2788028,0.1861452,3.59
1,100,2004,2104,0.3019394,0.2058509,3.30
1,101,2004,2105,0.3266317,0.2273990,3.03
1,102,2004,2106,0.3529236,0.2509799,2.77
1,103,2004,2107,0.3808502,0.2768130,2.53
1,104,2004,2108,0.4104359,0.3050437,2.31
1,105,2004,2109,0.4416930,0.3356985,2.10
1,106,2004,2110,0.4746198,0.3688243,1.91
1,107,2004,2111,0.5091990,0.4045717,1.73
1,108,2004,2112,0.5453968,0.4430912,1.57
1,109,2004,2113,0.5831612,0.4844250,1.42
1,110,2004,2114,0.6224217,0.5284740,1.28
1,111,2004,2115,0.6630882,0.5751382,1.15
1,112,2004,2116,0.7050519,0.6243815,1.03
1,113,2004,2117,0.7481851,0.6761227,0.91
1,114,2004,2118,0.7923424,0.7301518,0.77
1,115,2004,2119,1.0000000,1.0000000,0.50
1,0,2005,2005,0.0091951,0.0121894,84.04
1,1,2005,2006,0.0006668,0.0009577,84.07
1,2,2005,2007,0.0003367,0.0004572,83.15
1,3,2005,2008,0.0002291,0.0002970,82.19
1,4,2005,2009,0.0001930,0.0002359,81.22
1,5,2005,2010,0.0001870,0.0002139,80.23
1,6,2005,2011,0.0001837,0.0001984,79.25
1,7,2005,2012,0.0001828,0.0001882,78.27
1,8,2005,2013,0.0001845,0.0001829,77.28
1,9,2005,2014,0.0001904,0.0001824,76.30
1,10,2005,2015,0.0002017,0.0001874,75.31
1,11,2005,2016,0.0002200,0.0001991,74.32
1,12,2005,2017,0.0002484,0.0002208,73.34
1,13,2005,2018,0.0002934,0.0002583,72.35
1,14,2005,2019,0.0003624,0.0003186,71.37
1,15,2005,2020,0.0004596,0.0004055,70.40
1,16,2005,2021,0.0005802,0.0005144,69.42
1,17,2005,2022,0.0007098,0.0006305,68.46
1,18,2005,2023,0.0008321,0.0007389,67.50
1,19,2005,2024,0.0009391,0.0008309,66.55
1,20,2005,2025,0.0010297,0.0009049,65.61
1,21,2005,2026,0.0011033,0.0009604,64.67
1,22,2005,2027,0.0011584,0.0009983,63.73
1,23,2005,2028,0.0011978,0.0010246,62.79
1,24,2005,2029,0.0012275,0.0010429,61.85
1,25,2005,2030,0.0012521,0.0010512,60.92
1,26,2005,2031,0.0012759,0.0010565,59.98
1,27,2005,2032,0.0013058,0.0010688,59.04
1,28,2005,2033,0.0013446,0.0010963,58.11
1,29,2005,2034,0.0013859,0.0011223,57.17
1,30,2005,2035,0.0014216,0.0011345,56.23
1,31,2005,2036,0.0014530,0.0011407,55.30
1,32,2005,2037,0.0014859,0.0011483,54.36
1,33,2005,2038,0.0015203,0.0011529,53.42
1,34,2005,2039,0.0015540,0.0011492,52.48
1,35,2005,2040,0.0015941,0.0011412,51.54
1,36,2005,2041,0.0016525,0.0011491,50.60
1,37,2005,2042,0.0017318,0.0011744,49.66
1,38,2005,2043,0.0018255,0.0012203,48.72
1,39,2005,2044,0.0019305,0.0012825,47.78
1,40,2005,2045,0.0020513,0.0013593,46.84
1,41,2005,2046,0.0021897,0.0014509,45.90
1,42,2005,2047,0.0023342,0.0015460,44.97
1,43,2005,2048,0.0024669,0.0016264,44.03
1,44,2005,2049,0.0025867,0.0016843,43.11
1,45,2005,2050,0.0027191,0.0017288,42.18
1,46,2005,2051,0.0028925,0.0018066,41.25
1,47,2005,2052,0.0031101,0.0019206,40.32
1,48,2005,2053,0.0033571,0.0020643,39.40
1,49,2005,2054,0.0036304,0.0022200,38.48
1,50,2005,2055,0.0039379,0.0023774,37.56
1,51,2005,2056,0.0042708,0.0025390,36.65
1,52,2005,2057,0.0046082,0.0026954,35.75
1,53,2005,2058,0.0049489,0.0028338,34.84
1,54,2005,2059,0.0053157,0.0029832,33.94
1,55,2005,2060,0.0057365,0.0031564,33.04
1,56,2005,2061,0.0062406,0.0033977,32.14
1,57,2005,2062,0.0068502,0.0037232,31.25
1,58,2005,2063,0.0075521,0.0041287,30.36
1,59,2005,2064,0.0083035,0.0045513,29.49
1,60,2005,2065,0.0090849,0.0049514,28.62
1,61,2005,2066,0.0099105,0.0053415,27.76
1,62,2005,2067,0.0107829,0.0057280,26.91
1,63,2005,2068,0.0116995,0.0061231,26.06
1,64,2005,2069,0.0126957,0.0065635,25.22
1,65,2005,2070,0.0138071,0.0070588,24.38
1,66,2005,2071,0.0150054,0.0075894,23.55
1,67,2005,2072,0.0162315,0.0080741,22.73
1,68,2005,2073,0.0174919,0.0085113,21.91
1,69,2005,2074,0.0188954,0.0090035,21.09
1,70,2005,2075,0.0205786,0.0096546,20.28
1,71,2005,2076,0.0226142,0.0105733,19.47
1,72,2005,2077,0.0250119,0.0118063,18.67
1,73,2005,2078,0.0277519,0.0133409,17.89
1,74,2005,2079,0.0307579,0.0151054,17.12
1,75,2005,2080,0.0339099,0.0169195,16.38
1,76,2005,2081,0.0371478,0.0186753,15.65
1,77,2005,2082,0.0405123,0.0203773,14.94
1,78,2005,2083,0.0440886,0.0220928,14.24
1,79,2005,2084,0.0480027,0.0239317,13.55
1,80,2005,2085,0.0536037,0.0277049,12.87
1,81,2005,2086,0.0586892,0.0303784,12.22
1,82,2005,2087,0.0642414,0.0333219,11.59
1,83,2005,2088,0.0702997,0.0366162,10.97
1,84,2005,2089,0.0769067,0.0403166,10.37
1,85,2005,2090,0.0841076,0.0444270,9.79
1,86,2005,2091,0.0919504,0.0490216,9.22
1,87,2005,2092,0.1004863,0.0541946,8.67
1,88,2005,2093,0.1097689,0.0600205,8.14
1,89,2005,2094,0.1198550,0.0665180,7.62
1,90,2005,2095,0.1308036,0.0736959,7.13
1,91,2005,2096,0.1426766,0.0816433,6.66
1,92,2005,2097,0.1555375,0.0904910,6.21
1,93,2005,2098,0.1694519,0.1003437,5.78
1,94,2005,2099,0.1844867,0.1112427,5.36
1,95,2005,2100,0.2007091,0.1232457,4.97
1,96,2005,2101,0.2181866,0.1364986,4.60
1,97,2005,2102,0.2369856,0.1511844,4.25
1,98,2005,2103,0.2571705,0.1674433,3.92
1,99,2005,2104,0.2788028,0.1853308,3.60
1,100,2005,2105,0.3019394,0.2049276,3.31
1,101,2005,2106,0.3266317,0.2264216,3.04
1,102,2005,2107,0.3529236,0.2500325,2.78
1,103,2005,2108,0.3808502,0.2759131,2.54
1,104,2005,2109,0.4104359,0.3041029,2.31
1,105,2005,2110,0.4416930,0.3346639,2.11
1,106,2005,2111,0.4746198,0.3677653,1.91
1,107,2005,2112,0.5091990,0.4035845,1.74
1,108,2005,2113,0.5453968,0.4421983,1.57
1,109,2005,2114,0.5831612,0.4835445,1.42
1,110,2005,2115,0.6224217,0.5275619,1.28
1,111,2005,2116,0.6630882,0.5742639,1.15
1,112,2005,2117,0.7050519,0.6236263,1.03
1,113,2005,2118,0.7481851,0.6754956,0.91
1,114,2005,2119,0.7923424,0.7295941,0.77
1,115,2005,2120,1.0000000,1.0000000,0.50
1,0,2006,2006,0.0091950,0.0118864,84.18
1,1,2006,2007,0.0006668,0.0009248,84.20
1,2,2006,2008,0.0003367,0.0004403,83.27
1,3,2006,2009,0.0002291,0.0002828,82.31
1,4,2006,2010,0.0001930,0.0002233,81.33
1,5,2006,2011,0.0001870,0.0002031,80.35
1,6,2006,2012,0.0001837,0.0001896,79.37
1,7,2006,2013,0.0001828,0.0001810,78.38
1,8,2006,2014,0.0001845,0.0001762,77.40
1,9,2006,2015,0.0001904,0.0001756,76.41
1,10,2006,2016,0.0002017,0.0001809,75.42
1,11,2006,2017,0.0002200,0.0001932,74.44
1,12,2006,2018,0.0002484,0.0002152,73.45
1,13,2006,2019,0.0002934,0.0002523,72.47
1,14,2006,2020,0.0003624,0.0003118,71.48
1,15,2006,2021,0.0004596,0.0003981,70.51
1,16,2006,2022,0.0005802,0.0005069,69.53
1,17,2006,2023,0.0007098,0.0006231,68.57
1,18,2006,2024,0.0008321,0.0007308,67.61
1,19,2006,2025,0.0009391,0.0008215,66.66
1,20,2006,2026,0.0010297,0.0008947,65.72
1,21,2006,2027,0.0011033,0.0009504,64.77
1,22,2006,2028,0.0011584,0.0009887,63.83
1,23,2006,2029,0.0011978,0.0010146,62.90
1,24,2006,2030,0.0012275,0.0010320,61.96
1,25,2006,2031,0.0012521,0.0010399,61.02
1,26,2006,2032,0.0012759,0.0010457,60.09
1,27,2006,2033,0.0013058,0.0010586,59.15
1,28,2006,2034,0.0013446,0.0010859,58.21
1,29,2006,2035,0.0013859,0.0011109,57.27
1,30,2006,2036,0.0014216,0.0011224,56.34
1,31,2006,2037,0.0014530,0.0011290,55.40
1,32,2006,2038,0.0014859,0.0011371,54.46
1,33,2006,2039,0.0015203,0.0011410,53.52
1,34,2006,2040,0.0015540,0.0011356,52.58
1,35,2006,2041,0.0015941,0.0011265,51.64
1,36,2006,2042,0.0016525,0.0011346,50.70
1,37,2006,2043,0.0017318,0.0011602,49.76
1,38,2006,2044,0.0018255,0.0012051,48.82
1,39,2006,2045,0.0019305,0.0012655,47.87
1,40,2006,2046,0.0020513,0.0013413,46.93
1,41,2006,2047,0.0021897,0.0014333,46.00
1,42,2006,2048,0.0023342,0.0015291,45.06
1,43,2006,2049,0.0024669,0.0016084,44.13
1,44,2006,2050,0.0025867,0.0016640,43.20
1,45,2006,2051,0.0027191,0.0017069,42.27
1,46,2006,2052,0.0028925,0.0017847,41.34
1,47,2006,2053,0.0031101,0.0018989,40.42
1,48,2006,2054,0.0033571,0.0020403,39.49
1,49,2006,2055,0.0036304,0.0021922,38.57
1,50,2006,2056,0.0039379,0.0023469,37.66
1,51,2006,2057,0.0042708,0.0025082,36.74
1,52,2006,2058,0.0046082,0.0026649,35.83
1,53,2006,2059,0.0049489,0.0028005,34.93
1,54,2006,2060,0.0053157,0.0029445,34.02
1,55,2006,2061,0.0057365,0.0031139,33.12
1,56,2006,2062,0.0062406,0.0033548,32.23
1,57,2006,2063,0.0068502,0.0036804,31.33
1,58,2006,2064,0.0075521,0.0040814,30.45
1,59,2006,2065,0.0083035,0.0044959,29.57
1,60,2006,2066,0.0090849,0.0048903,28.70
1,61,2006,2067,0.0099105,0.0052794,27.84
1,62,2006,2068,0.0107829,0.0056657,26.98
1,63,2006,2069,0.0116995,0.0060538,26.14
1,64,2006,2070,0.0126957,0.0064823,25.29
1,65,2006,2071,0.0138071,0.0069696,24.45
1,66,2006,2072,0.0150054,0.0074994,23.62
1,67,2006,2073,0.0162315,0.0079854,22.80
1,68,2006,2074,0.0174919,0.0084152,21.98
1,69,2006,2075,0.0188954,0.0088919,21.16
1,70,2006,2076,0.0205786,0.0095316,20.34
1,71,2006,2077,0.0226142,0.0104477,19.53
1,72,2006,2078,0.0250119,0.0116790,18.73
1,73,2006,2079,0.0277519,0.0131978,17.95
1,74,2006,2080,0.0307579,0.0149359,17.18
1,75,2006,2081,0.0339099,0.0167323,16.44
1,76,2006,2082,0.0371478,0.0184857,15.71
1,77,2006,2083,0.0405123,0.0201888,14.99
1,78,2006,2084,0.0440886,0.0218855,14.29
1,79,2006,2085,0.0480027,0.0236889,13.60
1,80,2006,2086,0.0536037,0.0274357,12.92
1,81,2006,2087,0.0586892,0.0301046,12.27
1,82,2006,2088,0.0642414,0.0330474,11.64
1,83,2006,2089,0.0702997,0.0363114,11.02
1,84,2006,2090,0.0769067,0.0399587,10.41
1,85,2006,2091,0.0841076,0.0440330,9.82
1,86,2006,2092,0.0919504,0.0486230,9.25
1,87,2006,2093,0.1004863,0.0537982,8.70
1,88,2006,2094,0.1097689,0.0595847,8.17
1,89,2006,2095,0.1198550,0.0660103,7.65
1,90,2006,2096,0.1308036,0.0731412,7.16
1,91,2006,2097,0.1426766,0.0810867,6.68
1,92,2006,2098,0.1555375,0.0899435,6.23
1,93,2006,2099,0.1694519,0.0997493,5.80
1,94,2006,2100,0.1844867,0.1105574,5.38
1,95,2006,2101,0.2007091,0.1225041,4.99
1,96,2006,2102,0.2181866,0.1357619,4.62
1,97,2006,2103,0.2369856,0.1504645,4.26
1,98,2006,2104,0.2571705,0.1666661,3.93
1,99,2006,2105,0.2788028,0.1844458,3.62
1,100,2006,2106,0.3019394,0.2039861,3.32
1,101,2006,2107,0.3266317,0.2255039,3.04
1,102,2006,2108,0.3529236,0.2491553,2.79
1,103,2006,2109,0.3808502,0.2749897,2.54
1,104,2006,2110,0.4104359,0.3030795,2.32
1,105,2006,2111,0.4416930,0.3336072,2.11
1,106,2006,2112,0.4746198,0.3667705,1.92
1,107,2006,2113,0.5091990,0.4026746,1.74
1,108,2006,2114,0.5453968,0.4412891,1.57
1,109,2006,2115,0.5831612,0.4825883,1.42
1,110,2006,2116,0.6224217,0.5266290,1.28
1,111,2006,2117,0.6630882,0.5734404,1.15
1,112,2006,2118,0.7050519,0.6229239,1.03
1,113,2006,2119,0.7481851,0.6748486,0.91
1,114,2006,2120,0.7923424,0.7289852,0.77
1,115,2006,2121,1.0000000,1.0000000,0.50
1,0,2007,2007,0.0091950,0.0115960,84.33
1,1,2007,2008,0.0006668,0.0008882,84.32
1,2,2007,2009,0.0003367,0.0004186,83.39
1,3,2007,2010,0.0002291,0.0002670,82.43
1,4,2007,2011,0.0001930,0.0002111,81.45
1,5,2007,2012,0.0001870,0.0001935,80.47
1,6,2007,2013,0.0001837,0.0001818,79.48
1,7,2007,2014,0.0001828,0.0001740,78.50
1,8,2007,2015,0.0001845,0.0001692,77.51
1,9,2007,2016,0.0001904,0.0001690,76.52
1,10,2007,2017,0.0002017,0.0001749,75.54
1,11,2007,2018,0.0002200,0.0001878,74.55
1,12,2007,2019,0.0002484,0.0002097,73.56
1,13,2007,2020,0.0002934,0.0002461,72.58
1,14,2007,2021,0.0003624,0.0003049,71.60
1,15,2007,2022,0.0004596,0.0003913,70.62
1,16,2007,2023,0.0005802,0.0005001,69.64
1,17,2007,2024,0.0007098,0.0006156,68.68
1,18,2007,2025,0.0008321,0.0007220,67.72
1,19,2007,2026,0.0009391,0.0008120,66.77
1,20,2007,2027,0.0010297,0.0008853,65.82
1,21,2007,2028,0.0011033,0.0009412,64.88
1,22,2007,2029,0.0011584,0.0009789,63.94
1,23,2007,2030,0.0011978,0.0010038,63.00
1,24,2007,2031,0.0012275,0.0010210,62.07
1,25,2007,2032,0.0012521,0.0010294,61.13
1,26,2007,2033,0.0012759,0.0010357,60.19
1,27,2007,2034,0.0013058,0.0010483,59.25
1,28,2007,2035,0.0013446,0.0010747,58.32
1,29,2007,2036,0.0013859,0.0010993,57.38
1,30,2007,2037,0.0014216,0.0011112,56.44
1,31,2007,2038,0.0014530,0.0011182,55.50
1,32,2007,2039,0.0014859,0.0011258,54.56
1,33,2007,2040,0.0015203,0.0011282,53.63
1,34,2007,2041,0.0015540,0.0011219,52.69
1,35,2007,2042,0.0015941,0.0011129,51.74
1,36,2007,2043,0.0016525,0.0011213,50.80
1,37,2007,2044,0.0017318,0.0011458,49.86
1,38,2007,2045,0.0018255,0.0011889,48.91
1,39,2007,2046,0.0019305,0.0012483,47.97
1,40,2007,2047,0.0020513,0.0013245,47.03
1,41,2007,2048,0.0021897,0.0014172,46.09
1,42,2007,2049,0.0023342,0.0015119,45.16
1,43,2007,2050,0.0024669,0.0015890,44.23
1,44,2007,2051,0.0025867,0.0016434,43.30
1,45,2007,2052,0.0027191,0.0016864,42.37
1,46,2007,2053,0.0028925,0.0017645,41.44
1,47,2007,2054,0.0031101,0.0018766,40.51
1,48,2007,2055,0.0033571,0.0020145,39.58
1,49,2007,2056,0.0036304,0.0021641,38.66
1,50,2007,2057,0.0039379,0.0023186,37.75
1,51,2007,2058,0.0042708,0.0024800,36.83
1,52,2007,2059,0.0046082,0.0026341,35.92
1,53,2007,2060,0.0049489,0.0027646,35.02
1,54,2007,2061,0.0053157,0.0029053,34.11
1,55,2007,2062,0.0057365,0.0030745,33.21
1,56,2007,2063,0.0062406,0.0033156,32.31
1,57,2007,2064,0.0068502,0.0036370,31.42
1,58,2007,2065,0.0075521,0.0040305,30.53
1,59,2007,2066,0.0083035,0.0044398,29.65
1,60,2007,2067,0.0090849,0.0048334,28.78
1,61,2007,2068,0.0099105,0.0052222,27.92
1,62,2007,2069,0.0107829,0.0056020,27.06
1,63,2007,2070,0.0116995,0.0059790,26.21
1,64,2007,2071,0.0126957,0.0064002,25.37
1,65,2007,2072,0.0138071,0.0068867,24.53
1,66,2007,2073,0.0150054,0.0074176,23.69
1,67,2007,2074,0.0162315,0.0078967,22.87
1,68,2007,2075,0.0174919,0.0083122,22.04
1,69,2007,2076,0.0188954,0.0087791,21.22
1,70,2007,2077,0.0205786,0.0094170,20.41
1,71,2007,2078,0.0226142,0.0103319,19.60
1,72,2007,2079,0.0250119,0.0115488,18.80
1,73,2007,2080,0.0277519,0.0130430,18.01
1,74,2007,2081,0.0307579,0.0147643,17.24
1,75,2007,2082,0.0339099,0.0165579,16.49
1,76,2007,2083,0.0371478,0.0183121,15.76
1,77,2007,2084,0.0405123,0.0199979,15.05
1,78,2007,2085,0.0440886,0.0216621,14.34
1,79,2007,2086,0.0480027,0.0234427,13.65
1,80,2007,2087,0.0536037,0.0271844,12.97
1,81,2007,2088,0.0586892,0.0298525,12.31
1,82,2007,2089,0.0642414,0.0327673,11.68
1,83,2007,2090,0.0702997,0.0359819,11.06
1,84,2007,2091,0.0769067,0.0395954,10.45
1,85,2007,2092,0.0841076,0.0436649,9.86
1,86,2007,2093,0.0919504,0.0482562,9.29
1,87,2007,2094,0.1004863,0.0533942,8.73
1,88,2007,2095,0.1097689,0.0591133,8.20
1,89,2007,2096,0.1198550,0.0654944,7.68
1,90,2007,2097,0.1308036,0.0726226,7.19
1,91,2007,2098,0.1426766,0.0805755,6.71
1,92,2007,2099,0.1555375,0.0893872,6.25
1,93,2007,2100,0.1694519,0.0991064,5.82
1,94,2007,2101,0.1844867,0.1098598,5.40
1,95,2007,2102,0.2007091,0.1218090,5.01
1,96,2007,2103,0.2181866,0.1350804,4.63
1,97,2007,2104,0.2369856,0.1497261,4.28
1,98,2007,2105,0.2571705,0.1658219,3.94
1,99,2007,2106,0.2788028,0.1835436,3.63
1,100,2007,2107,0.3019394,0.2031023,3.33
1,101,2007,2108,0.3266317,0.2246545,3.05
1,102,2007,2109,0.3529236,0.2482556,2.79
1,103,2007,2110,0.3808502,0.2739856,2.55
1,104,2007,2111,0.4104359,0.3020347,2.33
1,105,2007,2112,0.4416930,0.3326149,2.12
1,106,2007,2113,0.4746198,0.3658538,1.92
1,107,2007,2114,0.5091990,0.4017482,1.74
1,108,2007,2115,0.5453968,0.4403021,1.58
1,109,2007,2116,0.5831612,0.4816106,1.43
1,110,2007,2117,0.6224217,0.5257504,1.29
1,111,2007,2118,0.6630882,0.5726746,1.16
1,112,2007,2119,0.7050519,0.6221991,1.03
1,113,2007,2120,0.7481851,0.6741424,0.91
1,114,2007,2121,0.7923424,0.7283621,0.77
1,115,2007,2122,1.0000000,1.0000000,0.50
1,0,2008,2008,0.0091949,0.0112688,84.48
1,1,2008,2009,0.0006668,0.0008415,84.44
1,2,2008,2010,0.0003367,0.0003944,83.51
1,3,2008,2011,0.0002291,0.0002517,82.54
1,4,2008,2012,0.0001930,0.0002002,81.56
1,5,2008,2013,0.0001870,0.0001850,80.58
1,6,2008,2014,0.0001837,0.0001742,79.60
1,7,2008,2015,0.0001828,0.0001666,78.61
1,8,2008,2016,0.0001845,0.0001623,77.62
1,9,2008,2017,0.0001904,0.0001630,76.64
1,10,2008,2018,0.0002017,0.0001696,75.65
1,11,2008,2019,0.0002200,0.0001825,74.66
1,12,2008,2020,0.0002484,0.0002038,73.67
1,13,2008,2021,0.0002934,0.0002398,72.69
1,14,2008,2022,0.0003624,0.0002987,71.71
1,15,2008,2023,0.0004596,0.0003850,70.73
1,16,2008,2024,0.0005802,0.0004932,69.75
1,17,2008,2025,0.0007098,0.0006075,68.79
1,18,2008,2026,0.0008321,0.0007131,67.83
1,19,2008,2027,0.0009391,0.0008031,66.88
1,20,2008,2028,0.0010297,0.0008766,65.93
1,21,2008,2029,0.0011033,0.0009319,64.99
1,22,2008,2030,0.0011584,0.0009684,64.05
1,23,2008,2031,0.0011978,0.0009930,63.11
1,24,2008,2032,0.0012275,0.0010108,62.17
1,25,2008,2033,0.0012521,0.0010198,61.24
1,26,2008,2034,0.0012759,0.0010257,60.30
1,27,2008,2035,0.0013058,0.0010372,59.36
1,28,2008,2036,0.0013446,0.0010634,58.42
1,29,2008,2037,0.0013859,0.0010885,57.48
1,30,2008,2038,0.0014216,0.0011009,56.54
1,31,2008,2039,0.0014530,0.0011073,55.61
1,32,2008,2040,0.0014859,0.0011136,54.67
1,33,2008,2041,0.0015203,0.0011152,53.73
1,34,2008,2042,0.0015540,0.0011091,52.79
1,35,2008,2043,0.0015941,0.0011004,51.84
1,36,2008,2044,0.0016525,0.0011079,50.90
1,37,2008,2045,0.0017318,0.0011305,49.96
1,38,2008,2046,0.0018255,0.0011725,49.01
1,39,2008,2047,0.0019305,0.0012323,48.07
1,40,2008,2048,0.0020513,0.0013092,47.13
1,41,2008,2049,0.0021897,0.0014009,46.19
1,42,2008,2050,0.0023342,0.0014934,45.25
1,43,2008,2051,0.0024669,0.0015694,44.32
1,44,2008,2052,0.0025867,0.0016242,43.39
1,45,2008,2053,0.0027191,0.0016675,42.46
1,46,2008,2054,0.0028925,0.0017437,41.53
1,47,2008,2055,0.0031101,0.0018524,40.60
1,48,2008,2056,0.0033571,0.0019883,39.68
1,49,2008,2057,0.0036304,0.0021379,38.75
1,50,2008,2058,0.0039379,0.0022926,37.84
1,51,2008,2059,0.0042708,0.0024515,36.92
1,52,2008,2060,0.0046082,0.0026009,36.01
1,53,2008,2061,0.0049489,0.0027284,35.10
1,54,2008,2062,0.0053157,0.0028689,34.20
1,55,2008,2063,0.0057365,0.0030384,33.29
1,56,2008,2064,0.0062406,0.0032758,32.39
1,57,2008,2065,0.0068502,0.0035904,31.50
1,58,2008,2066,0.0075521,0.0039791,30.61
1,59,2008,2067,0.0083035,0.0043876,29.73
1,60,2008,2068,0.0090849,0.0047809,28.86
1,61,2008,2069,0.0099105,0.0051638,28.00
1,62,2008,2070,0.0107829,0.0055332,27.14
1,63,2008,2071,0.0116995,0.0059034,26.29
1,64,2008,2072,0.0126957,0.0063239,25.44
1,65,2008,2073,0.0138071,0.0068113,24.60
1,66,2008,2074,0.0150054,0.0073357,23.76
1,67,2008,2075,0.0162315,0.0078015,22.94
1,68,2008,2076,0.0174919,0.0082081,22.11
1,69,2008,2077,0.0188954,0.0086739,21.29
1,70,2008,2078,0.0205786,0.0093113,20.47
1,71,2008,2079,0.0226142,0.0102134,19.66
1,72,2008,2080,0.0250119,0.0114081,18.86
1,73,2008,2081,0.0277519,0.0128865,18.07
1,74,2008,2082,0.0307579,0.0146044,17.30
1,75,2008,2083,0.0339099,0.0163983,16.55
1,76,2008,2084,0.0371478,0.0181363,15.82
1,77,2008,2085,0.0405123,0.0197923,15.10
1,78,2008,2086,0.0440886,0.0214358,14.39
1,79,2008,2087,0.0480027,0.0232131,13.70
1,80,2008,2088,0.0536037,0.0269530,13.01
1,81,2008,2089,0.0586892,0.0295954,12.36
1,82,2008,2090,0.0642414,0.0324645,11.72
1,83,2008,2091,0.0702997,0.0356476,11.10
1,84,2008,2092,0.0769067,0.0392562,10.49
1,85,2008,2093,0.0841076,0.0433264,9.90
1,86,2008,2094,0.0919504,0.0478827,9.32
1,87,2008,2095,0.1004863,0.0529575,8.77
1,88,2008,2096,0.1097689,0.0586344,8.23
1,89,2008,2097,0.1198550,0.0650121,7.71
1,90,2008,2098,0.1308036,0.0721463,7.21
1,91,2008,2099,0.1426766,0.0800562,6.73
1,92,2008,2100,0.1555375,0.0887857,6.28
1,93,2008,2101,0.1694519,0.0984522,5.84
1,94,2008,2102,0.1844867,0.1092062,5.42
1,95,2008,2103,0.2007091,0.1211663,5.03
1,96,2008,2104,0.2181866,0.1343817,4.65
1,97,2008,2105,0.2369856,0.1489243,4.29
1,98,2008,2106,0.2571705,0.1649615,3.96
1,99,2008,2107,0.2788028,0.1826970,3.64
1,100,2008,2108,0.3019394,0.2022845,3.34
1,101,2008,2109,0.3266317,0.2237834,3.06
1,102,2008,2110,0.3529236,0.2472775,2.80
1,103,2008,2111,0.3808502,0.2729607,2.56
1,104,2008,2112,0.4104359,0.3010537,2.33
1,105,2008,2113,0.4416930,0.3317007,2.12
1,106,2008,2114,0.4746198,0.3649207,1.93
1,107,2008,2115,0.5091990,0.4007428,1.75
1,108,2008,2116,0.5453968,0.4392932,1.58
1,109,2008,2117,0.5831612,0.4806902,1.43
1,110,2008,2118,0.6224217,0.5249336,1.29
1,111,2008,2119,0.6630882,0.5718846,1.16
1,112,2008,2120,0.7050519,0.6214083,1.04
1,113,2008,2121,0.7481851,0.6734197,0.92
1,114,2008,2122,0.7923424,0.7277751,0.77
1,115,2008,2123,1.0000000,1.0000000,0.50
1,0,2009,2009,0.0091949,0.0108454,84.64
1,1,2009,2010,0.0006668,0.0007897,84.56
1,2,2009,2011,0.0003367,0.0003711,83.63
1,3,2009,2012,0.0002291,0.0002381,82.66
1,4,2009,2013,0.0001930,0.0001907,81.68
1,5,2009,2014,0.0001870,0.0001767,80.70
1,6,2009,2015,0.0001837,0.0001663,79.71
1,7,2009,2016,0.0001828,0.0001593,78.72
1,8,2009,2017,0.0001845,0.0001561,77.74
1,9,2009,2018,0.0001904,0.0001576,76.75
1,10,2009,2019,0.0002017,0.0001644,75.76
1,11,2009,2020,0.0002200,0.0001769,74.77
1,12,2009,2021,0.0002484,0.0001980,73.78
1,13,2009,2022,0.0002934,0.0002340,72.80
1,14,2009,2023,0.0003624,0.0002929,71.82
1,15,2009,2024,0.0004596,0.0003787,70.84
1,16,2009,2025,0.0005802,0.0004858,69.86
1,17,2009,2026,0.0007098,0.0005993,68.90
1,18,2009,2027,0.0008321,0.0007049,67.94
1,19,2009,2028,0.0009391,0.0007950,66.99
1,20,2009,2029,0.0010297,0.0008678,66.04
1,21,2009,2030,0.0011033,0.0009218,65.10
1,22,2009,2031,0.0011584,0.0009578,64.16
1,23,2009,2032,0.0011978,0.0009828,63.22
1,24,2009,2033,0.0012275,0.0010014,62.28
1,25,2009,2034,0.0012521,0.0010101,61.34
1,26,2009,2035,0.0012759,0.0010149,60.40
1,27,2009,2036,0.0013058,0.0010259,59.46
1,28,2009,2037,0.0013446,0.0010528,58.52
1,29,2009,2038,0.0013859,0.0010786,57.58
1,30,2009,2039,0.0014216,0.0010904,56.65
1,31,2009,2040,0.0014530,0.0010955,55.71
1,32,2009,2041,0.0014859,0.0011012,54.77
1,33,2009,2042,0.0015203,0.0011032,53.83
1,34,2009,2043,0.0015540,0.0010974,52.89
1,35,2009,2044,0.0015941,0.0010878,51.94
1,36,2009,2045,0.0016525,0.0010935,51.00
1,37,2009,2046,0.0017318,0.0011149,50.06
1,38,2009,2047,0.0018255,0.0011572,49.11
1,39,2009,2048,0.0019305,0.0012176,48.17
1,40,2009,2049,0.0020513,0.0012935,47.22
1,41,2009,2050,0.0021897,0.0013832,46.29
1,42,2009,2051,0.0023342,0.0014747,45.35
1,43,2009,2052,0.0024669,0.0015511,44.41
1,44,2009,2053,0.0025867,0.0016064,43.48
1,45,2009,2054,0.0027191,0.0016480,42.55
1,46,2009,2055,0.0028925,0.0017212,41.62
1,47,2009,2056,0.0031101,0.0018280,40.69
1,48,2009,2057,0.0033571,0.0019640,39.77
1,49,2009,2058,0.0036304,0.0021141,38.84
1,50,2009,2059,0.0039379,0.0022665,37.92
1,51,2009,2060,0.0042708,0.0024209,37.01
1,52,2009,2061,0.0046082,0.0025674,36.10
1,53,2009,2062,0.0049489,0.0026946,35.19
1,54,2009,2063,0.0053157,0.0028356,34.28
1,55,2009,2064,0.0057365,0.0030018,33.38
1,56,2009,2065,0.0062406,0.0032331,32.48
1,57,2009,2066,0.0068502,0.0035433,31.58
1,58,2009,2067,0.0075521,0.0039312,30.69
1,59,2009,2068,0.0083035,0.0043395,29.81
1,60,2009,2069,0.0090849,0.0047273,28.94
1,61,2009,2070,0.0099105,0.0051007,28.08
1,62,2009,2071,0.0107829,0.0054637,27.22
1,63,2009,2072,0.0116995,0.0058331,26.36
1,64,2009,2073,0.0126957,0.0062546,25.52
1,65,2009,2074,0.0138071,0.0067359,24.67
1,66,2009,2075,0.0150054,0.0072479,23.84
1,67,2009,2076,0.0162315,0.0077053,23.01
1,68,2009,2077,0.0174919,0.0081111,22.18
1,69,2009,2078,0.0188954,0.0085771,21.36
1,70,2009,2079,0.0205786,0.0092033,20.54
1,71,2009,2080,0.0226142,0.0100855,19.73
1,72,2009,2081,0.0250119,0.0112658,18.92
1,73,2009,2082,0.0277519,0.0127408,18.13
1,74,2009,2083,0.0307579,0.0144582,17.36
1,75,2009,2084,0.0339099,0.0162367,16.61
1,76,2009,2085,0.0371478,0.0179470,15.87
1,77,2009,2086,0.0405123,0.0195839,15.15
1,78,2009,2087,0.0440886,0.0212246,14.45
1,79,2009,2088,0.0480027,0.0230019,13.75
1,80,2009,2089,0.0536037,0.0267170,13.06
1,81,2009,2090,0.0586892,0.0293174,12.40
1,82,2009,2091,0.0642414,0.0321573,11.76
1,83,2009,2092,0.0702997,0.0353354,11.14
1,84,2009,2093,0.0769067,0.0389442,10.53
1,85,2009,2094,0.0841076,0.0429816,9.93
1,86,2009,2095,0.0919504,0.0474789,9.36
1,87,2009,2096,0.1004863,0.0525139,8.80
1,88,2009,2097,0.1097689,0.0581868,8.26
1,89,2009,2098,0.1198550,0.0645693,7.74
1,90,2009,2099,0.1308036,0.0716627,7.24
1,91,2009,2100,0.1426766,0.0794948,6.76
1,92,2009,2101,0.1555375,0.0881738,6.30
1,93,2009,2102,0.1694519,0.0978393,5.86
1,94,2009,2103,0.1844867,0.1086019,5.44
1,95,2009,2104,0.2007091,0.1205074,5.04
1,96,2009,2105,0.2181866,0.1336231,4.67
1,97,2009,2106,0.2369856,0.1481073,4.31
1,98,2009,2107,0.2571705,0.1641544,3.97
1,99,2009,2108,0.2788028,0.1819139,3.65
1,100,2009,2109,0.3019394,0.2014462,3.35
1,101,2009,2110,0.3266317,0.2228368,3.07
1,102,2009,2111,0.3529236,0.2462794,2.81
1,103,2009,2112,0.3808502,0.2719988,2.57
1,104,2009,2113,0.4104359,0.3001502,2.34
1,105,2009,2114,0.4416930,0.3307704,2.13
1,106,2009,2115,0.4746198,0.3639083,1.93
1,107,2009,2116,0.5091990,0.3997153,1.75
1,108,2009,2117,0.5453968,0.4383436,1.58
1,109,2009,2118,0.5831612,0.4798346,1.43
1,110,2009,2119,0.6224217,0.5240911,1.29
1,111,2009,2120,0.6630882,0.5710228,1.16
1,112,2009,2121,0.7050519,0.6205992,1.04
1,113,2009,2122,0.7481851,0.6727391,0.92
1,114,2009,2123,0.7923424,0.7272308,0.77
1,115,2009,2124,1.0000000,1.0000000,0.50
1,0,2010,2010,0.0091948,0.0103671,84.80
1,1,2010,2011,0.0006668,0.0007399,84.68
1,2,2010,2012,0.0003367,0.0003504,83.75
1,3,2010,2013,0.0002291,0.0002262,82.78
1,4,2010,2014,0.0001930,0.0001814,81.79
1,5,2010,2015,0.0001870,0.0001680,80.81
1,6,2010,2016,0.0001837,0.0001585,79.82
1,7,2010,2017,0.0001828,0.0001528,78.83
1,8,2010,2018,0.0001845,0.0001505,77.85
1,9,2010,2019,0.0001904,0.0001523,76.86
1,10,2010,2020,0.0002017,0.0001588,75.87
1,11,2010,2021,0.0002200,0.0001713,74.88
1,12,2010,2022,0.0002484,0.0001926,73.89
1,13,2010,2023,0.0002934,0.0002288,72.91
1,14,2010,2024,0.0003624,0.0002872,71.93
1,15,2010,2025,0.0004596,0.0003719,70.95
1,16,2010,2026,0.0005802,0.0004784,69.97
1,17,2010,2027,0.0007098,0.0005917,69.01
1,18,2010,2028,0.0008321,0.0006973,68.05
1,19,2010,2029,0.0009391,0.0007867,67.09
1,20,2010,2030,0.0010297,0.0008584,66.15
1,21,2010,2031,0.0011033,0.0009117,65.20
1,22,2010,2032,0.0011584,0.0009479,64.26
1,23,2010,2033,0.0011978,0.0009736,63.32
1,24,2010,2034,0.0012275,0.0009920,62.38
1,25,2010,2035,0.0012521,0.0009996,61.44
1,26,2010,2036,0.0012759,0.0010039,60.51
1,27,2010,2037,0.0013058,0.0010154,59.57
1,28,2010,2038,0.0013446,0.0010431,58.63
1,29,2010,2039,0.0013859,0.0010685,57.69
1,30,2010,2040,0.0014216,0.0010790,56.75
1,31,2010,2041,0.0014530,0.0010836,55.81
1,32,2010,2042,0.0014859,0.0010896,54.87
1,33,2010,2043,0.0015203,0.0010921,53.93
1,34,2010,2044,0.0015540,0.0010857,52.99
1,35,2010,2045,0.0015941,0.0010743,52.04
1,36,2010,2046,0.0016525,0.0010789,51.10
1,37,2010,2047,0.0017318,0.0011005,50.15
1,38,2010,2048,0.0018255,0.0011432,49.21
1,39,2010,2049,0.0019305,0.0012027,48.26
1,40,2010,2050,0.0020513,0.0012767,47.32
1,41,2010,2051,0.0021897,0.0013654,46.38
1,42,2010,2052,0.0023342,0.0014573,45.44
1,43,2010,2053,0.0024669,0.0015342,44.51
1,44,2010,2054,0.0025867,0.0015882,43.58
1,45,2010,2055,0.0027191,0.0016270,42.65
1,46,2010,2056,0.0028925,0.0016985,41.71
1,47,2010,2057,0.0031101,0.0018054,40.78
1,48,2010,2058,0.0033571,0.0019418,39.86
1,49,2010,2059,0.0036304,0.0020899,38.93
1,50,2010,2060,0.0039379,0.0022383,38.01
1,51,2010,2061,0.0042708,0.0023900,37.10
1,52,2010,2062,0.0046082,0.0025363,36.19
1,53,2010,2063,0.0049489,0.0026638,35.28
1,54,2010,2064,0.0053157,0.0028018,34.37
1,55,2010,2065,0.0057365,0.0029624,33.46
1,56,2010,2066,0.0062406,0.0031899,32.56
1,57,2010,2067,0.0068502,0.0034994,31.67
1,58,2010,2068,0.0075521,0.0038871,30.77
1,59,2010,2069,0.0083035,0.0042903,29.89
1,60,2010,2070,0.0090849,0.0046694,29.02
1,61,2010,2071,0.0099105,0.0050368,28.15
1,62,2010,2072,0.0107829,0.0053991,27.29
1,63,2010,2073,0.0116995,0.0057693,26.44
1,64,2010,2074,0.0126957,0.0061852,25.59
1,65,2010,2075,0.0138071,0.0066551,24.75
1,66,2010,2076,0.0150054,0.0071591,23.91
1,67,2010,2077,0.0162315,0.0076157,23.08
1,68,2010,2078,0.0174919,0.0080217,22.25
1,69,2010,2079,0.0188954,0.0084779,21.43
1,70,2010,2080,0.0205786,0.0090866,20.60
1,71,2010,2081,0.0226142,0.0099562,19.79
1,72,2010,2082,0.0250119,0.0111334,18.98
1,73,2010,2083,0.0277519,0.0126075,18.19
1,74,2010,2084,0.0307579,0.0143103,17.42
1,75,2010,2085,0.0339099,0.0160627,16.66
1,76,2010,2086,0.0371478,0.0177552,15.93
1,77,2010,2087,0.0405123,0.0193895,15.21
1,78,2010,2088,0.0440886,0.0210304,14.50
1,79,2010,2089,0.0480027,0.0227865,13.80
1,80,2010,2090,0.0536037,0.0264620,13.11
1,81,2010,2091,0.0586892,0.0290355,12.45
1,82,2010,2092,0.0642414,0.0318705,11.81
1,83,2010,2093,0.0702997,0.0350483,11.18
1,84,2010,2094,0.0769067,0.0386265,10.57
1,85,2010,2095,0.0841076,0.0426090,9.97
1,86,2010,2096,0.0919504,0.0470689,9.39
1,87,2010,2097,0.1004863,0.0520994,8.83
1,88,2010,2098,0.1097689,0.0577760,8.29
1,89,2010,2099,0.1198550,0.0641198,7.77
1,90,2010,2100,0.1308036,0.0711400,7.27
1,91,2010,2101,0.1426766,0.0789240,6.78
1,92,2010,2102,0.1555375,0.0876008,6.32
1,93,2010,2103,0.1694519,0.0972729,5.88
1,94,2010,2104,0.1844867,0.1079826,5.46
1,95,2010,2105,0.2007091,0.1197923,5.06
1,96,2010,2106,0.2181866,0.1328505,4.68
1,97,2010,2107,0.2369856,0.1473413,4.32
1,98,2010,2108,0.2571705,0.1634081,3.98
1,99,2010,2109,0.2788028,0.1811113,3.66
1,100,2010,2110,0.3019394,0.2005354,3.36
1,101,2010,2111,0.3266317,0.2218712,3.08
1,102,2010,2112,0.3529236,0.2453430,2.82
1,103,2010,2113,0.3808502,0.2711131,2.57
1,104,2010,2114,0.4104359,0.2992312,2.35
1,105,2010,2115,0.4416930,0.3297614,2.13
1,106,2010,2116,0.4746198,0.3628740,1.94
1,107,2010,2117,0.5091990,0.3987485,1.76
1,108,2010,2118,0.5453968,0.4374610,1.59
1,109,2010,2119,0.5831612,0.4789523,1.43
1,110,2010,2120,0.6224217,0.5231723,1.29
1,111,2010,2121,0.6630882,0.5701413,1.16
1,112,2010,2122,0.7050519,0.6198374,1.04
1,113,2010,2123,0.7481851,0.6721081,0.92
1,114,2010,2124,0.7923424,0.7266721,0.77
1,115,2010,2125,1.0000000,1.0000000,0.50
1,0,2011,2011,0.0091947,0.0098990,84.96
1,1,2011,2012,0.0006668,0.0006959,84.80
1,2,2011,2013,0.0003367,0.0003323,83.86
1,3,2011,2014,0.0002291,0.0002146,82.89
1,4,2011,2015,0.0001930,0.0001718,81.91
1,5,2011,2016,0.0001870,0.0001596,80.92
1,6,2011,2017,0.0001837,0.0001516,79.93
1,7,2011,2018,0.0001828,0.0001470,78.95
1,8,2011,2019,0.0001845,0.0001451,77.96
1,9,2011,2020,0.0001904,0.0001467,76.97
1,10,2011,2021,0.0002017,0.0001534,75.98
1,11,2011,2022,0.0002200,0.0001662,74.99
1,12,2011,2023,0.0002484,0.0001878,74.00
1,13,2011,2024,0.0002934,0.0002235,73.02
1,14,2011,2025,0.0003624,0.0002810,72.03
1,15,2011,2026,0.0004596,0.0003651,71.05
1,16,2011,2027,0.0005802,0.0004714,70.08
1,17,2011,2028,0.0007098,0.0005847,69.11
1,18,2011,2029,0.0008321,0.0006896,68.15
1,19,2011,2030,0.0009391,0.0007778,67.20
1,20,2011,2031,0.0010297,0.0008488,66.25
1,21,2011,2032,0.0011033,0.0009022,65.31
1,22,2011,2033,0.0011584,0.0009388,64.37
1,23,2011,2034,0.0011978,0.0009642,63.43
1,24,2011,2035,0.0012275,0.0009818,62.49
1,25,2011,2036,0.0012521,0.0009890,61.55
1,26,2011,2037,0.0012759,0.0009937,60.61
1,27,2011,2038,0.0013058,0.0010058,59.67
1,28,2011,2039,0.0013446,0.0010332,58.73
1,29,2011,2040,0.0013859,0.0010576,57.79
1,30,2011,2041,0.0014216,0.0010676,56.85
1,31,2011,2042,0.0014530,0.0010725,55.91
1,32,2011,2043,0.0014859,0.0010791,54.97
1,33,2011,2044,0.0015203,0.0010810,54.03
1,34,2011,2045,0.0015540,0.0010730,53.09
1,35,2011,2046,0.0015941,0.0010606,52.14
1,36,2011,2047,0.0016525,0.0010654,51.20
1,37,2011,2048,0.0017318,0.0010873,50.25
1,38,2011,2049,0.0018255,0.0011290,49.30
1,39,2011,2050,0.0019305,0.0011867,48.36
1,40,2011,2051,0.0020513,0.0012598,47.42
1,41,2011,2052,0.0021897,0.0013488,46.48
1,42,2011,2053,0.0023342,0.0014412,45.54
1,43,2011,2054,0.0024669,0.0015169,44.60
1,44,2011,2055,0.0025867,0.0015685,43.67
1,45,2011,2056,0.0027191,0.0016058,42.74
1,46,2011,2057,0.0028925,0.0016774,41.81
1,47,2011,2058,0.0031101,0.0017846,40.88
1,48,2011,2059,0.0033571,0.0019194,39.95
1,49,2011,2060,0.0036304,0.0020640,39.02
1,50,2011,2061,0.0039379,0.0022098,38.10
1,51,2011,2062,0.0042708,0.0023612,37.19
1,52,2011,2063,0.0046082,0.0025077,36.27
1,53,2011,2064,0.0049489,0.0026325,35.36
1,54,2011,2065,0.0053157,0.0027655,34.46
1,55,2011,2066,0.0057365,0.0029226,33.55
1,56,2011,2067,0.0062406,0.0031497,32.65
1,57,2011,2068,0.0068502,0.0034590,31.75
1,58,2011,2069,0.0075521,0.0038420,30.86
1,59,2011,2070,0.0083035,0.0042372,29.97
1,60,2011,2071,0.0090849,0.0046109,29.10
1,61,2011,2072,0.0099105,0.0049775,28.23
1,62,2011,2073,0.0107829,0.0053404,27.37
1,63,2011,2074,0.0116995,0.0057054,26.51
1,64,2011,2075,0.0126957,0.0061109,25.66
1,65,2011,2076,0.0138071,0.0065734,24.82
1,66,2011,2077,0.0150054,0.0070764,23.98
1,67,2011,2078,0.0162315,0.0075330,23.15
1,68,2011,2079,0.0174919,0.0079302,22.32
1,69,2011,2080,0.0188954,0.0083709,21.49
1,70,2011,2081,0.0205786,0.0089687,20.67
1,71,2011,2082,0.0226142,0.0098359,19.85
1,72,2011,2083,0.0250119,0.0110124,19.04
1,73,2011,2084,0.0277519,0.0124727,18.25
1,74,2011,2085,0.0307579,0.0141510,17.48
1,75,2011,2086,0.0339099,0.0158865,16.72
1,76,2011,2087,0.0371478,0.0175763,15.98
1,77,2011,2088,0.0405123,0.0192107,15.26
1,78,2011,2089,0.0440886,0.0208323,14.55
1,79,2011,2090,0.0480027,0.0225539,13.85
1,80,2011,2091,0.0536037,0.0262033,13.15
1,81,2011,2092,0.0586892,0.0287723,12.49
1,82,2011,2093,0.0642414,0.0316069,11.85
1,83,2011,2094,0.0702997,0.0347561,11.22
1,84,2011,2095,0.0769067,0.0382833,10.61
1,85,2011,2096,0.0841076,0.0422307,10.01
1,86,2011,2097,0.0919504,0.0466859,9.43
1,87,2011,2098,0.1004863,0.0517191,8.86
1,88,2011,2099,0.1097689,0.0573590,8.32
1,89,2011,2100,0.1198550,0.0636341,7.80
1,90,2011,2101,0.1308036,0.0706086,7.29
1,91,2011,2102,0.1426766,0.0783895,6.81
1,92,2011,2103,0.1555375,0.0870713,6.35
1,93,2011,2104,0.1694519,0.0966926,5.90
1,94,2011,2105,0.1844867,0.1073108,5.48
1,95,2011,2106,0.2007091,0.1190642,5.08
1,96,2011,2107,0.2181866,0.1321262,4.70
1,97,2011,2108,0.2369856,0.1466331,4.34
1,98,2011,2109,0.2571705,0.1626434,4.00
1,99,2011,2110,0.2788028,0.1802396,3.68
1,100,2011,2111,0.3019394,0.1996067,3.38
1,101,2011,2112,0.3266317,0.2209654,3.09
1,102,2011,2113,0.3529236,0.2444810,2.83
1,103,2011,2114,0.3808502,0.2702124,2.58
1,104,2011,2115,0.4104359,0.2982346,2.35
1,105,2011,2116,0.4416930,0.3287309,2.14
1,106,2011,2117,0.4746198,0.3619011,1.94
1,107,2011,2118,0.5091990,0.3978502,1.76
1,108,2011,2119,0.5453968,0.4365512,1.59
1,109,2011,2120,0.5831612,0.4779902,1.44
1,110,2011,2121,0.6224217,0.5222325,1.29
1,111,2011,2122,0.6630882,0.5693114,1.16
1,112,2011,2123,0.7050519,0.6191312,1.04
1,113,2011,2124,0.7481851,0.6714604,0.92
1,114,2011,2125,0.7923424,0.7260633,0.77
1,115,2011,2126,1.0000000,1.0000000,0.50
1,0,2012,2012,0.0091947,0.0094775,85.11
1,1,2012,2013,0.0006668,0.0006575,84.92
1,2,2012,2014,0.0003367,0.0003148,83.98
1,3,2012,2015,0.0002291,0.0002027,83.00
1,4,2012,2016,0.0001930,0.0001625,82.02
1,5,2012,2017,0.0001870,0.0001521,81.03
1,6,2012,2018,0.0001837,0.0001454,80.05
1,7,2012,2019,0.0001828,0.0001413,79.06
1,8,2012,2020,0.0001845,0.0001393,78.07
1,9,2012,2021,0.0001904,0.0001412,77.08
1,10,2012,2022,0.0002017,0.0001484,76.09
1,11,2012,2023,0.0002200,0.0001616,75.10
1,12,2012,2024,0.0002484,0.0001829,74.11
1,13,2012,2025,0.0002934,0.0002180,73.13
1,14,2012,2026,0.0003624,0.0002749,72.14
1,15,2012,2027,0.0004596,0.0003588,71.16
1,16,2012,2028,0.0005802,0.0004651,70.19
1,17,2012,2029,0.0007098,0.0005776,69.22
1,18,2012,2030,0.0008321,0.0006814,68.26
1,19,2012,2031,0.0009391,0.0007689,67.31
1,20,2012,2032,0.0010297,0.0008399,66.36
1,21,2012,2033,0.0011033,0.0008936,65.41
1,22,2012,2034,0.0011584,0.0009296,64.47
1,23,2012,2035,0.0011978,0.0009541,63.53
1,24,2012,2036,0.0012275,0.0009714,62.59
1,25,2012,2037,0.0012521,0.0009791,61.65
1,26,2012,2038,0.0012759,0.0009844,60.71
1,27,2012,2039,0.0013058,0.0009960,59.77
1,28,2012,2040,0.0013446,0.0010226,58.83
1,29,2012,2041,0.0013859,0.0010466,57.89
1,30,2012,2042,0.0014216,0.0010569,56.95
1,31,2012,2043,0.0014530,0.0010623,56.01
1,32,2012,2044,0.0014859,0.0010684,55.07
1,33,2012,2045,0.0015203,0.0010690,54.13
1,34,2012,2046,0.0015540,0.0010602,53.18
1,35,2012,2047,0.0015941,0.0010479,52.24
1,36,2012,2048,0.0016525,0.0010530,51.29
1,37,2012,2049,0.0017318,0.0010738,50.35
1,38,2012,2050,0.0018255,0.0011137,49.40
1,39,2012,2051,0.0019305,0.0011705,48.46
1,40,2012,2052,0.0020513,0.0012439,47.51
1,41,2012,2053,0.0021897,0.0013334,46.57
1,42,2012,2054,0.0023342,0.0014246,45.63
1,43,2012,2055,0.0024669,0.0014981,44.70
1,44,2012,2056,0.0025867,0.0015485,43.76
1,45,2012,2057,0.0027191,0.0015861,42.83
1,46,2012,2058,0.0028925,0.0016582,41.90
1,47,2012,2059,0.0031101,0.0017637,40.97
1,48,2012,2060,0.0033571,0.0018952,40.04
1,49,2012,2061,0.0036304,0.0020377,39.11
1,50,2012,2062,0.0039379,0.0021833,38.19
1,51,2012,2063,0.0042708,0.0023349,37.27
1,52,2012,2064,0.0046082,0.0024788,36.36
1,53,2012,2065,0.0049489,0.0025989,35.45
1,54,2012,2066,0.0053157,0.0027287,34.54
1,55,2012,2067,0.0057365,0.0028856,33.63
1,56,2012,2068,0.0062406,0.0031127,32.73
1,57,2012,2069,0.0068502,0.0034178,31.83
1,58,2012,2070,0.0075521,0.0037933,30.94
1,59,2012,2071,0.0083035,0.0041835,30.05
1,60,2012,2072,0.0090849,0.0045565,29.18
1,61,2012,2073,0.0099105,0.0049237,28.31
1,62,2012,2074,0.0107829,0.0052816,27.45
1,63,2012,2075,0.0116995,0.0056370,26.59
1,64,2012,2076,0.0126957,0.0060357,25.74
1,65,2012,2077,0.0138071,0.0064972,24.89
1,66,2012,2078,0.0150054,0.0070001,24.05
1,67,2012,2079,0.0162315,0.0074484,23.22
1,68,2012,2080,0.0174919,0.0078314,22.39
1,69,2012,2081,0.0188954,0.0082627,21.56
1,70,2012,2082,0.0205786,0.0088590,20.73
1,71,2012,2083,0.0226142,0.0097260,19.92
1,72,2012,2084,0.0250119,0.0108901,19.11
1,73,2012,2085,0.0277519,0.0123277,18.31
1,74,2012,2086,0.0307579,0.0139898,17.53
1,75,2012,2087,0.0339099,0.0157221,16.78
1,76,2012,2088,0.0371478,0.0174118,16.04
1,77,2012,2089,0.0405123,0.0190285,15.31
1,78,2012,2090,0.0440886,0.0206185,14.60
1,79,2012,2091,0.0480027,0.0223182,13.89
1,80,2012,2092,0.0536037,0.0259619,13.20
1,81,2012,2093,0.0586892,0.0285305,12.54
1,82,2012,2094,0.0642414,0.0313385,11.89
1,83,2012,2095,0.0702997,0.0344405,11.26
1,84,2012,2096,0.0769067,0.0379350,10.64
1,85,2012,2097,0.0841076,0.0418775,10.04
1,86,2012,2098,0.0919504,0.0463346,9.46
1,87,2012,2099,0.1004863,0.0513332,8.90
1,88,2012,2100,0.1097689,0.0569087,8.35
1,89,2012,2101,0.1198550,0.0631406,7.83
1,90,2012,2102,0.1308036,0.0701113,7.32
1,91,2012,2103,0.1426766,0.0778959,6.83
1,92,2012,2104,0.1555375,0.0865291,6.37
1,93,2012,2105,0.1694519,0.0960632,5.92
1,94,2012,2106,0.1844867,0.1066269,5.50
1,95,2012,2107,0.2007091,0.1183819,5.10
1,96,2012,2108,0.2181866,0.1314568,4.72
1,97,2012,2109,0.2369856,0.1459076,4.35
1,98,2012,2110,0.2571705,0.1618131,4.01
1,99,2012,2111,0.2788028,0.1793510,3.69
1,100,2012,2112,0.3019394,0.1987358,3.39
1,101,2012,2113,0.3266317,0.2201320,3.10
1,102,2012,2114,0.3529236,0.2436047,2.84
1,103,2012,2115,0.3808502,0.2692360,2.59
1,104,2012,2116,0.4104359,0.2972170,2.36
1,105,2012,2117,0.4416930,0.3277617,2.14
1,106,2012,2118,0.4746198,0.3609973,1.95
1,107,2012,2119,0.5091990,0.3969244,1.76
1,108,2012,2120,0.5453968,0.4355594,1.59
1,109,2012,2121,0.5831612,0.4770066,1.44
1,110,2012,2122,0.6224217,0.5213482,1.30
1,111,2012,2123,0.6630882,0.5685422,1.17
1,112,2012,2124,0.7050519,0.6184064,1.04
1,113,2012,2125,0.7481851,0.6707547,0.92
1,114,2012,2126,0.7923424,0.7254401,0.77
1,115,2012,2127,1.0000000,1.0000000,0.50
1,0,2013,2013,0.0091946,0.0091034,85.26
1,1,2013,2014,0.0006668,0.0006205,85.04
1,2,2013,2015,0.0003367,0.0002968,84.09
1,3,2013,2016,0.0002291,0.0001912,83.12
1,4,2013,2017,0.0001930,0.0001541,82.13
1,5,2013,2018,0.0001870,0.0001455,81.15
1,6,2013,2019,0.0001837,0.0001393,80.16
1,7,2013,2020,0.0001828,0.0001353,79.17
1,8,2013,2021,0.0001845,0.0001337,78.18
1,9,2013,2022,0.0001904,0.0001361,77.19
1,10,2013,2023,0.0002017,0.0001439,76.20
1,11,2013,2024,0.0002200,0.0001570,75.21
1,12,2013,2025,0.0002484,0.0001778,74.22
1,13,2013,2026,0.0002934,0.0002124,73.24
1,14,2013,2027,0.0003624,0.0002692,72.25
1,15,2013,2028,0.0004596,0.0003531,71.27
1,16,2013,2029,0.0005802,0.0004587,70.30
1,17,2013,2030,0.0007098,0.0005701,69.33
1,18,2013,2031,0.0008321,0.0006730,68.37
1,19,2013,2032,0.0009391,0.0007605,67.41
1,20,2013,2033,0.0010297,0.0008317,66.46
1,21,2013,2034,0.0011033,0.0008848,65.52
1,22,2013,2035,0.0011584,0.0009197,64.58
1,23,2013,2036,0.0011978,0.0009439,63.64
1,24,2013,2037,0.0012275,0.0009618,62.69
1,25,2013,2038,0.0012521,0.0009700,61.75
1,26,2013,2039,0.0012759,0.0009748,60.81
1,27,2013,2040,0.0013058,0.0009855,59.87
1,28,2013,2041,0.0013446,0.0010118,58.93
1,29,2013,2042,0.0013859,0.0010363,57.99
1,30,2013,2043,0.0014216,0.0010471,57.05
1,31,2013,2044,0.0014530,0.0010521,56.11
1,32,2013,2045,0.0014859,0.0010570,55.17
1,33,2013,2046,0.0015203,0.0010568,54.23
1,34,2013,2047,0.0015540,0.0010482,53.28
1,35,2013,2048,0.0015941,0.0010363,52.34
1,36,2013,2049,0.0016525,0.0010404,51.39
1,37,2013,2050,0.0017318,0.0010594,50.45
1,38,2013,2051,0.0018255,0.0010983,49.50
1,39,2013,2052,0.0019305,0.0011554,48.55
1,40,2013,2053,0.0020513,0.0012293,47.61
1,41,2013,2054,0.0021897,0.0013177,46.67
1,42,2013,2055,0.0023342,0.0014067,45.73
1,43,2013,2056,0.0024669,0.0014791,44.79
1,44,2013,2057,0.0025867,0.0015300,43.86
1,45,2013,2058,0.0027191,0.0015680,42.92
1,46,2013,2059,0.0028925,0.0016387,41.99
1,47,2013,2060,0.0031101,0.0017412,41.06
1,48,2013,2061,0.0033571,0.0018708,40.13
1,49,2013,2062,0.0036304,0.0020133,39.20
1,50,2013,2063,0.0039379,0.0021591,38.28
1,51,2013,2064,0.0042708,0.0023081,37.36
1,52,2013,2065,0.0046082,0.0024477,36.45
1,53,2013,2066,0.0049489,0.0025649,35.54
1,54,2013,2067,0.0053157,0.0026946,34.63
1,55,2013,2068,0.0057365,0.0028516,33.72
1,56,2013,2069,0.0062406,0.0030749,32.81
1,57,2013,2070,0.0068502,0.0033732,31.91
1,58,2013,2071,0.0075521,0.0037442,31.02
1,59,2013,2072,0.0083035,0.0041336,30.13
1,60,2013,2073,0.0090849,0.0045070,29.26
1,61,2013,2074,0.0099105,0.0048697,28.39
1,62,2013,2075,0.0107829,0.0052186,27.52
1,63,2013,2076,0.0116995,0.0055677,26.66
1,64,2013,2077,0.0126957,0.0059656,25.81
1,65,2013,2078,0.0138071,0.0064270,24.96
1,66,2013,2079,0.0150054,0.0069221,24.12
1,67,2013,2080,0.0162315,0.0073570,23.29
1,68,2013,2081,0.0174919,0.0077315,22.45
1,69,2013,2082,0.0188954,0.0081621,21.63
1,70,2013,2083,0.0205786,0.0087588,20.80
1,71,2013,2084,0.0226142,0.0096149,19.98
1,72,2013,2085,0.0250119,0.0107585,19.17
1,73,2013,2086,0.0277519,0.0121810,18.37
1,74,2013,2087,0.0307579,0.0138395,17.59
1,75,2013,2088,0.0339099,0.0155710,16.83
1,76,2013,2089,0.0371478,0.0172441,16.09
1,77,2013,2090,0.0405123,0.0188317,15.36
1,78,2013,2091,0.0440886,0.0204018,14.65
1,79,2013,2092,0.0480027,0.0220984,13.94
1,80,2013,2093,0.0536037,0.0257401,13.25
1,81,2013,2094,0.0586892,0.0282843,12.58
1,82,2013,2095,0.0642414,0.0310487,11.94
1,83,2013,2096,0.0702997,0.0341202,11.30
1,84,2013,2097,0.0769067,0.0376098,10.68
1,85,2013,2098,0.0841076,0.0415536,10.08
1,86,2013,2099,0.0919504,0.0459782,9.50
1,87,2013,2100,0.1004863,0.0509166,8.93
1,88,2013,2101,0.1097689,0.0564512,8.38
1,89,2013,2102,0.1198550,0.0626788,7.85
1,90,2013,2103,0.1308036,0.0696521,7.35
1,91,2013,2104,0.1426766,0.0773904,6.86
1,92,2013,2105,0.1555375,0.0859411,6.39
1,93,2013,2106,0.1694519,0.0954229,5.95
1,94,2013,2107,0.1844867,0.1059862,5.52
1,95,2013,2108,0.2007091,0.1177515,5.12
1,96,2013,2109,0.2181866,0.1307714,4.73
1,97,2013,2110,0.2369856,0.1451203,4.37
1,98,2013,2111,0.2571705,0.1609671,4.02
1,99,2013,2112,0.2788028,0.1785181,3.70
1,100,2013,2113,0.3019394,0.1979347,3.40
1,101,2013,2114,0.3266317,0.2192850,3.11
1,102,2013,2115,0.3529236,0.2426550,2.85
1,103,2013,2116,0.3808502,0.2682393,2.60
1,104,2013,2117,0.4104359,0.2962603,2.36
1,105,2013,2118,0.4416930,0.3268617,2.15
1,106,2013,2119,0.4746198,0.3600661,1.95
1,107,2013,2120,0.5091990,0.3959154,1.77
1,108,2013,2121,0.5453968,0.4345455,1.60
1,109,2013,2122,0.5831612,0.4760811,1.44
1,110,2013,2123,0.6224217,0.5205286,1.30
1,111,2013,2124,0.6630882,0.5677530,1.17
1,112,2013,2125,0.7050519,0.6176170,1.04
1,113,2013,2126,0.7481851,0.6700327,0.92
1,114,2013,2127,0.7923424,0.7248535,0.78
1,115,2013,2128,1.0000000,1.0000000,0.50
1,0,2014,2014,0.0091945,0.0087361,85.41
1,1,2014,2015,0.0006668,0.0005825,85.16
1,2,2014,2016,0.0003367,0.0002794,84.21
1,3,2014,2017,0.0002291,0.0001810,83.23
1,4,2014,2018,0.0001930,0.0001468,82.25
1,5,2014,2019,0.0001870,0.0001390,81.26
1,6,2014,2020,0.0001837,0.0001330,80.27
1,7,2014,2021,0.0001828,0.0001295,79.28
1,8,2014,2022,0.0001845,0.0001286,78.29
1,9,2014,2023,0.0001904,0.0001317,77.30
1,10,2014,2024,0.0002017,0.0001394,76.31
1,11,2014,2025,0.0002200,0.0001522,75.32
1,12,2014,2026,0.0002484,0.0001727,74.33
1,13,2014,2027,0.0002934,0.0002073,73.34
1,14,2014,2028,0.0003624,0.0002640,72.36
1,15,2014,2029,0.0004596,0.0003473,71.38
1,16,2014,2030,0.0005802,0.0004518,70.40
1,17,2014,2031,0.0007098,0.0005624,69.43
1,18,2014,2032,0.0008321,0.0006652,68.47
1,19,2014,2033,0.0009391,0.0007528,67.52
1,20,2014,2034,0.0010297,0.0008234,66.57
1,21,2014,2035,0.0011033,0.0008754,65.62
1,22,2014,2036,0.0011584,0.0009097,64.68
1,23,2014,2037,0.0011978,0.0009343,63.74
1,24,2014,2038,0.0012275,0.0009529,62.80
1,25,2014,2039,0.0012521,0.0009608,61.86
1,26,2014,2040,0.0012759,0.0009646,60.92
1,27,2014,2041,0.0013058,0.0009748,59.97
1,28,2014,2042,0.0013446,0.0010017,59.03
1,29,2014,2043,0.0013859,0.0010269,58.09
1,30,2014,2044,0.0014216,0.0010372,57.15
1,31,2014,2045,0.0014530,0.0010410,56.21
1,32,2014,2046,0.0014859,0.0010453,55.27
1,33,2014,2047,0.0015203,0.0010455,54.32
1,34,2014,2048,0.0015540,0.0010373,53.38
1,35,2014,2049,0.0015941,0.0010244,52.44
1,36,2014,2050,0.0016525,0.0010268,51.49
1,37,2014,2051,0.0017318,0.0010448,50.54
1,38,2014,2052,0.0018255,0.0010839,49.59
1,39,2014,2053,0.0019305,0.0011415,48.65
1,40,2014,2054,0.0020513,0.0012143,47.70
1,41,2014,2055,0.0021897,0.0013006,46.76
1,42,2014,2056,0.0023342,0.0013886,45.82
1,43,2014,2057,0.0024669,0.0014614,44.88
1,44,2014,2058,0.0025867,0.0015130,43.95
1,45,2014,2059,0.0027191,0.0015498,43.01
1,46,2014,2060,0.0028925,0.0016177,42.08
1,47,2014,2061,0.0031101,0.0017185,41.15
1,48,2014,2062,0.0033571,0.0018481,40.22
1,49,2014,2063,0.0036304,0.0019909,39.29
1,50,2014,2064,0.0039379,0.0021345,38.37
1,51,2014,2065,0.0042708,0.0022794,37.45
1,52,2014,2066,0.0046082,0.0024162,36.53
1,53,2014,2067,0.0049489,0.0025332,35.62
1,54,2014,2068,0.0053157,0.0026631,34.71
1,55,2014,2069,0.0057365,0.0028168,33.80
1,56,2014,2070,0.0062406,0.0030341,32.90
1,57,2014,2071,0.0068502,0.0033283,31.99
1,58,2014,2072,0.0075521,0.0036985,31.10
1,59,2014,2073,0.0083035,0.0040883,30.21
1,60,2014,2074,0.0090849,0.0044576,29.33
1,61,2014,2075,0.0099105,0.0048119,28.46
1,62,2014,2076,0.0107829,0.0051549,27.60
1,63,2014,2077,0.0116995,0.0055032,26.74
1,64,2014,2078,0.0126957,0.0059011,25.88
1,65,2014,2079,0.0138071,0.0063551,25.04
1,66,2014,2080,0.0150054,0.0068377,24.19
1,67,2014,2081,0.0162315,0.0072647,23.36
1,68,2014,2082,0.0174919,0.0076386,22.52
1,69,2014,2083,0.0188954,0.0080702,21.69
1,70,2014,2084,0.0205786,0.0086576,20.86
1,71,2014,2085,0.0226142,0.0094954,20.04
1,72,2014,2086,0.0250119,0.0106254,19.23
1,73,2014,2087,0.0277519,0.0120443,18.43
1,74,2014,2088,0.0307579,0.0137014,17.65
1,75,2014,2089,0.0339099,0.0154171,16.89
1,76,2014,2090,0.0371478,0.0170631,16.14
1,77,2014,2091,0.0405123,0.0186323,15.42
1,78,2014,2092,0.0440886,0.0201997,14.70
1,79,2014,2093,0.0480027,0.0218965,13.99
1,80,2014,2094,0.0536037,0.0255144,13.29
1,81,2014,2095,0.0586892,0.0280185,12.63
1,82,2014,2096,0.0642414,0.0307547,11.98
1,83,2014,2097,0.0702997,0.0338213,11.34
1,84,2014,2098,0.0769067,0.0373116,10.72
1,85,2014,2099,0.0841076,0.0412251,10.12
1,86,2014,2100,0.0919504,0.0455935,9.53
1,87,2014,2101,0.1004863,0.0504934,8.96
1,88,2014,2102,0.1097689,0.0560233,8.41
1,89,2014,2103,0.1198550,0.0622525,7.88
1,90,2014,2104,0.1308036,0.0691820,7.37
1,91,2014,2105,0.1426766,0.0768425,6.88
1,92,2014,2106,0.1555375,0.0853431,6.42
1,93,2014,2107,0.1694519,0.0948231,5.97
1,94,2014,2108,0.1844867,0.1053945,5.54
1,95,2014,2109,0.2007091,0.1171062,5.13
1,96,2014,2110,0.2181866,0.1300276,4.75
1,97,2014,2111,0.2369856,0.1443182,4.38
1,98,2014,2112,0.2571705,0.1601742,4.04
1,99,2014,2113,0.2788028,0.1777520,3.71
1,100,2014,2114,0.3019394,0.1971206,3.41
1,101,2014,2115,0.3266317,0.2183672,3.12
1,102,2014,2116,0.3529236,0.2416859,2.85
1,103,2014,2117,0.3808502,0.2673026,2.60
1,104,2014,2118,0.4104359,0.2953722,2.37
1,105,2014,2119,0.4416930,0.3259346,2.16
1,106,2014,2120,0.4746198,0.3590515,1.96
1,107,2014,2121,0.5091990,0.3948843,1.77
1,108,2014,2122,0.5453968,0.4335919,1.60
1,109,2014,2123,0.5831612,0.4752237,1.45
1,110,2014,2124,0.6224217,0.5196879,1.30
1,111,2014,2125,0.6630882,0.5668935,1.17
1,112,2014,2126,0.7050519,0.6168092,1.04
1,113,2014,2127,0.7481851,0.6693530,0.92
1,114,2014,2128,0.7923424,0.7243111,0.78
1,115,2014,2129,1.0000000,1.0000000,0.50
1,0,2015,2015,0.0091945,0.0083531,85.55
1,1,2015,2016,0.0006668,0.0005461,85.27
1,2,2015,2017,0.0003367,0.0002639,84.32
1,3,2015,2018,0.0002291,0.0001720,83.34
1,4,2015,2019,0.0001930,0.0001397,82.36
1,5,2015,2020,0.0001870,0.0001322,81.37
1,6,2015,2021,0.0001837,0.0001269,80.38
1,7,2015,2022,0.0001828,0.0001242,79.39
1,8,2015,2023,0.0001845,0.0001240,78.40
1,9,2015,2024,0.0001904,0.0001272,77.41
1,10,2015,2025,0.0002017,0.0001347,76.42
1,11,2015,2026,0.0002200,0.0001474,75.43
1,12,2015,2027,0.0002484,0.0001680,74.44
1,13,2015,2028,0.0002934,0.0002026,73.45
1,14,2015,2029,0.0003624,0.0002589,72.47
1,15,2015,2030,0.0004596,0.0003411,71.48
1,16,2015,2031,0.0005802,0.0004449,70.51
1,17,2015,2032,0.0007098,0.0005553,69.54
1,18,2015,2033,0.0008321,0.0006581,68.58
1,19,2015,2034,0.0009391,0.0007451,67.62
1,20,2015,2035,0.0010297,0.0008146,66.67
1,21,2015,2036,0.0011033,0.0008658,65.73
1,22,2015,2037,0.0011584,0.0009004,64.78
1,23,2015,2038,0.0011978,0.0009256,63.84
1,24,2015,2039,0.0012275,0.0009439,62.90
1,25,2015,2040,0.0012521,0.0009508,61.96
1,26,2015,2041,0.0012759,0.0009542,61.02
1,27,2015,2042,0.0013058,0.0009648,60.08
1,28,2015,2043,0.0013446,0.0009925,59.13
1,29,2015,2044,0.0013859,0.0010174,58.19
1,30,2015,2045,0.0014216,0.0010266,57.25
1,31,2015,2046,0.0014530,0.0010298,56.31
1,32,2015,2047,0.0014859,0.0010345,55.37
1,33,2015,2048,0.0015203,0.0010351,54.42
1,34,2015,2049,0.0015540,0.0010261,53.48
1,35,2015,2050,0.0015941,0.0010116,52.53
1,36,2015,2051,0.0016525,0.0010131,51.59
1,37,2015,2052,0.0017318,0.0010312,50.64
1,38,2015,2053,0.0018255,0.0010707,49.69
1,39,2015,2054,0.0019305,0.0011272,48.74
1,40,2015,2055,0.0020513,0.0011981,47.80
1,41,2015,2056,0.0021897,0.0012834,46.85
1,42,2015,2057,0.0023342,0.0013718,45.91
1,43,2015,2058,0.0024669,0.0014453,44.98
1,44,2015,2059,0.0025867,0.0014959,44.04
1,45,2015,2060,0.0027191,0.0015302,43.10
1,46,2015,2061,0.0028925,0.0015966,42.17
1,47,2015,2062,0.0031101,0.0016973,41.24
1,48,2015,2063,0.0033571,0.0018274,40.31
1,49,2015,2064,0.0036304,0.0019683,39.38
1,50,2015,2065,0.0039379,0.0021080,38.46
1,51,2015,2066,0.0042708,0.0022503,37.54
1,52,2015,2067,0.0046082,0.0023869,36.62
1,53,2015,2068,0.0049489,0.0025041,35.71
1,54,2015,2069,0.0053157,0.0026310,34.79
1,55,2015,2070,0.0057365,0.0027792,33.88
1,56,2015,2071,0.0062406,0.0029929,32.98
1,57,2015,2072,0.0068502,0.0032865,32.08
1,58,2015,2073,0.0075521,0.0036570,31.18
1,59,2015,2074,0.0083035,0.0040430,30.29
1,60,2015,2075,0.0090849,0.0044045,29.41
1,61,2015,2076,0.0099105,0.0047534,28.54
1,62,2015,2077,0.0107829,0.0050955,27.67
1,63,2015,2078,0.0116995,0.0054437,26.81
1,64,2015,2079,0.0126957,0.0058349,25.96
1,65,2015,2080,0.0138071,0.0062775,25.11
1,66,2015,2081,0.0150054,0.0067525,24.26
1,67,2015,2082,0.0162315,0.0071787,23.42
1,68,2015,2083,0.0174919,0.0075537,22.59
1,69,2015,2084,0.0188954,0.0079773,21.76
1,70,2015,2085,0.0205786,0.0085488,20.93
1,71,2015,2086,0.0226142,0.0093747,20.11
1,72,2015,2087,0.0250119,0.0105015,19.29
1,73,2015,2088,0.0277519,0.0119187,18.49
1,74,2015,2089,0.0307579,0.0135607,17.71
1,75,2015,2090,0.0339099,0.0152509,16.94
1,76,2015,2091,0.0371478,0.0168797,16.20
1,77,2015,2092,0.0405123,0.0184463,15.47
1,78,2015,2093,0.0440886,0.0200141,14.75
1,79,2015,2094,0.0480027,0.0216912,14.04
1,80,2015,2095,0.0536037,0.0252707,13.34
1,81,2015,2096,0.0586892,0.0277489,12.67
1,82,2015,2097,0.0642414,0.0304804,12.02
1,83,2015,2098,0.0702997,0.0335472,11.38
1,84,2015,2099,0.0769067,0.0370093,10.76
1,85,2015,2100,0.0841076,0.0408705,10.16
1,86,2015,2101,0.0919504,0.0452029,9.57
1,87,2015,2102,0.1004863,0.0500977,9.00
1,88,2015,2103,0.1097689,0.0556284,8.44
1,89,2015,2104,0.1198550,0.0618162,7.91
1,90,2015,2105,0.1308036,0.0686726,7.40
1,91,2015,2106,0.1426766,0.0762854,6.91
1,92,2015,2107,0.1555375,0.0847831,6.44
1,93,2015,2108,0.1694519,0.0942693,5.99
1,94,2015,2109,0.1844867,0.1047889,5.56
1,95,2015,2110,0.2007091,0.1164061,5.15
1,96,2015,2111,0.2181866,0.1292702,4.76
1,97,2015,2112,0.2369856,0.1435667,4.40
1,98,2015,2113,0.2571705,0.1594453,4.05
1,99,2015,2114,0.2788028,0.1769739,3.72
1,100,2015,2115,0.3019394,0.1962389,3.42
1,101,2015,2116,0.3266317,0.2174310,3.13
1,102,2015,2117,0.3529236,0.2407753,2.86
1,103,2015,2118,0.3808502,0.2664333,2.61
1,104,2015,2119,0.4104359,0.2944576,2.38
1,105,2015,2120,0.4416930,0.3249248,2.16
1,106,2015,2121,0.4746198,0.3580150,1.96
1,107,2015,2122,0.5091990,0.3939146,1.78
1,108,2015,2123,0.5453968,0.4327086,1.61
1,109,2015,2124,0.5831612,0.4743443,1.45
1,110,2015,2125,0.6224217,0.5187725,1.30
1,111,2015,2126,0.6630882,0.5660143,1.17
1,112,2015,2127,0.7050519,0.6160491,1.05
1,113,2015,2128,0.7481851,0.6687247,0.92
1,114,2015,2129,0.7923424,0.7237567,0.78
1,115,2015,2130,1.0000000,1.0000000,0.50
1,0,2016,2016,0.0091944,0.0079783,85.70
1,1,2016,2017,0.0006668,0.0005139,85.39
1,2,2016,2018,0.0003367,0.0002504,84.43
1,3,2016,2019,0.0002291,0.0001632,83.45
1,4,2016,2020,0.0001930,0.0001324,82.47
1,5,2016,2021,0.0001870,0.0001257,81.48
1,6,2016,2022,0.0001837,0.0001213,80.49
1,7,2016,2023,0.0001828,0.0001195,79.50
1,8,2016,2024,0.0001845,0.0001195,78.51
1,9,2016,2025,0.0001904,0.0001225,77.52
1,10,2016,2026,0.0002017,0.0001300,76.53
1,11,2016,2027,0.0002200,0.0001430,75.54
1,12,2016,2028,0.0002484,0.0001638,74.55
1,13,2016,2029,0.0002934,0.0001980,73.56
1,14,2016,2030,0.0003624,0.0002533,72.57
1,15,2016,2031,0.0004596,0.0003349,71.59
1,16,2016,2032,0.0005802,0.0004385,70.61
1,17,2016,2033,0.0007098,0.0005488,69.65
1,18,2016,2034,0.0008321,0.0006510,68.68
1,19,2016,2035,0.0009391,0.0007368,67.73
1,20,2016,2036,0.0010297,0.0008056,66.78
1,21,2016,2037,0.0011033,0.0008569,65.83
1,22,2016,2038,0.0011584,0.0008919,64.89
1,23,2016,2039,0.0011978,0.0009167,63.94
1,24,2016,2040,0.0012275,0.0009342,63.00
1,25,2016,2041,0.0012521,0.0009407,62.06
1,26,2016,2042,0.0012759,0.0009445,61.12
1,27,2016,2043,0.0013058,0.0009557,60.18
1,28,2016,2044,0.0013446,0.0009832,59.23
1,29,2016,2045,0.0013859,0.0010072,58.29
1,30,2016,2046,0.0014216,0.0010158,57.35
1,31,2016,2047,0.0014530,0.0010194,56.41
1,32,2016,2048,0.0014859,0.0010246,55.46
1,33,2016,2049,0.0015203,0.0010246,54.52
1,34,2016,2050,0.0015540,0.0010141,53.58
1,35,2016,2051,0.0015941,0.0009987,52.63
1,36,2016,2052,0.0016525,0.0010003,51.68
1,37,2016,2053,0.0017318,0.0010186,50.73
1,38,2016,2054,0.0018255,0.0010571,49.78
1,39,2016,2055,0.0019305,0.0011118,48.84
1,40,2016,2056,0.0020513,0.0011818,47.89
1,41,2016,2057,0.0021897,0.0012674,46.95
1,42,2016,2058,0.0023342,0.0013564,46.01
1,43,2016,2059,0.0024669,0.0014290,45.07
1,44,2016,2060,0.0025867,0.0014775,44.13
1,45,2016,2061,0.0027191,0.0015104,43.20
1,46,2016,2062,0.0028925,0.0015769,42.26
1,47,2016,2063,0.0031101,0.0016780,41.33
1,48,2016,2064,0.0033571,0.0018063,40.40
1,49,2016,2065,0.0036304,0.0019439,39.47
1,50,2016,2066,0.0039379,0.0020813,38.54
1,51,2016,2067,0.0042708,0.0022232,37.62
1,52,2016,2068,0.0046082,0.0023600,36.71
1,53,2016,2069,0.0049489,0.0024743,35.79
1,54,2016,2070,0.0053157,0.0025963,34.88
1,55,2016,2071,0.0057365,0.0027413,33.97
1,56,2016,2072,0.0062406,0.0029547,33.06
1,57,2016,2073,0.0068502,0.0032486,32.16
1,58,2016,2074,0.0075521,0.0036155,31.26
1,59,2016,2075,0.0083035,0.0039944,30.37
1,60,2016,2076,0.0090849,0.0043509,29.49
1,61,2016,2077,0.0099105,0.0046989,28.62
1,62,2016,2078,0.0107829,0.0050408,27.75
1,63,2016,2079,0.0116995,0.0053828,26.89
1,64,2016,2080,0.0126957,0.0057635,26.03
1,65,2016,2081,0.0138071,0.0061990,25.18
1,66,2016,2082,0.0150054,0.0066731,24.33
1,67,2016,2083,0.0162315,0.0071001,23.49
1,68,2016,2084,0.0174919,0.0074679,22.66
1,69,2016,2085,0.0188954,0.0078775,21.82
1,70,2016,2086,0.0205786,0.0084387,20.99
1,71,2016,2087,0.0226142,0.0092623,20.17
1,72,2016,2088,0.0250119,0.0103878,19.35
1,73,2016,2089,0.0277519,0.0117909,18.55
1,74,2016,2090,0.0307579,0.0134089,17.77
1,75,2016,2091,0.0339099,0.0150827,17.00
1,76,2016,2092,0.0371478,0.0167087,16.25
1,77,2016,2093,0.0405123,0.0182756,15.52
1,78,2016,2094,0.0440886,0.0198254,14.80
1,79,2016,2095,0.0480027,0.0214697,14.09
1,80,2016,2096,0.0536037,0.0250235,13.39
1,81,2016,2097,0.0586892,0.0274973,12.72
1,82,2016,2098,0.0642414,0.0302288,12.06
1,83,2016,2099,0.0702997,0.0332694,11.42
1,84,2016,2100,0.0769067,0.0366831,10.80
1,85,2016,2101,0.0841076,0.0405106,10.19
1,86,2016,2102,0.0919504,0.0448377,9.60
1,87,2016,2103,0.1004863,0.0497326,9.03
1,88,2016,2104,0.1097689,0.0552243,8.47
1,89,2016,2105,0.1198550,0.0613436,7.94
1,90,2016,2106,0.1308036,0.0681548,7.43
1,91,2016,2107,0.1426766,0.0757639,6.93
1,92,2016,2108,0.1555375,0.0842662,6.46
1,93,2016,2109,0.1694519,0.0937027,6.01
1,94,2016,2110,0.1844867,0.1041322,5.58
1,95,2016,2111,0.2007091,0.1156934,5.17
1,96,2016,2112,0.2181866,0.1285608,4.78
1,97,2016,2113,0.2369856,0.1428761,4.41
1,98,2016,2114,0.2571705,0.1587050,4.06
1,99,2016,2115,0.2788028,0.1761314,3.74
1,100,2016,2116,0.3019394,0.1953399,3.43
1,101,2016,2117,0.3266317,0.2165517,3.14
1,102,2016,2118,0.3529236,0.2399305,2.87
1,103,2016,2119,0.3808502,0.2655382,2.62
1,104,2016,2120,0.4104359,0.2934616,2.38
1,105,2016,2121,0.4416930,0.3238934,2.17
1,106,2016,2122,0.4746198,0.3570405,1.97
1,107,2016,2123,0.5091990,0.3930168,1.78
1,108,2016,2124,0.5453968,0.4318029,1.61
1,109,2016,2125,0.5831612,0.4733870,1.45
1,110,2016,2126,0.6224217,0.5178363,1.31
1,111,2016,2127,0.6630882,0.5651870,1.17
1,112,2016,2128,0.7050519,0.6153464,1.05
1,113,2016,2129,0.7481851,0.6680825,0.92
1,114,2016,2130,0.7923424,0.7231536,0.78
1,115,2016,2131,1.0000000,1.0000000,0.50
1,0,2017,2017,0.0091944,0.0076405,85.84
1,1,2017,2018,0.0006668,0.0004857,85.50
1,2,2017,2019,0.0003367,0.0002372,84.54
1,3,2017,2020,0.0002291,0.0001542,83.56
1,4,2017,2021,0.0001930,0.0001252,82.58
1,5,2017,2022,0.0001870,0.0001198,81.59
1,6,2017,2023,0.0001837,0.0001164,80.60
1,7,2017,2024,0.0001828,0.0001148,79.61
1,8,2017,2025,0.0001845,0.0001148,78.61
1,9,2017,2026,0.0001904,0.0001179,77.62
1,10,2017,2027,0.0002017,0.0001258,76.63
1,11,2017,2028,0.0002200,0.0001390,75.64
1,12,2017,2029,0.0002484,0.0001596,74.65
1,13,2017,2030,0.0002934,0.0001931,73.66
1,14,2017,2031,0.0003624,0.0002478,72.68
1,15,2017,2032,0.0004596,0.0003292,71.70
1,16,2017,2033,0.0005802,0.0004327,70.72
1,17,2017,2034,0.0007098,0.0005422,69.75
1,18,2017,2035,0.0008321,0.0006433,68.79
1,19,2017,2036,0.0009391,0.0007284,67.83
1,20,2017,2037,0.0010297,0.0007972,66.88
1,21,2017,2038,0.0011033,0.0008488,65.93
1,22,2017,2039,0.0011584,0.0008832,64.99
1,23,2017,2040,0.0011978,0.0009071,64.05
1,24,2017,2041,0.0012275,0.0009244,63.10
1,25,2017,2042,0.0012521,0.0009313,62.16
1,26,2017,2043,0.0012759,0.0009356,61.22
1,27,2017,2044,0.0013058,0.0009465,60.28
1,28,2017,2045,0.0013446,0.0009732,59.33
1,29,2017,2046,0.0013859,0.0009968,58.39
1,30,2017,2047,0.0014216,0.0010057,57.45
1,31,2017,2048,0.0014530,0.0010098,56.51
1,32,2017,2049,0.0014859,0.0010145,55.56
1,33,2017,2050,0.0015203,0.0010132,54.62
1,34,2017,2051,0.0015540,0.0010020,53.67
1,35,2017,2052,0.0015941,0.0009867,52.73
1,36,2017,2053,0.0016525,0.0009886,51.78
1,37,2017,2054,0.0017318,0.0010058,50.83
1,38,2017,2055,0.0018255,0.0010424,49.88
1,39,2017,2056,0.0019305,0.0010962,48.93
1,40,2017,2057,0.0020513,0.0011666,47.98
1,41,2017,2058,0.0021897,0.0012528,47.04
1,42,2017,2059,0.0023342,0.0013408,46.10
1,43,2017,2060,0.0024669,0.0014114,45.16
1,44,2017,2061,0.0025867,0.0014588,44.22
1,45,2017,2062,0.0027191,0.0014920,43.29
1,46,2017,2063,0.0028925,0.0015589,42.35
1,47,2017,2064,0.0031101,0.0016584,41.42
1,48,2017,2065,0.0033571,0.0017836,40.48
1,49,2017,2066,0.0036304,0.0019192,39.56
1,50,2017,2067,0.0039379,0.0020563,38.63
1,51,2017,2068,0.0042708,0.0021983,37.71
1,52,2017,2069,0.0046082,0.0023324,36.79
1,53,2017,2070,0.0049489,0.0024422,35.88
1,54,2017,2071,0.0053157,0.0025613,34.96
1,55,2017,2072,0.0057365,0.0027062,34.05
1,56,2017,2073,0.0062406,0.0029200,33.14
1,57,2017,2074,0.0068502,0.0032106,32.24
1,58,2017,2075,0.0075521,0.0035710,31.34
1,59,2017,2076,0.0083035,0.0039452,30.45
1,60,2017,2077,0.0090849,0.0043009,29.57
1,61,2017,2078,0.0099105,0.0046486,28.69
1,62,2017,2079,0.0107829,0.0049847,27.83
1,63,2017,2080,0.0116995,0.0053170,26.96
1,64,2017,2081,0.0126957,0.0056913,26.10
1,65,2017,2082,0.0138071,0.0061259,25.25
1,66,2017,2083,0.0150054,0.0066006,24.40
1,67,2017,2084,0.0162315,0.0070207,23.56
1,68,2017,2085,0.0174919,0.0073757,22.73
1,69,2017,2086,0.0188954,0.0077765,21.89
1,70,2017,2087,0.0205786,0.0083363,21.06
1,71,2017,2088,0.0226142,0.0091591,20.23
1,72,2017,2089,0.0250119,0.0102720,19.41
1,73,2017,2090,0.0277519,0.0116530,18.61
1,74,2017,2091,0.0307579,0.0132553,17.82
1,75,2017,2092,0.0339099,0.0149258,17.06
1,76,2017,2093,0.0371478,0.0165517,16.31
1,77,2017,2094,0.0405123,0.0181020,15.57
1,78,2017,2095,0.0440886,0.0196218,14.85
1,79,2017,2096,0.0480027,0.0212452,14.14
1,80,2017,2097,0.0536037,0.0247930,13.43
1,81,2017,2098,0.0586892,0.0272667,12.76
1,82,2017,2099,0.0642414,0.0299739,12.11
1,83,2017,2100,0.0702997,0.0329696,11.46
1,84,2017,2101,0.0769067,0.0363520,10.84
1,85,2017,2102,0.0841076,0.0401742,10.23
1,86,2017,2103,0.0919504,0.0445008,9.64
1,87,2017,2104,0.1004863,0.0493592,9.06
1,88,2017,2105,0.1097689,0.0547867,8.51
1,89,2017,2106,0.1198550,0.0608633,7.97
1,90,2017,2107,0.1308036,0.0676702,7.45
1,91,2017,2108,0.1426766,0.0752826,6.96
1,92,2017,2109,0.1555375,0.0837375,6.48
1,93,2017,2110,0.1694519,0.0930884,6.03
1,94,2017,2111,0.1844867,0.1034638,5.60
1,95,2017,2112,0.2007091,0.1150262,5.19
1,96,2017,2113,0.2181866,0.1279091,4.80
1,97,2017,2114,0.2369856,0.1421750,4.43
1,98,2017,2115,0.2571705,0.1579038,4.08
1,99,2017,2116,0.2788028,0.1752725,3.75
1,100,2017,2117,0.3019394,0.1944956,3.44
1,101,2017,2118,0.3266317,0.2157360,3.15
1,102,2017,2119,0.3529236,0.2390610,2.88
1,103,2017,2120,0.3808502,0.2645639,2.63
1,104,2017,2121,0.4104359,0.2924447,2.39
1,105,2017,2122,0.4416930,0.3229241,2.17
1,106,2017,2123,0.4746198,0.3561385,1.97
1,107,2017,2124,0.5091990,0.3920963,1.78
1,108,2017,2125,0.5453968,0.4308172,1.61
1,109,2017,2126,0.5831612,0.4724082,1.45
1,110,2017,2127,0.6224217,0.5169557,1.31
1,111,2017,2128,0.6630882,0.5644226,1.17
1,112,2017,2129,0.7050519,0.6146286,1.05
1,113,2017,2130,0.7481851,0.6673840,0.92
1,114,2017,2131,0.7923424,0.7225363,0.78
1,115,2017,2132,1.0000000,1.0000000,0.50
1,0,2018,2018,0.0091943,0.0073406,85.98
1,1,2018,2019,0.0006668,0.0004585,85.62
1,2,2018,2020,0.0003367,0.0002237,84.65
1,3,2018,2021,0.0002291,0.0001455,83.67
1,4,2018,2022,0.0001930,0.0001189,82.69
1,5,2018,2023,0.0001870,0.0001146,81.70
1,6,2018,2024,0.0001837,0.0001115,80.70
1,7,2018,2025,0.0001828,0.0001100,79.71
1,8,2018,2026,0.0001845,0.0001101,78.72
1,9,2018,2027,0.0001904,0.0001137,77.73
1,10,2018,2028,0.0002017,0.0001220,76.74
1,11,2018,2029,0.0002200,0.0001351,75.75
1,12,2018,2030,0.0002484,0.0001551,74.76
1,13,2018,2031,0.0002934,0.0001881,73.77
1,14,2018,2032,0.0003624,0.0002427,72.78
1,15,2018,2033,0.0004596,0.0003240,71.80
1,16,2018,2034,0.0005802,0.0004268,70.83
1,17,2018,2035,0.0007098,0.0005352,69.86
1,18,2018,2036,0.0008321,0.0006355,68.89
1,19,2018,2037,0.0009391,0.0007205,67.94
1,20,2018,2038,0.0010297,0.0007895,66.98
1,21,2018,2039,0.0011033,0.0008405,66.04
1,22,2018,2040,0.0011584,0.0008738,65.09
1,23,2018,2041,0.0011978,0.0008973,64.15
1,24,2018,2042,0.0012275,0.0009152,63.21
1,25,2018,2043,0.0012521,0.0009227,62.26
1,26,2018,2044,0.0012759,0.0009266,61.32
1,27,2018,2045,0.0013058,0.0009366,60.38
1,28,2018,2046,0.0013446,0.0009630,59.43
1,29,2018,2047,0.0013859,0.0009871,58.49
1,30,2018,2048,0.0014216,0.0009965,57.55
1,31,2018,2049,0.0014530,0.0010000,56.60
1,32,2018,2050,0.0014859,0.0010035,55.66
1,33,2018,2051,0.0015203,0.0010016,54.72
1,34,2018,2052,0.0015540,0.0009907,53.77
1,35,2018,2053,0.0015941,0.0009756,52.82
1,36,2018,2054,0.0016525,0.0009765,51.87
1,37,2018,2055,0.0017318,0.0009918,50.92
1,38,2018,2056,0.0018255,0.0010275,49.97
1,39,2018,2057,0.0019305,0.0010817,49.02
1,40,2018,2058,0.0020513,0.0011527,48.08
1,41,2018,2059,0.0021897,0.0012380,47.13
1,42,2018,2060,0.0023342,0.0013241,46.19
1,43,2018,2061,0.0024669,0.0013937,45.25
1,44,2018,2062,0.0025867,0.0014415,44.31
1,45,2018,2063,0.0027191,0.0014751,43.38
1,46,2018,2064,0.0028925,0.0015406,42.44
1,47,2018,2065,0.0031101,0.0016373,41.50
1,48,2018,2066,0.0033571,0.0017607,40.57
1,49,2018,2067,0.0036304,0.0018962,39.64
1,50,2018,2068,0.0039379,0.0020334,38.72
1,51,2018,2069,0.0042708,0.0021728,37.79
1,52,2018,2070,0.0046082,0.0023026,36.88
1,53,2018,2071,0.0049489,0.0024097,35.96
1,54,2018,2072,0.0053157,0.0025288,35.05
1,55,2018,2073,0.0057365,0.0026742,34.13
1,56,2018,2074,0.0062406,0.0028853,33.22
1,57,2018,2075,0.0068502,0.0031700,32.32
1,58,2018,2076,0.0075521,0.0035260,31.42
1,59,2018,2077,0.0083035,0.0038994,30.53
1,60,2018,2078,0.0090849,0.0042548,29.65
1,61,2018,2079,0.0099105,0.0045972,28.77
1,62,2018,2080,0.0107829,0.0049242,27.90
1,63,2018,2081,0.0116995,0.0052505,27.04
1,64,2018,2082,0.0126957,0.0056242,26.18
1,65,2018,2083,0.0138071,0.0060592,25.32
1,66,2018,2084,0.0150054,0.0065273,24.47
1,67,2018,2085,0.0162315,0.0069353,23.63
1,68,2018,2086,0.0174919,0.0072824,22.79
1,69,2018,2087,0.0188954,0.0076826,21.96
1,70,2018,2088,0.0205786,0.0082424,21.12
1,71,2018,2089,0.0226142,0.0090542,20.29
1,72,2018,2090,0.0250119,0.0101472,19.47
1,73,2018,2091,0.0277519,0.0115136,18.67
1,74,2018,2092,0.0307579,0.0131121,17.88
1,75,2018,2093,0.0339099,0.0147818,17.11
1,76,2018,2094,0.0371478,0.0163921,16.36
1,77,2018,2095,0.0405123,0.0179147,15.63
1,78,2018,2096,0.0440886,0.0194155,14.90
1,79,2018,2097,0.0480027,0.0210359,14.19
1,80,2018,2098,0.0536037,0.0245817,13.48
1,81,2018,2099,0.0586892,0.0270331,12.81
1,82,2018,2100,0.0642414,0.0296990,12.15
1,83,2018,2101,0.0702997,0.0326655,11.51
1,84,2018,2102,0.0769067,0.0360426,10.88
1,85,2018,2103,0.0841076,0.0398640,10.27
1,86,2018,2104,0.0919504,0.0441564,9.67
1,87,2018,2105,0.1004863,0.0489548,9.09
1,88,2018,2106,0.1097689,0.0543421,8.54
1,89,2018,2107,0.1198550,0.0604140,8.00
1,90,2018,2108,0.1308036,0.0672232,7.48
1,91,2018,2109,0.1426766,0.0747905,6.98
1,92,2018,2110,0.1555375,0.0831645,6.51
1,93,2018,2111,0.1694519,0.0924634,6.05
1,94,2018,2112,0.1844867,0.1028382,5.62
1,95,2018,2113,0.2007091,0.1144133,5.21
1,96,2018,2114,0.2181866,0.1272476,4.81
1,97,2018,2115,0.2369856,0.1414163,4.44
1,98,2018,2116,0.2571705,0.1570872,4.09
1,99,2018,2117,0.2788028,0.1744663,3.76
1,100,2018,2118,0.3019394,0.1937128,3.45
1,101,2018,2119,0.3266317,0.2148968,3.16
1,102,2018,2120,0.3529236,0.2381147,2.89
1,103,2018,2121,0.3808502,0.2635694,2.63
1,104,2018,2122,0.4104359,0.2914894,2.40
1,105,2018,2123,0.4416930,0.3220271,2.18
1,106,2018,2124,0.4746198,0.3552139,1.98
1,107,2018,2125,0.5091990,0.3910949,1.79
1,108,2018,2126,0.5453968,0.4298097,1.62
1,109,2018,2127,0.5831612,0.4714878,1.46
1,110,2018,2128,0.6224217,0.5161421,1.31
1,111,2018,2129,0.6630882,0.5636417,1.18
1,112,2018,2130,0.7050519,0.6138478,1.05
1,113,2018,2131,0.7481851,0.6666692,0.93
1,114,2018,2132,0.7923424,0.7219545,0.78
1,115,2018,2133,1.0000000,1.0000000,0.50
1,0,2019,2019,0.0091943,0.0070459,86.12
1,1,2019,2020,0.0006668,0.0004306,85.73
1,2,2019,2021,0.0003367,0.0002107,84.77
1,3,2019,2022,0.0002291,0.0001377,83.78
1,4,2019,2023,0.0001930,0.0001132,82.79
1,5,2019,2024,0.0001870,0.0001094,81.80
1,6,2019,2025,0.0001837,0.0001065,80.81
1,7,2019,2026,0.0001828,0.0001052,79.82
1,8,2019,2027,0.0001845,0.0001059,78.83
1,9,2019,2028,0.0001904,0.0001099,77.84
1,10,2019,2029,0.0002017,0.0001182,76.85
1,11,2019,2030,0.0002200,0.0001309,75.86
1,12,2019,2031,0.0002484,0.0001506,74.87
1,13,2019,2032,0.0002934,0.0001836,73.88
1,14,2019,2033,0.0003624,0.0002381,72.89
1,15,2019,2034,0.0004596,0.0003187,71.91
1,16,2019,2035,0.0005802,0.0004205,70.93
1,17,2019,2036,0.0007098,0.0005281,69.96
1,18,2019,2037,0.0008321,0.0006282,69.00
1,19,2019,2038,0.0009391,0.0007133,68.04
1,20,2019,2039,0.0010297,0.0007817,67.09
1,21,2019,2040,0.0011033,0.0008315,66.14
1,22,2019,2041,0.0011584,0.0008643,65.19
1,23,2019,2042,0.0011978,0.0008883,64.25
1,24,2019,2043,0.0012275,0.0009068,63.31
1,25,2019,2044,0.0012521,0.0009140,62.36
1,26,2019,2045,0.0012759,0.0009170,61.42
1,27,2019,2046,0.0013058,0.0009265,60.48
1,28,2019,2047,0.0013446,0.0009536,59.53
1,29,2019,2048,0.0013859,0.0009782,58.59
1,30,2019,2049,0.0014216,0.0009871,57.65
1,31,2019,2050,0.0014530,0.0009895,56.70
1,32,2019,2051,0.0014859,0.0009925,55.76
1,33,2019,2052,0.0015203,0.0009908,54.81
1,34,2019,2053,0.0015540,0.0009802,53.87
1,35,2019,2054,0.0015941,0.0009642,52.92
1,36,2019,2055,0.0016525,0.0009634,51.97
1,37,2019,2056,0.0017318,0.0009778,51.02
1,38,2019,2057,0.0018255,0.0010138,50.07
1,39,2019,2058,0.0019305,0.0010685,49.12
1,40,2019,2059,0.0020513,0.0011387,48.17
1,41,2019,2060,0.0021897,0.0012222,47.22
1,42,2019,2061,0.0023342,0.0013072,46.28
1,43,2019,2062,0.0024669,0.0013772,45.34
1,44,2019,2063,0.0025867,0.0014256,44.40
1,45,2019,2064,0.0027191,0.0014580,43.47
1,46,2019,2065,0.0028925,0.0015210,42.53
1,47,2019,2066,0.0031101,0.0016159,41.59
1,48,2019,2067,0.0033571,0.0017394,40.66
1,49,2019,2068,0.0036304,0.0018751,39.73
1,50,2019,2069,0.0039379,0.0020099,38.80
1,51,2019,2070,0.0042708,0.0021453,37.88
1,52,2019,2071,0.0046082,0.0022726,36.96
1,53,2019,2072,0.0049489,0.0023795,36.04
1,54,2019,2073,0.0053157,0.0024993,35.13
1,55,2019,2074,0.0057365,0.0026423,34.22
1,56,2019,2075,0.0062406,0.0028481,33.30
1,57,2019,2076,0.0068502,0.0031290,32.40
1,58,2019,2077,0.0075521,0.0034841,31.50
1,59,2019,2078,0.0083035,0.0038571,30.61
1,60,2019,2079,0.0090849,0.0042077,29.72
1,61,2019,2080,0.0099105,0.0045416,28.85
1,62,2019,2081,0.0107829,0.0048630,27.98
1,63,2019,2082,0.0116995,0.0051886,27.11
1,64,2019,2083,0.0126957,0.0055628,26.25
1,65,2019,2084,0.0138071,0.0059917,25.39
1,66,2019,2085,0.0150054,0.0064484,24.54
1,67,2019,2086,0.0162315,0.0068490,23.70
1,68,2019,2087,0.0174919,0.0071956,22.86
1,69,2019,2088,0.0188954,0.0075963,22.02
1,70,2019,2089,0.0205786,0.0081468,21.19
1,71,2019,2090,0.0226142,0.0089411,20.36
1,72,2019,2091,0.0250119,0.0100210,19.54
1,73,2019,2092,0.0277519,0.0113837,18.73
1,74,2019,2093,0.0307579,0.0129808,17.94
1,75,2019,2094,0.0339099,0.0146355,17.17
1,76,2019,2095,0.0371478,0.0162199,16.41
1,77,2019,2096,0.0405123,0.0177249,15.68
1,78,2019,2097,0.0440886,0.0192231,14.95
1,79,2019,2098,0.0480027,0.0208442,14.23
1,80,2019,2099,0.0536037,0.0243676,13.53
1,81,2019,2100,0.0586892,0.0267811,12.85
1,82,2019,2101,0.0642414,0.0294201,12.19
1,83,2019,2102,0.0702997,0.0323814,11.55
1,84,2019,2103,0.0769067,0.0357574,10.92
1,85,2019,2104,0.0841076,0.0395468,10.30
1,86,2019,2105,0.0919504,0.0437835,9.71
1,87,2019,2106,0.1004863,0.0485442,9.13
1,88,2019,2107,0.1097689,0.0539264,8.57
1,89,2019,2108,0.1198550,0.0599997,8.03
1,90,2019,2109,0.1308036,0.0667662,7.51
1,91,2019,2110,0.1426766,0.0742574,7.01
1,92,2019,2111,0.1555375,0.0825817,6.53
1,93,2019,2112,0.1694519,0.0918787,6.07
1,94,2019,2113,0.1844867,0.1022638,5.64
1,95,2019,2114,0.2007091,0.1137915,5.22
1,96,2019,2115,0.2181866,0.1265320,4.83
1,97,2019,2116,0.2369856,0.1406433,4.46
1,98,2019,2117,0.2571705,0.1563209,4.11
1,99,2019,2118,0.2788028,0.1737189,3.77
1,100,2019,2119,0.3019394,0.1929075,3.46
1,101,2019,2120,0.3266317,0.2139837,3.17
1,102,2019,2121,0.3529236,0.2371491,2.90
1,103,2019,2122,0.3808502,0.2626353,2.64
1,104,2019,2123,0.4104359,0.2906054,2.40
1,105,2019,2124,0.4416930,0.3211080,2.18
1,106,2019,2125,0.4746198,0.3542084,1.98
1,107,2019,2126,0.5091990,0.3900716,1.79
1,108,2019,2127,0.5453968,0.4288624,1.62
1,109,2019,2128,0.5831612,0.4706375,1.46
1,110,2019,2129,0.6224217,0.5153111,1.31
1,111,2019,2130,0.6630882,0.5627925,1.18
1,112,2019,2131,0.7050519,0.6130490,1.05
1,113,2019,2132,0.7481851,0.6659957,0.93
1,114,2019,2133,0.7923424,0.7214133,0.78
1,115,2019,2134,1.0000000,1.0000000,0.50
1,0,2020,2020,0.0091942,0.0067384,86.26
1,1,2020,2021,0.0006668,0.0004038,85.84
1,2,2020,2022,0.0003367,0.0001991,84.87
1,3,2020,2023,0.0002291,0.0001309,83.89
1,4,2020,2024,0.0001930,0.0001077,82.90
1,5,2020,2025,0.0001870,0.0001041,81.91
1,6,2020,2026,0.0001837,0.0001015,80.92
1,7,2020,2027,0.0001828,0.0001009,79.93
1,8,2020,2028,0.0001845,0.0001021,78.94
1,9,2020,2029,0.0001904,0.0001062,77.94
1,10,2020,2030,0.0002017,0.0001142,76.95
1,11,2020,2031,0.0002200,0.0001268,75.96
1,12,2020,2032,0.0002484,0.0001466,74.97
1,13,2020,2033,0.0002934,0.0001795,73.98
1,14,2020,2034,0.0003624,0.0002335,72.99
1,15,2020,2035,0.0004596,0.0003131,72.01
1,16,2020,2036,0.0005802,0.0004141,71.03
1,17,2020,2037,0.0007098,0.0005215,70.06
1,18,2020,2038,0.0008321,0.0006215,69.10
1,19,2020,2039,0.0009391,0.0007060,68.14
1,20,2020,2040,0.0010297,0.0007732,67.19
1,21,2020,2041,0.0011033,0.0008224,66.24
1,22,2020,2042,0.0011584,0.0008554,65.30
1,23,2020,2043,0.0011978,0.0008800,64.35
1,24,2020,2044,0.0012275,0.0008983,63.41
1,25,2020,2045,0.0012521,0.0009047,62.46
1,26,2020,2046,0.0012759,0.0009072,61.52
1,27,2020,2047,0.0013058,0.0009172,60.58
1,28,2020,2048,0.0013446,0.0009449,59.63
1,29,2020,2049,0.0013859,0.0009692,58.69
1,30,2020,2050,0.0014216,0.0009769,57.74
1,31,2020,2051,0.0014530,0.0009788,56.80
1,32,2020,2052,0.0014859,0.0009822,55.85
1,33,2020,2053,0.0015203,0.0009809,54.91
1,34,2020,2054,0.0015540,0.0009694,53.96
1,35,2020,2055,0.0015941,0.0009518,53.01
1,36,2020,2056,0.0016525,0.0009502,52.06
1,37,2020,2057,0.0017318,0.0009648,51.11
1,38,2020,2058,0.0018255,0.0010012,50.16
1,39,2020,2059,0.0019305,0.0010552,49.21
1,40,2020,2060,0.0020513,0.0011236,48.26
1,41,2020,2061,0.0021897,0.0012061,47.32
1,42,2020,2062,0.0023342,0.0012915,46.37
1,43,2020,2063,0.0024669,0.0013621,45.43
1,44,2020,2064,0.0025867,0.0014095,44.49
1,45,2020,2065,0.0027191,0.0014396,43.56
1,46,2020,2066,0.0028925,0.0015011,42.62
1,47,2020,2067,0.0031101,0.0015960,41.68
1,48,2020,2068,0.0033571,0.0017197,40.75
1,49,2020,2069,0.0036304,0.0018534,39.82
1,50,2020,2070,0.0039379,0.0019846,38.89
1,51,2020,2071,0.0042708,0.0021175,37.97
1,52,2020,2072,0.0046082,0.0022446,37.05
1,53,2020,2073,0.0049489,0.0023522,36.13
1,54,2020,2074,0.0053157,0.0024698,35.21
1,55,2020,2075,0.0057365,0.0026081,34.30
1,56,2020,2076,0.0062406,0.0028106,33.39
1,57,2020,2077,0.0068502,0.0030907,32.48
1,58,2020,2078,0.0075521,0.0034455,31.58
1,59,2020,2079,0.0083035,0.0038139,30.69
1,60,2020,2080,0.0090849,0.0041567,29.80
1,61,2020,2081,0.0099105,0.0044854,28.92
1,62,2020,2082,0.0107829,0.0048060,28.05
1,63,2020,2083,0.0116995,0.0051320,27.18
1,64,2020,2084,0.0126957,0.0055007,26.32
1,65,2020,2085,0.0138071,0.0059191,25.46
1,66,2020,2086,0.0150054,0.0063687,24.61
1,67,2020,2087,0.0162315,0.0067686,23.77
1,68,2020,2088,0.0174919,0.0071158,22.93
1,69,2020,2089,0.0188954,0.0075086,22.09
1,70,2020,2090,0.0205786,0.0080438,21.25
1,71,2020,2091,0.0226142,0.0088268,20.42
1,72,2020,2092,0.0250119,0.0099035,19.60
1,73,2020,2093,0.0277519,0.0112645,18.79
1,74,2020,2094,0.0307579,0.0128473,18.00
1,75,2020,2095,0.0339099,0.0144777,17.22
1,76,2020,2096,0.0371478,0.0160455,16.47
1,77,2020,2097,0.0405123,0.0175480,15.73
1,78,2020,2098,0.0440886,0.0190470,15.00
1,79,2020,2099,0.0480027,0.0206502,14.28
1,80,2020,2100,0.0536037,0.0241367,13.57
1,81,2020,2101,0.0586892,0.0265255,12.90
1,82,2020,2102,0.0642414,0.0291595,12.23
1,83,2020,2103,0.0702997,0.0321195,11.59
1,84,2020,2104,0.0769067,0.0354658,10.96
1,85,2020,2105,0.0841076,0.0392036,10.34
1,86,2020,2106,0.0919504,0.0434049,9.74
1,87,2020,2107,0.1004863,0.0481603,9.16
1,88,2020,2108,0.1097689,0.0535430,8.60
1,89,2020,2109,0.1198550,0.0595762,8.06
1,90,2020,2110,0.1308036,0.0662712,7.54
1,91,2020,2111,0.1426766,0.0737153,7.03
1,92,2020,2112,0.1555375,0.0820366,6.55
1,93,2020,2113,0.1694519,0.0913419,6.10
1,94,2020,2114,0.1844867,0.1016811,5.66
1,95,2020,2115,0.2007091,0.1131190,5.24
1,96,2020,2116,0.2181866,0.1258032,4.85
1,97,2020,2117,0.2369856,0.1399182,4.47
1,98,2020,2118,0.2571705,0.1556108,4.12
1,99,2020,2119,0.2788028,0.1729503,3.79
1,100,2020,2120,0.3019394,0.1920317,3.47
1,101,2020,2121,0.3266317,0.2130524,3.18
1,102,2020,2122,0.3529236,0.2362425,2.90
1,103,2020,2123,0.3808502,0.2617714,2.65
1,104,2020,2124,0.4104359,0.2897000,2.41
1,105,2020,2125,0.4416930,0.3201086,2.19
1,106,2020,2126,0.4746198,0.3531811,1.99
1,107,2020,2127,0.5091990,0.3891098,1.80
1,108,2020,2128,0.5453968,0.4279877,1.62
1,109,2020,2129,0.5831612,0.4697693,1.46
1,110,2020,2130,0.6224217,0.5144077,1.32
1,111,2020,2131,0.6630882,0.5619239,1.18
1,112,2020,2132,0.7050519,0.6122964,1.05
1,113,2020,2133,0.7481851,0.6653692,0.93
1,114,2020,2134,0.7923424,0.7208546,0.78
1,115,2020,2135,1.0000000,1.0000000,0.50
1,0,2021,2021,0.0091942,0.0064374,86.39
1,1,2021,2022,0.0006668,0.0003801,85.95
1,2,2021,2023,0.0003367,0.0001889,84.98
1,3,2021,2024,0.0002291,0.0001242,84.00
1,4,2021,2025,0.0001930,0.0001021,83.01
1,5,2021,2026,0.0001870,0.0000989,82.02
1,6,2021,2027,0.0001837,0.0000971,81.03
1,7,2021,2028,0.0001828,0.0000971,80.03
1,8,2021,2029,0.0001845,0.0000984,79.04
1,9,2021,2030,0.0001904,0.0001023,78.05
1,10,2021,2031,0.0002017,0.0001103,77.06
1,11,2021,2032,0.0002200,0.0001230,76.07
1,12,2021,2033,0.0002484,0.0001429,75.08
1,13,2021,2034,0.0002934,0.0001755,74.09
1,14,2021,2035,0.0003624,0.0002285,73.10
1,15,2021,2036,0.0004596,0.0003075,72.12
1,16,2021,2037,0.0005802,0.0004082,71.14
1,17,2021,2038,0.0007098,0.0005154,70.17
1,18,2021,2039,0.0008321,0.0006148,69.20
1,19,2021,2040,0.0009391,0.0006981,68.24
1,20,2021,2041,0.0010297,0.0007647,67.29
1,21,2021,2042,0.0011033,0.0008140,66.34
1,22,2021,2043,0.0011584,0.0008473,65.40
1,23,2021,2044,0.0011978,0.0008716,64.45
1,24,2021,2045,0.0012275,0.0008892,63.51
1,25,2021,2046,0.0012521,0.0008952,62.56
1,26,2021,2047,0.0012759,0.0008981,61.62
1,27,2021,2048,0.0013058,0.0009086,60.67
1,28,2021,2049,0.0013446,0.0009360,59.73
1,29,2021,2050,0.0013859,0.0009594,58.78
1,30,2021,2051,0.0014216,0.0009666,57.84
1,31,2021,2052,0.0014530,0.0009688,56.90
1,32,2021,2053,0.0014859,0.0009726,55.95
1,33,2021,2054,0.0015203,0.0009706,55.00
1,34,2021,2055,0.0015540,0.0009578,54.06
1,35,2021,2056,0.0015941,0.0009394,53.11
1,36,2021,2057,0.0016525,0.0009379,52.16
1,37,2021,2058,0.0017318,0.0009529,51.21
1,38,2021,2059,0.0018255,0.0009885,50.26
1,39,2021,2060,0.0019305,0.0010408,49.30
1,40,2021,2061,0.0020513,0.0011084,48.36
1,41,2021,2062,0.0021897,0.0011912,47.41
1,42,2021,2063,0.0023342,0.0012771,46.46
1,43,2021,2064,0.0024669,0.0013467,45.52
1,44,2021,2065,0.0025867,0.0013922,44.58
1,45,2021,2066,0.0027191,0.0014210,43.65
1,46,2021,2067,0.0028925,0.0014826,42.71
1,47,2021,2068,0.0031101,0.0015778,41.77
1,48,2021,2069,0.0033571,0.0016997,40.83
1,49,2021,2070,0.0036304,0.0018301,39.90
1,50,2021,2071,0.0039379,0.0019590,38.98
1,51,2021,2072,0.0042708,0.0020917,38.05
1,52,2021,2073,0.0046082,0.0022193,37.13
1,53,2021,2074,0.0049489,0.0023248,36.21
1,54,2021,2075,0.0053157,0.0024382,35.29
1,55,2021,2076,0.0057365,0.0025735,34.38
1,56,2021,2077,0.0062406,0.0027756,33.47
1,57,2021,2078,0.0068502,0.0030555,32.56
1,58,2021,2079,0.0075521,0.0034060,31.66
1,59,2021,2080,0.0083035,0.0037672,30.76
1,60,2021,2081,0.0090849,0.0041051,29.88
1,61,2021,2082,0.0099105,0.0044331,29.00
1,62,2021,2083,0.0107829,0.0047539,28.13
1,63,2021,2084,0.0116995,0.0050749,27.26
1,64,2021,2085,0.0126957,0.0054340,26.39
1,65,2021,2086,0.0138071,0.0058457,25.54
1,66,2021,2087,0.0150054,0.0062944,24.68
1,67,2021,2088,0.0162315,0.0066947,23.84
1,68,2021,2089,0.0174919,0.0070348,22.99
1,69,2021,2090,0.0188954,0.0074141,22.15
1,70,2021,2091,0.0205786,0.0079397,21.31
1,71,2021,2092,0.0226142,0.0087204,20.48
1,72,2021,2093,0.0250119,0.0097958,19.66
1,73,2021,2094,0.0277519,0.0111436,18.85
1,74,2021,2095,0.0307579,0.0127035,18.05
1,75,2021,2096,0.0339099,0.0143179,17.28
1,76,2021,2097,0.0371478,0.0158829,16.52
1,77,2021,2098,0.0405123,0.0173860,15.78
1,78,2021,2099,0.0440886,0.0188686,15.05
1,79,2021,2100,0.0480027,0.0204410,14.33
1,80,2021,2101,0.0536037,0.0239026,13.62
1,81,2021,2102,0.0586892,0.0262868,12.94
1,82,2021,2103,0.0642414,0.0289194,12.28
1,83,2021,2104,0.0702997,0.0318519,11.63
1,84,2021,2105,0.0769067,0.0351504,10.99
1,85,2021,2106,0.0841076,0.0388552,10.38
1,86,2021,2107,0.0919504,0.0430511,9.78
1,87,2021,2108,0.1004863,0.0478064,9.19
1,88,2021,2109,0.1097689,0.0531514,8.63
1,89,2021,2110,0.1198550,0.0591176,8.09
1,90,2021,2111,0.1308036,0.0657681,7.56
1,91,2021,2112,0.1426766,0.0732084,7.06
1,92,2021,2113,0.1555375,0.0815363,6.58
1,93,2021,2114,0.1694519,0.0907975,6.12
1,94,2021,2115,0.1844867,0.1010512,5.68
1,95,2021,2116,0.2007091,0.1124343,5.26
1,96,2021,2117,0.2181866,0.1251197,4.86
1,97,2021,2118,0.2369856,0.1392464,4.49
1,98,2021,2119,0.2571705,0.1548807,4.13
1,99,2021,2120,0.2788028,0.1721146,3.80
1,100,2021,2121,0.3019394,0.1911386,3.48
1,101,2021,2122,0.3266317,0.2121781,3.19
1,102,2021,2123,0.3529236,0.2354042,2.91
1,103,2021,2124,0.3808502,0.2608866,2.66
1,104,2021,2125,0.4104359,0.2887157,2.42
1,105,2021,2126,0.4416930,0.3190879,2.20
1,106,2021,2127,0.4746198,0.3522158,1.99
1,107,2021,2128,0.5091990,0.3882217,1.80
1,108,2021,2129,0.5453968,0.4270946,1.63
1,109,2021,2130,0.5831612,0.4688258,1.47
1,110,2021,2131,0.6224217,0.5134838,1.32
1,111,2021,2132,0.6630882,0.5611057,1.18
1,112,2021,2133,0.7050519,0.6115964,1.06
1,113,2021,2134,0.7481851,0.6647226,0.93
1,114,2021,2135,0.7923424,0.7202448,0.78
1,115,2021,2136,1.0000000,1.0000000,0.50
1,0,2022,2022,0.0091941,0.0061660,86.53
1,1,2022,2023,0.0006668,0.0003594,86.06
1,2,2022,2024,0.0003367,0.0001790,85.09
1,3,2022,2025,0.0002291,0.0001174,84.11
1,4,2022,2026,0.0001930,0.0000965,83.12
1,5,2022,2027,0.0001870,0.0000943,82.12
1,6,2022,2028,0.0001837,0.0000931,81.13
1,7,2022,2029,0.0001828,0.0000933,80.14
1,8,2022,2030,0.0001845,0.0000945,79.15
1,9,2022,2031,0.0001904,0.0000985,78.16
1,10,2022,2032,0.0002017,0.0001067,77.16
1,11,2022,2033,0.0002200,0.0001197,76.17
1,12,2022,2034,0.0002484,0.0001393,75.18
1,13,2022,2035,0.0002934,0.0001712,74.19
1,14,2022,2036,0.0003624,0.0002236,73.20
1,15,2022,2037,0.0004596,0.0003022,72.22
1,16,2022,2038,0.0005802,0.0004028,71.24
1,17,2022,2039,0.0007098,0.0005093,70.27
1,18,2022,2040,0.0008321,0.0006075,69.30
1,19,2022,2041,0.0009391,0.0006901,68.35
1,20,2022,2042,0.0010297,0.0007567,67.39
1,21,2022,2043,0.0011033,0.0008063,66.44
1,22,2022,2044,0.0011584,0.0008392,65.50
1,23,2022,2045,0.0011978,0.0008626,64.55
1,24,2022,2046,0.0012275,0.0008800,63.61
1,25,2022,2047,0.0012521,0.0008863,62.66
1,26,2022,2048,0.0012759,0.0008897,61.72
1,27,2022,2049,0.0013058,0.0008998,60.77
1,28,2022,2050,0.0013446,0.0009265,59.83
1,29,2022,2051,0.0013859,0.0009495,58.88
1,30,2022,2052,0.0014216,0.0009570,57.94
1,31,2022,2053,0.0014530,0.0009596,56.99
1,32,2022,2054,0.0014859,0.0009628,56.05
1,33,2022,2055,0.0015203,0.0009595,55.10
1,34,2022,2056,0.0015540,0.0009460,54.15
1,35,2022,2057,0.0015941,0.0009278,53.20
1,36,2022,2058,0.0016525,0.0009267,52.25
1,37,2022,2059,0.0017318,0.0009409,51.30
1,38,2022,2060,0.0018255,0.0009749,50.35
1,39,2022,2061,0.0019305,0.0010264,49.40
1,40,2022,2062,0.0020513,0.0010942,48.45
1,41,2022,2063,0.0021897,0.0011776,47.50
1,42,2022,2064,0.0023342,0.0012625,46.56
1,43,2022,2065,0.0024669,0.0013302,45.61
1,44,2022,2066,0.0025867,0.0013747,44.67
1,45,2022,2067,0.0027191,0.0014037,43.73
1,46,2022,2068,0.0028925,0.0014656,42.79
1,47,2022,2069,0.0031101,0.0015591,41.86
1,48,2022,2070,0.0033571,0.0016780,40.92
1,49,2022,2071,0.0036304,0.0018065,39.99
1,50,2022,2072,0.0039379,0.0019352,39.06
1,51,2022,2073,0.0042708,0.0020682,38.14
1,52,2022,2074,0.0046082,0.0021939,37.21
1,53,2022,2075,0.0049489,0.0022955,36.29
1,54,2022,2076,0.0053157,0.0024063,35.38
1,55,2022,2077,0.0057365,0.0025414,34.46
1,56,2022,2078,0.0062406,0.0027434,33.55
1,57,2022,2079,0.0068502,0.0030195,32.64
1,58,2022,2080,0.0075521,0.0033634,31.74
1,59,2022,2081,0.0083035,0.0037200,30.84
1,60,2022,2082,0.0090849,0.0040572,29.95
1,61,2022,2083,0.0099105,0.0043853,29.07
1,62,2022,2084,0.0107829,0.0047013,28.20
1,63,2022,2085,0.0116995,0.0050134,27.33
1,64,2022,2086,0.0126957,0.0053665,26.47
1,65,2022,2087,0.0138071,0.0057774,25.61
1,66,2022,2088,0.0150054,0.0062262,24.75
1,67,2022,2089,0.0162315,0.0066196,23.90
1,68,2022,2090,0.0174919,0.0069474,23.06
1,69,2022,2091,0.0188954,0.0073186,22.22
1,70,2022,2092,0.0205786,0.0078429,21.38
1,71,2022,2093,0.0226142,0.0086229,20.54
1,72,2022,2094,0.0250119,0.0096865,19.72
1,73,2022,2095,0.0277519,0.0110133,18.91
1,74,2022,2096,0.0307579,0.0125579,18.11
1,75,2022,2097,0.0339099,0.0141690,17.33
1,76,2022,2098,0.0371478,0.0157341,16.58
1,77,2022,2099,0.0405123,0.0172220,15.83
1,78,2022,2100,0.0440886,0.0186765,15.10
1,79,2022,2101,0.0480027,0.0202291,14.38
1,80,2022,2102,0.0536037,0.0236840,13.67
1,81,2022,2103,0.0586892,0.0260668,12.99
1,82,2022,2104,0.0642414,0.0286741,12.32
1,83,2022,2105,0.0702997,0.0315624,11.67
1,84,2022,2106,0.0769067,0.0348303,11.03
1,85,2022,2107,0.0841076,0.0385297,10.41
1,86,2022,2108,0.0919504,0.0427250,9.81
1,87,2022,2109,0.1004863,0.0474449,9.23
1,88,2022,2110,0.1097689,0.0527274,8.66
1,89,2022,2111,0.1198550,0.0586517,8.11
1,90,2022,2112,0.1308036,0.0652978,7.59
1,91,2022,2113,0.1426766,0.0727433,7.08
1,92,2022,2114,0.1555375,0.0810292,6.60
1,93,2022,2115,0.1694519,0.0902092,6.14
1,94,2022,2116,0.1844867,0.1004100,5.70
1,95,2022,2117,0.2007091,0.1117924,5.28
1,96,2022,2118,0.2181866,0.1244867,4.88
1,97,2022,2119,0.2369856,0.1385560,4.50
1,98,2022,2120,0.2571705,0.1540872,4.15
1,99,2022,2121,0.2788028,0.1712628,3.81
1,100,2022,2122,0.3019394,0.1903006,3.49
1,101,2022,2123,0.3266317,0.2113700,3.20
1,102,2022,2124,0.3529236,0.2345460,2.92
1,103,2022,2125,0.3808502,0.2599252,2.66
1,104,2022,2126,0.4104359,0.2877108,2.42
1,105,2022,2127,0.4416930,0.3181291,2.20
1,106,2022,2128,0.4746198,0.3513248,2.00
1,107,2022,2129,0.5091990,0.3873154,1.80
1,108,2022,2130,0.5453968,0.4261242,1.63
1,109,2022,2131,0.5831612,0.4678609,1.47
1,110,2022,2132,0.6224217,0.5126138,1.32
1,111,2022,2133,0.6630882,0.5603449,1.18
1,112,2022,2134,0.7050519,0.6108742,1.06
1,113,2022,2135,0.7481851,0.6640170,0.93
1,114,2022,2136,0.7923424,0.7196208,0.78
1,115,2022,2137,1.0000000,1.0000000,0.50
1,0,2023,2023,0.0091941,0.0059244,86.66
1,1,2023,2024,0.0006668,0.0003392,86.17
1,2,2023,2025,0.0003367,0.0001688,85.20
1,3,2023,2026,0.0002291,0.0001107,84.21
1,4,2023,2027,0.0001930,0.0000916,83.22
1,5,2023,2028,0.0001870,0.0000902,82.23
1,6,2023,2029,0.0001837,0.0000892,81.24
1,7,2023,2030,0.0001828,0.0000894,80.25
1,8,2023,2031,0.0001845,0.0000907,79.25
1,9,2023,2032,0.0001904,0.0000950,78.26
1,10,2023,2033,0.0002017,0.0001035,77.27
1,11,2023,2034,0.0002200,0.0001163,76.28
1,12,2023,2035,0.0002484,0.0001354,75.28
1,13,2023,2036,0.0002934,0.0001668,74.29
1,14,2023,2037,0.0003624,0.0002190,73.31
1,15,2023,2038,0.0004596,0.0002975,72.32
1,16,2023,2039,0.0005802,0.0003973,71.34
1,17,2023,2040,0.0007098,0.0005027,70.37
1,18,2023,2041,0.0008321,0.0006001,69.41
1,19,2023,2042,0.0009391,0.0006827,68.45
1,20,2023,2043,0.0010297,0.0007495,67.49
1,21,2023,2044,0.0011033,0.0007985,66.54
1,22,2023,2045,0.0011584,0.0008304,65.60
1,23,2023,2046,0.0011978,0.0008534,64.65
1,24,2023,2047,0.0012275,0.0008713,63.71
1,25,2023,2048,0.0012521,0.0008782,62.76
1,26,2023,2049,0.0012759,0.0008812,61.82
1,27,2023,2050,0.0013058,0.0008904,60.87
1,28,2023,2051,0.0013446,0.0009168,59.92
1,29,2023,2052,0.0013859,0.0009402,58.98
1,30,2023,2053,0.0014216,0.0009481,58.03
1,31,2023,2054,0.0014530,0.0009501,57.09
1,32,2023,2055,0.0014859,0.0009521,56.14
1,33,2023,2056,0.0015203,0.0009483,55.20
1,34,2023,2057,0.0015540,0.0009350,54.25
1,35,2023,2058,0.0015941,0.0009172,53.30
1,36,2023,2059,0.0016525,0.0009154,52.35
1,37,2023,2060,0.0017318,0.0009280,51.39
1,38,2023,2061,0.0018255,0.0009611,50.44
1,39,2023,2062,0.0019305,0.0010129,49.49
1,40,2023,2063,0.0020513,0.0010813,48.54
1,41,2023,2064,0.0021897,0.0011637,47.59
1,42,2023,2065,0.0023342,0.0012468,46.65
1,43,2023,2066,0.0024669,0.0013135,45.70
1,44,2023,2067,0.0025867,0.0013584,44.76
1,45,2023,2068,0.0027191,0.0013878,43.82
1,46,2023,2069,0.0028925,0.0014482,42.88
1,47,2023,2070,0.0031101,0.0015389,41.94
1,48,2023,2071,0.0033571,0.0016561,41.01
1,49,2023,2072,0.0036304,0.0017846,40.08
1,50,2023,2073,0.0039379,0.0019136,39.15
1,51,2023,2074,0.0042708,0.0020447,38.22
1,52,2023,2075,0.0046082,0.0021667,37.30
1,53,2023,2076,0.0049489,0.0022658,36.38
1,54,2023,2077,0.0053157,0.0023765,35.46
1,55,2023,2078,0.0057365,0.0025118,34.54
1,56,2023,2079,0.0062406,0.0027105,33.63
1,57,2023,2080,0.0068502,0.0029806,32.72
1,58,2023,2081,0.0075521,0.0033202,31.81
1,59,2023,2082,0.0083035,0.0036761,30.92
1,60,2023,2083,0.0090849,0.0040134,30.03
1,61,2023,2084,0.0099105,0.0043370,29.15
1,62,2023,2085,0.0107829,0.0046447,28.27
1,63,2023,2086,0.0116995,0.0049512,27.40
1,64,2023,2087,0.0126957,0.0053036,26.54
1,65,2023,2088,0.0138071,0.0057146,25.68
1,66,2023,2089,0.0150054,0.0061569,24.82
1,67,2023,2090,0.0162315,0.0065387,23.97
1,68,2023,2091,0.0174919,0.0068590,23.13
1,69,2023,2092,0.0188954,0.0072297,22.28
1,70,2023,2093,0.0205786,0.0077542,21.44
1,71,2023,2094,0.0226142,0.0085240,20.61
1,72,2023,2095,0.0250119,0.0095688,19.78
1,73,2023,2096,0.0277519,0.0108814,18.96
1,74,2023,2097,0.0307579,0.0124222,18.17
1,75,2023,2098,0.0339099,0.0140327,17.39
1,76,2023,2099,0.0371478,0.0155834,16.63
1,77,2023,2100,0.0405123,0.0170453,15.89
1,78,2023,2101,0.0440886,0.0184817,15.15
1,79,2023,2102,0.0480027,0.0200313,14.43
1,80,2023,2103,0.0536037,0.0234826,13.71
1,81,2023,2104,0.0586892,0.0258421,13.03
1,82,2023,2105,0.0642414,0.0284087,12.36
1,83,2023,2106,0.0702997,0.0312686,11.71
1,84,2023,2107,0.0769067,0.0345312,11.07
1,85,2023,2108,0.0841076,0.0382297,10.45
1,86,2023,2109,0.0919504,0.0423920,9.85
1,87,2023,2110,0.1004863,0.0470537,9.26
1,88,2023,2111,0.1097689,0.0522967,8.69
1,89,2023,2112,0.1198550,0.0582162,8.14
1,90,2023,2113,0.1308036,0.0648665,7.62
1,91,2023,2114,0.1426766,0.0722720,7.11
1,92,2023,2115,0.1555375,0.0804812,6.62
1,93,2023,2116,0.1694519,0.0896106,6.16
1,94,2023,2117,0.1844867,0.0998091,5.72
1,95,2023,2118,0.2007091,0.1111980,5.30
1,96,2023,2119,0.2181866,0.1238363,4.90
1,97,2023,2120,0.2369856,0.1378057,4.52
1,98,2023,2121,0.2571705,0.1532786,4.16
1,99,2023,2122,0.2788028,0.1704637,3.82
1,100,2023,2123,0.3019394,0.1895261,3.51
1,101,2023,2124,0.3266317,0.2105429,3.21
1,102,2023,2125,0.3529236,0.2336136,2.93
1,103,2023,2126,0.3808502,0.2589439,2.67
1,104,2023,2127,0.4104359,0.2867672,2.43
1,105,2023,2128,0.4416930,0.3172444,2.21
1,106,2023,2129,0.4746198,0.3504157,2.00
1,107,2023,2130,0.5091990,0.3863309,1.81
1,108,2023,2131,0.5453968,0.4251324,1.63
1,109,2023,2132,0.5831612,0.4669527,1.47
1,110,2023,2133,0.6224217,0.5118049,1.32
1,111,2023,2134,0.6630882,0.5595600,1.19
1,112,2023,2135,0.7050519,0.6100861,1.06
1,113,2023,2136,0.7481851,0.6632949,0.93
1,114,2023,2137,0.7923424,0.7190334,0.78
1,115,2023,2138,1.0000000,1.0000000,0.50
1,0,2024,2024,0.0091941,0.0056857,86.78
1,1,2024,2025,0.0006668,0.0003185,86.28
1,2,2024,2026,0.0003367,0.0001589,85.31
1,3,2024,2027,0.0002291,0.0001048,84.32
1,4,2024,2028,0.0001930,0.0000873,83.33
1,5,2024,2029,0.0001870,0.0000861,82.34
1,6,2024,2030,0.0001837,0.0000852,81.34
1,7,2024,2031,0.0001828,0.0000855,80.35
1,8,2024,2032,0.0001845,0.0000873,79.36
1,9,2024,2033,0.0001904,0.0000919,78.36
1,10,2024,2034,0.0002017,0.0001003,77.37
1,11,2024,2035,0.0002200,0.0001128,76.38
1,12,2024,2036,0.0002484,0.0001316,75.39
1,13,2024,2037,0.0002934,0.0001629,74.40
1,14,2024,2038,0.0003624,0.0002149,73.41
1,15,2024,2039,0.0004596,0.0002927,72.42
1,16,2024,2040,0.0005802,0.0003914,71.45
1,17,2024,2041,0.0007098,0.0004960,70.47
1,18,2024,2042,0.0008321,0.0005933,69.51
1,19,2024,2043,0.0009391,0.0006759,68.55
1,20,2024,2044,0.0010297,0.0007421,67.60
1,21,2024,2045,0.0011033,0.0007901,66.65
1,22,2024,2046,0.0011584,0.0008214,65.70
1,23,2024,2047,0.0011978,0.0008449,64.75
1,24,2024,2048,0.0012275,0.0008634,63.81
1,25,2024,2049,0.0012521,0.0008699,62.86
1,26,2024,2050,0.0012759,0.0008720,61.91
1,27,2024,2051,0.0013058,0.0008808,60.97
1,28,2024,2052,0.0013446,0.0009077,60.02
1,29,2024,2053,0.0013859,0.0009316,59.08
1,30,2024,2054,0.0014216,0.0009389,58.13
1,31,2024,2055,0.0014530,0.0009398,57.18
1,32,2024,2056,0.0014859,0.0009414,56.24
1,33,2024,2057,0.0015203,0.0009379,55.29
1,34,2024,2058,0.0015540,0.0009250,54.34
1,35,2024,2059,0.0015941,0.0009065,53.39
1,36,2024,2060,0.0016525,0.0009032,52.44
1,37,2024,2061,0.0017318,0.0009149,51.49
1,38,2024,2062,0.0018255,0.0009483,50.53
1,39,2024,2063,0.0019305,0.0010006,49.58
1,40,2024,2064,0.0020513,0.0010682,48.63
1,41,2024,2065,0.0021897,0.0011488,47.68
1,42,2024,2066,0.0023342,0.0012309,46.74
1,43,2024,2067,0.0024669,0.0012980,45.79
1,44,2024,2068,0.0025867,0.0013433,44.85
1,45,2024,2069,0.0027191,0.0013715,43.91
1,46,2024,2070,0.0028925,0.0014295,42.97
1,47,2024,2071,0.0031101,0.0015185,42.03
1,48,2024,2072,0.0033571,0.0016358,41.09
1,49,2024,2073,0.0036304,0.0017647,40.16
1,50,2024,2074,0.0039379,0.0018920,39.23
1,51,2024,2075,0.0042708,0.0020196,38.30
1,52,2024,2076,0.0046082,0.0021393,37.38
1,53,2024,2077,0.0049489,0.0022382,36.46
1,54,2024,2078,0.0053157,0.0023491,35.54
1,55,2024,2079,0.0057365,0.0024815,34.62
1,56,2024,2080,0.0062406,0.0026750,33.71
1,57,2024,2081,0.0068502,0.0029412,32.80
1,58,2024,2082,0.0075521,0.0032801,31.89
1,59,2024,2083,0.0083035,0.0036360,31.00
1,60,2024,2084,0.0090849,0.0039690,30.11
1,61,2024,2085,0.0099105,0.0042850,29.23
1,62,2024,2086,0.0107829,0.0045875,28.35
1,63,2024,2087,0.0116995,0.0048933,27.48
1,64,2024,2088,0.0126957,0.0052459,26.61
1,65,2024,2089,0.0138071,0.0056508,25.75
1,66,2024,2090,0.0150054,0.0060821,24.89
1,67,2024,2091,0.0162315,0.0064568,24.04
1,68,2024,2092,0.0174919,0.0067768,23.19
1,69,2024,2093,0.0188954,0.0071483,22.35
1,70,2024,2094,0.0205786,0.0076641,21.51
1,71,2024,2095,0.0226142,0.0084175,20.67
1,72,2024,2096,0.0250119,0.0094497,19.84
1,73,2024,2097,0.0277519,0.0107586,19.02
1,74,2024,2098,0.0307579,0.0122982,18.22
1,75,2024,2099,0.0339099,0.0138947,17.45
1,76,2024,2100,0.0371478,0.0154211,16.68
1,77,2024,2101,0.0405123,0.0168662,15.94
1,78,2024,2102,0.0440886,0.0183000,15.20
1,79,2024,2103,0.0480027,0.0198491,14.48
1,80,2024,2104,0.0536037,0.0232768,13.76
1,81,2024,2105,0.0586892,0.0255991,13.08
1,82,2024,2106,0.0642414,0.0281395,12.41
1,83,2024,2107,0.0702997,0.0309942,11.75
1,84,2024,2108,0.0769067,0.0342557,11.11
1,85,2024,2109,0.0841076,0.0379235,10.49
1,86,2024,2110,0.0919504,0.0420318,9.88
1,87,2024,2111,0.1004863,0.0466564,9.29
1,88,2024,2112,0.1097689,0.0518944,8.72
1,89,2024,2113,0.1198550,0.0578170,8.17
1,90,2024,2114,0.1308036,0.0644294,7.64
1,91,2024,2115,0.1426766,0.0717628,7.14
1,92,2024,2116,0.1555375,0.0799238,6.65
1,93,2024,2117,0.1694519,0.0890497,6.18
1,94,2024,2118,0.1844867,0.0992528,5.74
1,95,2024,2119,0.2007091,0.1105875,5.31
1,96,2024,2120,0.2181866,0.1231298,4.91
1,97,2024,2121,0.2369856,0.1370414,4.53
1,98,2024,2122,0.2571705,0.1525203,4.17
1,99,2024,2123,0.2788028,0.1697255,3.83
1,100,2024,2124,0.3019394,0.1887337,3.52
1,101,2024,2125,0.3266317,0.2096447,3.22
1,102,2024,2126,0.3529236,0.2326623,2.94
1,103,2024,2127,0.3808502,0.2580226,2.68
1,104,2024,2128,0.4104359,0.2858967,2.44
1,105,2024,2129,0.4416930,0.3163419,2.21
1,106,2024,2130,0.4746198,0.3494284,2.01
1,107,2024,2131,0.5091990,0.3853248,1.81
1,108,2024,2132,0.5453968,0.4241989,1.64
1,109,2024,2133,0.5831612,0.4661084,1.47
1,110,2024,2134,0.6224217,0.5109707,1.33
1,111,2024,2135,0.6630882,0.5587038,1.19
1,112,2024,2136,0.7050519,0.6092798,1.06
1,113,2024,2137,0.7481851,0.6626153,0.93
1,114,2024,2138,0.7923424,0.7184908,0.78
1,115,2024,2139,1.0000000,1.0000000,0.50
1,0,2025,2025,0.0091940,0.0054365,86.91
1,1,2025,2026,0.0006668,0.0002986,86.39
1,2,2025,2027,0.0003367,0.0001501,85.41
1,3,2025,2028,0.0002291,0.0000996,84.43
1,4,2025,2029,0.0001930,0.0000830,83.43
1,5,2025,2030,0.0001870,0.0000820,82.44
1,6,2025,2031,0.0001837,0.0000813,81.45
1,7,2025,2032,0.0001828,0.0000820,80.45
1,8,2025,2033,0.0001845,0.0000842,79.46
1,9,2025,2034,0.0001904,0.0000888,78.47
1,10,2025,2035,0.0002017,0.0000970,77.47
1,11,2025,2036,0.0002200,0.0001093,76.48
1,12,2025,2037,0.0002484,0.0001281,75.49
1,13,2025,2038,0.0002934,0.0001593,74.50
1,14,2025,2039,0.0003624,0.0002107,73.51
1,15,2025,2040,0.0004596,0.0002875,72.53
1,16,2025,2041,0.0005802,0.0003855,71.55
1,17,2025,2042,0.0007098,0.0004898,70.58
1,18,2025,2043,0.0008321,0.0005870,69.61
1,19,2025,2044,0.0009391,0.0006691,68.65
1,20,2025,2045,0.0010297,0.0007342,67.70
1,21,2025,2046,0.0011033,0.0007815,66.75
1,22,2025,2047,0.0011584,0.0008131,65.80
1,23,2025,2048,0.0011978,0.0008371,64.85
1,24,2025,2049,0.0012275,0.0008553,63.90
1,25,2025,2050,0.0012521,0.0008610,62.96
1,26,2025,2051,0.0012759,0.0008627,62.01
1,27,2025,2052,0.0013058,0.0008718,61.07
1,28,2025,2053,0.0013446,0.0008993,60.12
1,29,2025,2054,0.0013859,0.0009228,59.17
1,30,2025,2055,0.0014216,0.0009290,58.23
1,31,2025,2056,0.0014530,0.0009294,57.28
1,32,2025,2057,0.0014859,0.0009313,56.33
1,33,2025,2058,0.0015203,0.0009283,55.38
1,34,2025,2059,0.0015540,0.0009149,54.44
1,35,2025,2060,0.0015941,0.0008950,53.48
1,36,2025,2061,0.0016525,0.0008910,52.53
1,37,2025,2062,0.0017318,0.0009028,51.58
1,38,2025,2063,0.0018255,0.0009366,50.62
1,39,2025,2064,0.0019305,0.0009882,49.67
1,40,2025,2065,0.0020513,0.0010541,48.72
1,41,2025,2066,0.0021897,0.0011338,47.77
1,42,2025,2067,0.0023342,0.0012161,46.83
1,43,2025,2068,0.0024669,0.0012837,45.88
1,44,2025,2069,0.0025867,0.0013280,44.94
1,45,2025,2070,0.0027191,0.0013539,44.00
1,46,2025,2071,0.0028925,0.0014105,43.06
1,47,2025,2072,0.0031101,0.0014996,42.12
1,48,2025,2073,0.0033571,0.0016173,41.18
1,49,2025,2074,0.0036304,0.0017448,40.25
1,50,2025,2075,0.0039379,0.0018689,39.32
1,51,2025,2076,0.0042708,0.0019942,38.39
1,52,2025,2077,0.0046082,0.0021137,37.46
1,53,2025,2078,0.0049489,0.0022128,36.54
1,54,2025,2079,0.0053157,0.0023211,35.62
1,55,2025,2080,0.0057365,0.0024488,34.70
1,56,2025,2081,0.0062406,0.0026391,33.79
1,57,2025,2082,0.0068502,0.0029047,32.88
1,58,2025,2083,0.0075521,0.0032435,31.97
1,59,2025,2084,0.0083035,0.0035954,31.07
1,60,2025,2085,0.0090849,0.0039214,30.18
1,61,2025,2086,0.0099105,0.0042324,29.30
1,62,2025,2087,0.0107829,0.0045341,28.42
1,63,2025,2088,0.0116995,0.0048401,27.55
1,64,2025,2089,0.0126957,0.0051872,26.68
1,65,2025,2090,0.0138071,0.0055820,25.82
1,66,2025,2091,0.0150054,0.0060065,24.96
1,67,2025,2092,0.0162315,0.0063806,24.11
1,68,2025,2093,0.0174919,0.0067015,23.26
1,69,2025,2094,0.0188954,0.0070656,22.41
1,70,2025,2095,0.0205786,0.0075672,21.57
1,71,2025,2096,0.0226142,0.0083098,20.73
1,72,2025,2097,0.0250119,0.0093390,19.90
1,73,2025,2098,0.0277519,0.0106464,19.08
1,74,2025,2099,0.0307579,0.0121726,18.28
1,75,2025,2100,0.0339099,0.0137462,17.50
1,76,2025,2101,0.0371478,0.0152567,16.74
1,77,2025,2102,0.0405123,0.0166992,15.99
1,78,2025,2103,0.0440886,0.0181327,15.25
1,79,2025,2104,0.0480027,0.0196632,14.52
1,80,2025,2105,0.0536037,0.0230544,13.81
1,81,2025,2106,0.0586892,0.0253526,13.12
1,82,2025,2107,0.0642414,0.0278881,12.45
1,83,2025,2108,0.0702997,0.0307416,11.79
1,84,2025,2109,0.0769067,0.0339745,11.15
1,85,2025,2110,0.0841076,0.0375923,10.52
1,86,2025,2111,0.0919504,0.0416660,9.92
1,87,2025,2112,0.1004863,0.0462854,9.32
1,88,2025,2113,0.1097689,0.0515256,8.75
1,89,2025,2114,0.1198550,0.0574125,8.20
1,90,2025,2115,0.1308036,0.0639574,7.67
1,91,2025,2116,0.1426766,0.0712451,7.16
1,92,2025,2117,0.1555375,0.0794017,6.67
1,93,2025,2118,0.1694519,0.0885307,6.20
1,94,2025,2119,0.1844867,0.0986817,5.76
1,95,2025,2120,0.2007091,0.1099245,5.33
1,96,2025,2121,0.2181866,0.1224103,4.93
1,97,2025,2122,0.2369856,0.1363250,4.55
1,98,2025,2123,0.2571705,0.1518200,4.19
1,99,2025,2124,0.2788028,0.1689703,3.85
1,100,2025,2125,0.3019394,0.1878735,3.53
1,101,2025,2126,0.3266317,0.2087285,3.23
1,102,2025,2127,0.3529236,0.2317696,2.95
1,103,2025,2128,0.3808502,0.2571731,2.69
1,104,2025,2129,0.4104359,0.2850089,2.44
1,105,2025,2130,0.4416930,0.3153621,2.22
1,106,2025,2131,0.4746198,0.3484199,2.01
1,107,2025,2132,0.5091990,0.3843781,1.82
1,108,2025,2133,0.5453968,0.4233313,1.64
1,109,2025,2134,0.5831612,0.4652379,1.48
1,110,2025,2135,0.6224217,0.5100608,1.33
1,111,2025,2136,0.6630882,0.5578279,1.19
1,112,2025,2137,0.7050519,0.6085212,1.06
1,113,2025,2138,0.7481851,0.6619878,0.93
1,114,2025,2139,0.7923424,0.7179372,0.78
1,115,2025,2140,1.0000000,1.0000000,0.50
1,0,2026,2026,0.0091940,0.0051925,87.04
1,1,2026,2027,0.0006668,0.0002810,86.49
1,2,2026,2028,0.0003367,0.0001424,85.52
1,3,2026,2029,0.0002291,0.0000945,84.53
1,4,2026,2030,0.0001930,0.0000787,83.54
1,5,2026,2031,0.0001870,0.0000779,82.55
1,6,2026,2032,0.0001837,0.0000777,81.55
1,7,2026,2033,0.0001828,0.0000790,80.56
1,8,2026,2034,0.0001845,0.0000812,79.56
1,9,2026,2035,0.0001904,0.0000856,78.57
1,10,2026,2036,0.0002017,0.0000936,77.58
1,11,2026,2037,0.0002200,0.0001060,76.58
1,12,2026,2038,0.0002484,0.0001249,75.59
1,13,2026,2039,0.0002934,0.0001557,74.60
1,14,2026,2040,0.0003624,0.0002063,73.61
1,15,2026,2041,0.0004596,0.0002823,72.63
1,16,2026,2042,0.0005802,0.0003800,71.65
1,17,2026,2043,0.0007098,0.0004841,70.68
1,18,2026,2044,0.0008321,0.0005807,69.71
1,19,2026,2045,0.0009391,0.0006617,68.75
1,20,2026,2046,0.0010297,0.0007262,67.80
1,21,2026,2047,0.0011033,0.0007736,66.84
1,22,2026,2048,0.0011584,0.0008055,65.90
1,23,2026,2049,0.0011978,0.0008291,64.95
1,24,2026,2050,0.0012275,0.0008466,64.00
1,25,2026,2051,0.0012521,0.0008519,63.06
1,26,2026,2052,0.0012759,0.0008540,62.11
1,27,2026,2053,0.0013058,0.0008636,61.16
1,28,2026,2054,0.0013446,0.0008907,60.21
1,29,2026,2055,0.0013859,0.0009133,59.27
1,30,2026,2056,0.0014216,0.0009190,58.32
1,31,2026,2057,0.0014530,0.0009197,57.37
1,32,2026,2058,0.0014859,0.0009221,56.43
1,33,2026,2059,0.0015203,0.0009186,55.48
1,34,2026,2060,0.0015540,0.0009040,54.53
1,35,2026,2061,0.0015941,0.0008833,53.58
1,36,2026,2062,0.0016525,0.0008795,52.62
1,37,2026,2063,0.0017318,0.0008918,51.67
1,38,2026,2064,0.0018255,0.0009248,50.72
1,39,2026,2065,0.0019305,0.0009748,49.76
1,40,2026,2066,0.0020513,0.0010398,48.81
1,41,2026,2067,0.0021897,0.0011198,47.86
1,42,2026,2068,0.0023342,0.0012025,46.91
1,43,2026,2069,0.0024669,0.0012690,45.97
1,44,2026,2070,0.0025867,0.0013114,45.03
1,45,2026,2071,0.0027191,0.0013361,44.09
1,46,2026,2072,0.0028925,0.0013929,43.14
1,47,2026,2073,0.0031101,0.0014824,42.20
1,48,2026,2074,0.0033571,0.0015988,41.27
1,49,2026,2075,0.0036304,0.0017234,40.33
1,50,2026,2076,0.0039379,0.0018455,39.40
1,51,2026,2077,0.0042708,0.0019705,38.47
1,52,2026,2078,0.0046082,0.0020901,37.55
1,53,2026,2079,0.0049489,0.0021868,36.62
1,54,2026,2080,0.0053157,0.0022909,35.70
1,55,2026,2081,0.0057365,0.0024157,34.78
1,56,2026,2082,0.0062406,0.0026057,33.87
1,57,2026,2083,0.0068502,0.0028713,32.95
1,58,2026,2084,0.0075521,0.0032064,32.05
1,59,2026,2085,0.0083035,0.0035518,31.15
1,60,2026,2086,0.0090849,0.0038732,30.26
1,61,2026,2087,0.0099105,0.0041835,29.37
1,62,2026,2088,0.0107829,0.0044852,28.50
1,63,2026,2089,0.0116995,0.0047861,27.62
1,64,2026,2090,0.0126957,0.0051239,26.75
1,65,2026,2091,0.0138071,0.0055124,25.89
1,66,2026,2092,0.0150054,0.0059361,25.03
1,67,2026,2093,0.0162315,0.0063108,24.18
1,68,2026,2094,0.0174919,0.0066250,23.33
1,69,2026,2095,0.0188954,0.0069767,22.48
1,70,2026,2096,0.0205786,0.0074693,21.63
1,71,2026,2097,0.0226142,0.0082097,20.79
1,72,2026,2098,0.0250119,0.0092377,19.96
1,73,2026,2099,0.0277519,0.0105329,19.14
1,74,2026,2100,0.0307579,0.0120375,18.34
1,75,2026,2101,0.0339099,0.0135957,17.56
1,76,2026,2102,0.0371478,0.0151033,16.79
1,77,2026,2103,0.0405123,0.0165454,16.04
1,78,2026,2104,0.0440886,0.0179619,15.30
1,79,2026,2105,0.0480027,0.0194623,14.57
1,80,2026,2106,0.0536037,0.0228288,13.85
1,81,2026,2107,0.0586892,0.0251225,13.16
1,82,2026,2108,0.0642414,0.0276566,12.49
1,83,2026,2109,0.0702997,0.0304837,11.83
1,84,2026,2110,0.0769067,0.0336704,11.19
1,85,2026,2111,0.0841076,0.0372561,10.56
1,86,2026,2112,0.0919504,0.0413245,9.95
1,87,2026,2113,0.1004863,0.0459454,9.36
1,88,2026,2114,0.1097689,0.0511521,8.78
1,89,2026,2115,0.1198550,0.0569759,8.23
1,90,2026,2116,0.1308036,0.0634776,7.70
1,91,2026,2117,0.1426766,0.0707603,7.19
1,92,2026,2118,0.1555375,0.0789187,6.69
1,93,2026,2119,0.1694519,0.0879978,6.23
1,94,2026,2120,0.1844867,0.0980616,5.78
1,95,2026,2121,0.2007091,0.1092496,5.35
1,96,2026,2122,0.2181866,0.1217360,4.95
1,97,2026,2123,0.2369856,0.1356635,4.56
1,98,2026,2124,0.2571705,0.1511038,4.20
1,99,2026,2125,0.2788028,0.1681508,3.86
1,100,2026,2126,0.3019394,0.1869963,3.54
1,101,2026,2127,0.3266317,0.2078689,3.24
1,102,2026,2128,0.3529236,0.2309465,2.96
1,103,2026,2129,0.3808502,0.2563069,2.69
1,104,2026,2130,0.4104359,0.2840454,2.45
1,105,2026,2131,0.4416930,0.3143614,2.22
1,106,2026,2132,0.4746198,0.3474711,2.02
1,107,2026,2133,0.5091990,0.3834986,1.82
1,108,2026,2134,0.5453968,0.4224370,1.64
1,109,2026,2135,0.5831612,0.4642886,1.48
1,110,2026,2136,0.6224217,0.5091302,1.33
1,111,2026,2137,0.6630882,0.5570040,1.19
1,112,2026,2138,0.7050519,0.6078208,1.06
1,113,2026,2139,0.7481851,0.6613476,0.93
1,114,2026,2140,0.7923424,0.7173354,0.78
1,115,2026,2141,1.0000000,1.0000000,0.50
1,0,2027,2027,0.0091940,0.0049727,87.17
1,1,2027,2028,0.0006668,0.0002657,86.60
1,2,2027,2029,0.0003367,0.0001350,85.62
1,3,2027,2030,0.0002291,0.0000893,84.64
1,4,2027,2031,0.0001930,0.0000744,83.64
1,5,2027,2032,0.0001870,0.0000743,82.65
1,6,2027,2033,0.0001837,0.0000746,81.66
1,7,2027,2034,0.0001828,0.0000759,80.66
1,8,2027,2035,0.0001845,0.0000780,79.67
1,9,2027,2036,0.0001904,0.0000824,78.67
1,10,2027,2037,0.0002017,0.0000906,77.68
1,11,2027,2038,0.0002200,0.0001031,76.69
1,12,2027,2039,0.0002484,0.0001217,75.69
1,13,2027,2040,0.0002934,0.0001518,74.70
1,14,2027,2041,0.0003624,0.0002018,73.72
1,15,2027,2042,0.0004596,0.0002775,72.73
1,16,2027,2043,0.0005802,0.0003750,71.75
1,17,2027,2044,0.0007098,0.0004784,70.78
1,18,2027,2045,0.0008321,0.0005739,69.81
1,19,2027,2046,0.0009391,0.0006542,68.85
1,20,2027,2047,0.0010297,0.0007187,67.90
1,21,2027,2048,0.0011033,0.0007663,66.94
1,22,2027,2049,0.0011584,0.0007977,65.99
1,23,2027,2050,0.0011978,0.0008205,65.05
1,24,2027,2051,0.0012275,0.0008378,64.10
1,25,2027,2052,0.0012521,0.0008435,63.15
1,26,2027,2053,0.0012759,0.0008459,62.21
1,27,2027,2054,0.0013058,0.0008551,61.26
1,28,2027,2055,0.0013446,0.0008814,60.31
1,29,2027,2056,0.0013859,0.0009036,59.36
1,30,2027,2057,0.0014216,0.0009096,58.42
1,31,2027,2058,0.0014530,0.0009108,57.47
1,32,2027,2059,0.0014859,0.0009128,56.52
1,33,2027,2060,0.0015203,0.0009082,55.57
1,34,2027,2061,0.0015540,0.0008930,54.62
1,35,2027,2062,0.0015941,0.0008725,53.67
1,36,2027,2063,0.0016525,0.0008691,52.72
1,37,2027,2064,0.0017318,0.0008805,51.76
1,38,2027,2065,0.0018255,0.0009121,50.81
1,39,2027,2066,0.0019305,0.0009613,49.85
1,40,2027,2067,0.0020513,0.0010266,48.90
1,41,2027,2068,0.0021897,0.0011069,47.95
1,42,2027,2069,0.0023342,0.0011886,47.00
1,43,2027,2070,0.0024669,0.0012532,46.06
1,44,2027,2071,0.0025867,0.0012946,45.12
1,45,2027,2072,0.0027191,0.0013196,44.17
1,46,2027,2073,0.0028925,0.0013769,43.23
1,47,2027,2074,0.0031101,0.0014653,42.29
1,48,2027,2075,0.0033571,0.0015790,41.35
1,49,2027,2076,0.0036304,0.0017018,40.42
1,50,2027,2077,0.0039379,0.0018236,39.48
1,51,2027,2078,0.0042708,0.0019487,38.56
1,52,2027,2079,0.0046082,0.0020659,37.63
1,53,2027,2080,0.0049489,0.0021587,36.71
1,54,2027,2081,0.0053157,0.0022603,35.79
1,55,2027,2082,0.0057365,0.0023851,34.86
1,56,2027,2083,0.0062406,0.0025752,33.95
1,57,2027,2084,0.0068502,0.0028376,33.03
1,58,2027,2085,0.0075521,0.0031666,32.13
1,59,2027,2086,0.0083035,0.0035076,31.23
1,60,2027,2087,0.0090849,0.0038283,30.33
1,61,2027,2088,0.0099105,0.0041385,29.45
1,62,2027,2089,0.0107829,0.0044354,28.57
1,63,2027,2090,0.0116995,0.0047278,27.69
1,64,2027,2091,0.0126957,0.0050599,26.82
1,65,2027,2092,0.0138071,0.0054476,25.96
1,66,2027,2093,0.0150054,0.0058715,25.10
1,67,2027,2094,0.0162315,0.0062399,24.24
1,68,2027,2095,0.0174919,0.0065427,23.39
1,69,2027,2096,0.0188954,0.0068868,22.54
1,70,2027,2097,0.0205786,0.0073782,21.70
1,71,2027,2098,0.0226142,0.0081181,20.85
1,72,2027,2099,0.0250119,0.0091354,20.02
1,73,2027,2100,0.0277519,0.0104107,19.20
1,74,2027,2101,0.0307579,0.0119007,18.40
1,75,2027,2102,0.0339099,0.0134554,17.61
1,76,2027,2103,0.0371478,0.0149621,16.84
1,77,2027,2104,0.0405123,0.0163884,16.09
1,78,2027,2105,0.0440886,0.0177774,15.35
1,79,2027,2106,0.0480027,0.0192587,14.62
1,80,2027,2107,0.0536037,0.0226182,13.90
1,81,2027,2108,0.0586892,0.0249106,13.21
1,82,2027,2109,0.0642414,0.0274204,12.53
1,83,2027,2110,0.0702997,0.0302049,11.87
1,84,2027,2111,0.0769067,0.0333619,11.23
1,85,2027,2112,0.0841076,0.0369422,10.60
1,86,2027,2113,0.0919504,0.0410116,9.98
1,87,2027,2114,0.1004863,0.0456011,9.39
1,88,2027,2115,0.1097689,0.0507490,8.82
1,89,2027,2116,0.1198550,0.0565322,8.26
1,90,2027,2117,0.1308036,0.0630285,7.72
1,91,2027,2118,0.1426766,0.0703120,7.21
1,92,2027,2119,0.1555375,0.0784230,6.72
1,93,2027,2120,0.1694519,0.0874196,6.25
1,94,2027,2121,0.1844867,0.0974305,5.80
1,95,2027,2122,0.2007091,0.1086172,5.37
1,96,2027,2123,0.2181866,0.1211136,4.96
1,97,2027,2124,0.2369856,0.1349872,4.58
1,98,2027,2125,0.2571705,0.1503267,4.22
1,99,2027,2126,0.2788028,0.1673153,3.87
1,100,2027,2127,0.3019394,0.1861735,3.55
1,101,2027,2128,0.3266317,0.2070767,3.25
1,102,2027,2129,0.3529236,0.2301075,2.97
1,103,2027,2130,0.3808502,0.2553671,2.70
1,104,2027,2131,0.4104359,0.2830617,2.46
1,105,2027,2132,0.4416930,0.3134204,2.23
1,106,2027,2133,0.4746198,0.3465900,2.02
1,107,2027,2134,0.5091990,0.3825922,1.83
1,108,2027,2135,0.5453968,0.4214621,1.65
1,109,2027,2136,0.5831612,0.4633181,1.48
1,110,2027,2137,0.6224217,0.5082552,1.33
1,111,2027,2138,0.6630882,0.5562435,1.19
1,112,2027,2139,0.7050519,0.6071064,1.06
1,113,2027,2140,0.7481851,0.6606517,0.94
1,114,2027,2141,0.7923424,0.7167194,0.78
1,115,2027,2142,1.0000000,1.0000000,0.50
1,0,2028,2028,0.0091939,0.0047775,87.29
1,1,2028,2029,0.0006668,0.0002508,86.71
1,2,2028,2030,0.0003367,0.0001273,85.73
1,3,2028,2031,0.0002291,0.0000843,84.74
1,4,2028,2032,0.0001930,0.0000707,83.75
1,5,2028,2033,0.0001870,0.0000710,82.75
1,6,2028,2034,0.0001837,0.0000715,81.76
1,7,2028,2035,0.0001828,0.0000727,80.76
1,8,2028,2036,0.0001845,0.0000749,79.77
1,9,2028,2037,0.0001904,0.0000795,78.78
1,10,2028,2038,0.0002017,0.0000879,77.78
1,11,2028,2039,0.0002200,0.0001003,76.79
1,12,2028,2040,0.0002484,0.0001183,75.80
1,13,2028,2041,0.0002934,0.0001480,74.81
1,14,2028,2042,0.0003624,0.0001977,73.82
1,15,2028,2043,0.0004596,0.0002732,72.83
1,16,2028,2044,0.0005802,0.0003699,71.85
1,17,2028,2045,0.0007098,0.0004723,70.88
1,18,2028,2046,0.0008321,0.0005670,69.91
1,19,2028,2047,0.0009391,0.0006472,68.95
1,20,2028,2048,0.0010297,0.0007119,67.99
1,21,2028,2049,0.0011033,0.0007589,67.04
1,22,2028,2050,0.0011584,0.0007893,66.09
1,23,2028,2051,0.0011978,0.0008118,65.14
1,24,2028,2052,0.0012275,0.0008295,64.20
1,25,2028,2053,0.0012521,0.0008356,63.25
1,26,2028,2054,0.0012759,0.0008376,62.30
1,27,2028,2055,0.0013058,0.0008458,61.35
1,28,2028,2056,0.0013446,0.0008719,60.41
1,29,2028,2057,0.0013859,0.0008945,59.46
1,30,2028,2058,0.0014216,0.0009010,58.51
1,31,2028,2059,0.0014530,0.0009018,57.56
1,32,2028,2060,0.0014859,0.0009028,56.61
1,33,2028,2061,0.0015203,0.0008977,55.67
1,34,2028,2062,0.0015540,0.0008827,54.71
1,35,2028,2063,0.0015941,0.0008626,53.76
1,36,2028,2064,0.0016525,0.0008585,52.81
1,37,2028,2065,0.0017318,0.0008685,51.85
1,38,2028,2066,0.0018255,0.0008992,50.90
1,39,2028,2067,0.0019305,0.0009487,49.94
1,40,2028,2068,0.0020513,0.0010143,48.99
1,41,2028,2069,0.0021897,0.0010937,48.04
1,42,2028,2070,0.0023342,0.0011736,47.09
1,43,2028,2071,0.0024669,0.0012373,46.15
1,44,2028,2072,0.0025867,0.0012790,45.20
1,45,2028,2073,0.0027191,0.0013047,44.26
1,46,2028,2074,0.0028925,0.0013609,43.32
1,47,2028,2075,0.0031101,0.0014469,42.38
1,48,2028,2076,0.0033571,0.0015590,41.44
1,49,2028,2077,0.0036304,0.0016817,40.50
1,50,2028,2078,0.0039379,0.0018035,39.57
1,51,2028,2079,0.0042708,0.0019263,38.64
1,52,2028,2080,0.0046082,0.0020399,37.71
1,53,2028,2081,0.0049489,0.0021303,36.79
1,54,2028,2082,0.0053157,0.0022319,35.87
1,55,2028,2083,0.0057365,0.0023570,34.94
1,56,2028,2084,0.0062406,0.0025444,34.03
1,57,2028,2085,0.0068502,0.0028014,33.11
1,58,2028,2086,0.0075521,0.0031264,32.20
1,59,2028,2087,0.0083035,0.0034666,31.30
1,60,2028,2088,0.0090849,0.0037871,30.41
1,61,2028,2089,0.0099105,0.0040928,29.52
1,62,2028,2090,0.0107829,0.0043817,28.64
1,63,2028,2091,0.0116995,0.0046688,27.77
1,64,2028,2092,0.0126957,0.0050004,26.89
1,65,2028,2093,0.0138071,0.0053882,26.03
1,66,2028,2094,0.0150054,0.0058060,25.17
1,67,2028,2095,0.0162315,0.0061636,24.31
1,68,2028,2096,0.0174919,0.0064595,23.46
1,69,2028,2097,0.0188954,0.0068031,22.61
1,70,2028,2098,0.0205786,0.0072950,21.76
1,71,2028,2099,0.0226142,0.0080257,20.91
1,72,2028,2100,0.0250119,0.0090253,20.08
1,73,2028,2101,0.0277519,0.0102871,19.26
1,74,2028,2102,0.0307579,0.0117731,18.45
1,75,2028,2103,0.0339099,0.0133263,17.67
1,76,2028,2104,0.0371478,0.0148180,16.90
1,77,2028,2105,0.0405123,0.0162187,16.15
1,78,2028,2106,0.0440886,0.0175904,15.40
1,79,2028,2107,0.0480027,0.0190688,14.67
1,80,2028,2108,0.0536037,0.0224243,13.95
1,81,2028,2109,0.0586892,0.0246944,13.25
1,82,2028,2110,0.0642414,0.0271651,12.58
1,83,2028,2111,0.0702997,0.0299220,11.91
1,84,2028,2112,0.0769067,0.0330739,11.27
1,85,2028,2113,0.0841076,0.0366548,10.63
1,86,2028,2114,0.0919504,0.0406949,10.02
1,87,2028,2115,0.1004863,0.0452297,9.42
1,88,2028,2116,0.1097689,0.0503394,8.85
1,89,2028,2117,0.1198550,0.0561170,8.29
1,90,2028,2118,0.1308036,0.0626133,7.75
1,91,2028,2119,0.1426766,0.0698520,7.24
1,92,2028,2120,0.1555375,0.0778852,6.74
1,93,2028,2121,0.1694519,0.0868312,6.27
1,94,2028,2122,0.1844867,0.0968394,5.82
1,95,2028,2123,0.2007091,0.1080338,5.39
1,96,2028,2124,0.2181866,0.1204775,4.98
1,97,2028,2125,0.2369856,0.1342536,4.59
1,98,2028,2126,0.2571705,0.1495349,4.23
1,99,2028,2127,0.2788028,0.1665321,3.88
1,100,2028,2128,0.3019394,0.1854155,3.56
1,101,2028,2129,0.3266317,0.2062694,3.26
1,102,2028,2130,0.3529236,0.2291975,2.97
1,103,2028,2131,0.3808502,0.2544079,2.71
1,104,2028,2132,0.4104359,0.2821369,2.46
1,105,2028,2133,0.4416930,0.3125467,2.24
1,106,2028,2134,0.4746198,0.3456820,2.02
1,107,2028,2135,0.5091990,0.3816043,1.83
1,108,2028,2136,0.5453968,0.4204655,1.65
1,109,2028,2137,0.5831612,0.4624056,1.49
1,110,2028,2138,0.6224217,0.5074475,1.34
1,111,2028,2139,0.6630882,0.5554679,1.20
1,112,2028,2140,0.7050519,0.6063299,1.07
1,113,2028,2141,0.7481851,0.6599396,0.94
1,114,2028,2142,0.7923424,0.7161395,0.78
1,115,2028,2143,1.0000000,1.0000000,0.50
1,0,2029,2029,0.0091939,0.0045854,87.41
1,1,2029,2030,0.0006668,0.0002356,86.81
1,2,2029,2031,0.0003367,0.0001199,85.83
1,3,2029,2032,0.0002291,0.0000798,84.84
1,4,2029,2033,0.0001930,0.0000673,83.85
1,5,2029,2034,0.0001870,0.0000679,82.86
1,6,2029,2035,0.0001837,0.0000683,81.86
1,7,2029,2036,0.0001828,0.0000696,80.87
1,8,2029,2037,0.0001845,0.0000720,79.87
1,9,2029,2038,0.0001904,0.0000769,78.88
1,10,2029,2039,0.0002017,0.0000852,77.88
1,11,2029,2040,0.0002200,0.0000972,76.89
1,12,2029,2041,0.0002484,0.0001150,75.90
1,13,2029,2042,0.0002934,0.0001445,74.91
1,14,2029,2043,0.0003624,0.0001940,73.92
1,15,2029,2044,0.0004596,0.0002688,72.93
1,16,2029,2045,0.0005802,0.0003645,71.95
1,17,2029,2046,0.0007098,0.0004661,70.98
1,18,2029,2047,0.0008321,0.0005606,70.01
1,19,2029,2048,0.0009391,0.0006409,69.05
1,20,2029,2049,0.0010297,0.0007049,68.09
1,21,2029,2050,0.0011033,0.0007509,67.14
1,22,2029,2051,0.0011584,0.0007808,66.19
1,23,2029,2052,0.0011978,0.0008037,65.24
1,24,2029,2053,0.0012275,0.0008219,64.29
1,25,2029,2054,0.0012521,0.0008276,63.35
1,26,2029,2055,0.0012759,0.0008286,62.40
1,27,2029,2056,0.0013058,0.0008365,61.45
1,28,2029,2057,0.0013446,0.0008631,60.50
1,29,2029,2058,0.0013859,0.0008863,59.55
1,30,2029,2059,0.0014216,0.0008923,58.61
1,31,2029,2060,0.0014530,0.0008922,57.66
1,32,2029,2061,0.0014859,0.0008927,56.71
1,33,2029,2062,0.0015203,0.0008879,55.76
1,34,2029,2063,0.0015540,0.0008733,54.81
1,35,2029,2064,0.0015941,0.0008526,53.85
1,36,2029,2065,0.0016525,0.0008471,52.90
1,37,2029,2066,0.0017318,0.0008563,51.94
1,38,2029,2067,0.0018255,0.0008873,50.99
1,39,2029,2068,0.0019305,0.0009371,50.03
1,40,2029,2069,0.0020513,0.0010019,49.08
1,41,2029,2070,0.0021897,0.0010795,48.13
1,42,2029,2071,0.0023342,0.0011584,47.18
1,43,2029,2072,0.0024669,0.0012224,46.23
1,44,2029,2073,0.0025867,0.0012649,45.29
1,45,2029,2074,0.0027191,0.0012897,44.35
1,46,2029,2075,0.0028925,0.0013438,43.40
1,47,2029,2076,0.0031101,0.0014282,42.46
1,48,2029,2077,0.0033571,0.0015404,41.52
1,49,2029,2078,0.0036304,0.0016632,40.58
1,50,2029,2079,0.0039379,0.0017830,39.65
1,51,2029,2080,0.0042708,0.0019022,38.72
1,52,2029,2081,0.0046082,0.0020135,37.79
1,53,2029,2082,0.0049489,0.0021040,36.87
1,54,2029,2083,0.0053157,0.0022060,35.95
1,55,2029,2084,0.0057365,0.0023287,35.02
1,56,2029,2085,0.0062406,0.0025113,34.11
1,57,2029,2086,0.0068502,0.0027647,33.19
1,58,2029,2087,0.0075521,0.0030889,32.28
1,59,2029,2088,0.0083035,0.0034288,31.38
1,60,2029,2089,0.0090849,0.0037451,30.49
1,61,2029,2090,0.0099105,0.0040434,29.60
1,62,2029,2091,0.0107829,0.0043274,28.72
1,63,2029,2092,0.0116995,0.0046139,27.84
1,64,2029,2093,0.0126957,0.0049458,26.97
1,65,2029,2094,0.0138071,0.0053280,26.10
1,66,2029,2095,0.0150054,0.0057355,25.23
1,67,2029,2096,0.0162315,0.0060864,24.38
1,68,2029,2097,0.0174919,0.0063821,23.52
1,69,2029,2098,0.0188954,0.0067267,22.67
1,70,2029,2099,0.0205786,0.0072109,21.82
1,71,2029,2100,0.0226142,0.0079263,20.98
1,72,2029,2101,0.0250119,0.0089140,20.14
1,73,2029,2102,0.0277519,0.0101720,19.32
1,74,2029,2103,0.0307579,0.0116558,18.51
1,75,2029,2104,0.0339099,0.0131945,17.72
1,76,2029,2105,0.0371478,0.0146623,16.95
1,77,2029,2106,0.0405123,0.0160469,16.20
1,78,2029,2107,0.0440886,0.0174159,15.45
1,79,2029,2108,0.0480027,0.0188941,14.72
1,80,2029,2109,0.0536037,0.0222266,13.99
1,81,2029,2110,0.0586892,0.0244608,13.30
1,82,2029,2111,0.0642414,0.0269061,12.62
1,83,2029,2112,0.0702997,0.0296581,11.95
1,84,2029,2113,0.0769067,0.0328102,11.30
1,85,2029,2114,0.0841076,0.0363639,10.67
1,86,2029,2115,0.0919504,0.0403532,10.05
1,87,2029,2116,0.1004863,0.0448524,9.46
1,88,2029,2117,0.1097689,0.0499563,8.88
1,89,2029,2118,0.1198550,0.0557332,8.32
1,90,2029,2119,0.1308036,0.0621873,7.78
1,91,2029,2120,0.1426766,0.0693530,7.26
1,92,2029,2121,0.1555375,0.0773382,6.77
1,93,2029,2122,0.1694519,0.0862804,6.29
1,94,2029,2123,0.1844867,0.0962942,5.84
1,95,2029,2124,0.2007091,0.1074376,5.41
1,96,2029,2125,0.2181866,0.1197877,5.00
1,97,2029,2126,0.2369856,0.1335064,4.61
1,98,2029,2127,0.2571705,0.1487928,4.24
1,99,2029,2128,0.2788028,0.1658106,3.90
1,100,2029,2129,0.3019394,0.1846433,3.57
1,101,2029,2130,0.3266317,0.2053941,3.27
1,102,2029,2131,0.3529236,0.2282691,2.98
1,103,2029,2132,0.3808502,0.2535065,2.72
1,104,2029,2133,0.4104359,0.2812784,2.47
1,105,2029,2134,0.4416930,0.3116466,2.24
1,106,2029,2135,0.4746198,0.3446929,2.03
1,107,2029,2136,0.5091990,0.3805949,1.83
1,108,2029,2137,0.5453968,0.4195289,1.65
1,109,2029,2138,0.5831612,0.4615636,1.49
1,110,2029,2139,0.6224217,0.5066241,1.34
1,111,2029,2140,0.6630882,0.5546251,1.20
1,112,2029,2141,0.7050519,0.6055354,1.07
1,113,2029,2142,0.7481851,0.6592693,0.94
1,114,2029,2143,0.7923424,0.7156034,0.78
1,115,2029,2144,1.0000000,1.0000000,0.50
1,0,2030,2030,0.0091939,0.0043851,87.53
1,1,2030,2031,0.0006668,0.0002209,86.92
1,2,2030,2032,0.0003367,0.0001133,85.94
1,3,2030,2033,0.0002291,0.0000758,84.95
1,4,2030,2034,0.0001930,0.0000641,83.95
1,5,2030,2035,0.0001870,0.0000646,82.96
1,6,2030,2036,0.0001837,0.0000652,81.96
1,7,2030,2037,0.0001828,0.0000668,80.97
1,8,2030,2038,0.0001845,0.0000695,79.97
1,9,2030,2039,0.0001904,0.0000744,78.98
1,10,2030,2040,0.0002017,0.0000824,77.98
1,11,2030,2041,0.0002200,0.0000942,76.99
1,12,2030,2042,0.0002484,0.0001119,76.00
1,13,2030,2043,0.0002934,0.0001413,75.01
1,14,2030,2044,0.0003624,0.0001903,74.02
1,15,2030,2045,0.0004596,0.0002641,73.03
1,16,2030,2046,0.0005802,0.0003591,72.05
1,17,2030,2047,0.0007098,0.0004603,71.08
1,18,2030,2048,0.0008321,0.0005548,70.11
1,19,2030,2049,0.0009391,0.0006343,69.15
1,20,2030,2050,0.0010297,0.0006973,68.19
1,21,2030,2051,0.0011033,0.0007428,67.24
1,22,2030,2052,0.0011584,0.0007729,66.29
1,23,2030,2053,0.0011978,0.0007961,65.34
1,24,2030,2054,0.0012275,0.0008140,64.39
1,25,2030,2055,0.0012521,0.0008188,63.44
1,26,2030,2056,0.0012759,0.0008195,62.49
1,27,2030,2057,0.0013058,0.0008278,61.54
1,28,2030,2058,0.0013446,0.0008550,60.60
1,29,2030,2059,0.0013859,0.0008779,59.65
1,30,2030,2060,0.0014216,0.0008830,58.70
1,31,2030,2061,0.0014530,0.0008824,57.75
1,32,2030,2062,0.0014859,0.0008833,56.80
1,33,2030,2063,0.0015203,0.0008789,55.85
1,34,2030,2064,0.0015540,0.0008637,54.90
1,35,2030,2065,0.0015941,0.0008418,53.95
1,36,2030,2066,0.0016525,0.0008357,52.99
1,37,2030,2067,0.0017318,0.0008450,52.04
1,38,2030,2068,0.0018255,0.0008763,51.08
1,39,2030,2069,0.0019305,0.0009253,50.12
1,40,2030,2070,0.0020513,0.0009884,49.17
1,41,2030,2071,0.0021897,0.0010651,48.22
1,42,2030,2072,0.0023342,0.0011443,47.27
1,43,2030,2073,0.0024669,0.0012089,46.32
1,44,2030,2074,0.0025867,0.0012507,45.38
1,45,2030,2075,0.0027191,0.0012736,44.43
1,46,2030,2076,0.0028925,0.0013265,43.49
1,47,2030,2077,0.0031101,0.0014109,42.55
1,48,2030,2078,0.0033571,0.0015232,41.61
1,49,2030,2079,0.0036304,0.0016442,40.67
1,50,2030,2080,0.0039379,0.0017608,39.73
1,51,2030,2081,0.0042708,0.0018778,38.80
1,52,2030,2082,0.0046082,0.0019890,37.88
1,53,2030,2083,0.0049489,0.0020799,36.95
1,54,2030,2084,0.0053157,0.0021798,36.03
1,55,2030,2085,0.0057365,0.0022983,35.10
1,56,2030,2086,0.0062406,0.0024779,34.18
1,57,2030,2087,0.0068502,0.0027306,33.27
1,58,2030,2088,0.0075521,0.0030545,32.36
1,59,2030,2089,0.0083035,0.0033904,31.45
1,60,2030,2090,0.0090849,0.0036999,30.56
1,61,2030,2091,0.0099105,0.0039936,29.67
1,62,2030,2092,0.0107829,0.0042768,28.79
1,63,2030,2093,0.0116995,0.0045636,27.91
1,64,2030,2094,0.0126957,0.0048904,27.04
1,65,2030,2095,0.0138071,0.0052631,26.17
1,66,2030,2096,0.0150054,0.0056642,25.30
1,67,2030,2097,0.0162315,0.0060146,24.44
1,68,2030,2098,0.0174919,0.0063114,23.59
1,69,2030,2099,0.0188954,0.0066495,22.74
1,70,2030,2100,0.0205786,0.0071205,21.88
1,71,2030,2101,0.0226142,0.0078258,21.04
1,72,2030,2102,0.0250119,0.0088103,20.20
1,73,2030,2103,0.0277519,0.0100661,19.37
1,74,2030,2104,0.0307579,0.0115362,18.57
1,75,2030,2105,0.0339099,0.0130522,17.78
1,76,2030,2106,0.0371478,0.0145046,17.01
1,77,2030,2107,0.0405123,0.0158866,16.25
1,78,2030,2108,0.0440886,0.0172555,15.50
1,79,2030,2109,0.0480027,0.0187160,14.77
1,80,2030,2110,0.0536037,0.0220129,14.04
1,81,2030,2111,0.0586892,0.0242238,13.34
1,82,2030,2112,0.0642414,0.0266645,12.66
1,83,2030,2113,0.0702997,0.0294164,12.00
1,84,2030,2114,0.0769067,0.0325433,11.34
1,85,2030,2115,0.0841076,0.0360502,10.71
1,86,2030,2116,0.0919504,0.0400064,10.09
1,87,2030,2117,0.1004863,0.0444996,9.49
1,88,2030,2118,0.1097689,0.0496023,8.91
1,89,2030,2119,0.1198550,0.0553396,8.35
1,90,2030,2120,0.1308036,0.0617255,7.81
1,91,2030,2121,0.1426766,0.0688457,7.29
1,92,2030,2122,0.1555375,0.0768262,6.79
1,93,2030,2123,0.1694519,0.0857724,6.31
1,94,2030,2124,0.1844867,0.0957372,5.86
1,95,2030,2125,0.2007091,0.1067914,5.43
1,96,2030,2126,0.2181866,0.1190854,5.01
1,97,2030,2127,0.2369856,0.1328062,4.62
1,98,2030,2128,0.2571705,0.1481093,4.26
1,99,2030,2129,0.2788028,0.1650758,3.91
1,100,2030,2130,0.3019394,0.1838062,3.58
1,101,2030,2131,0.3266317,0.2045012,3.28
1,102,2030,2132,0.3529236,0.2273968,2.99
1,103,2030,2133,0.3808502,0.2526699,2.72
1,104,2030,2134,0.4104359,0.2803943,2.48
1,105,2030,2135,0.4416930,0.3106663,2.25
1,106,2030,2136,0.4746198,0.3436823,2.04
1,107,2030,2137,0.5091990,0.3796464,1.84
1,108,2030,2138,0.5453968,0.4186648,1.66
1,109,2030,2139,0.5831612,0.4607054,1.49
1,110,2030,2140,0.6224217,0.5057295,1.34
1,111,2030,2141,0.6630882,0.5537630,1.20
1,112,2030,2142,0.7050519,0.6047878,1.07
1,113,2030,2143,0.7481851,0.6586496,0.94
1,114,2030,2144,0.7923424,0.7150553,0.78
1,115,2030,2145,1.0000000,1.0000000,0.50
1,0,2031,2031,0.0091938,0.0041889,87.65
1,1,2031,2032,0.0006668,0.0002080,87.02
1,2,2031,2033,0.0003367,0.0001075,86.04
1,3,2031,2034,0.0002291,0.0000720,85.05
1,4,2031,2035,0.0001930,0.0000608,84.05
1,5,2031,2036,0.0001870,0.0000615,83.06
1,6,2031,2037,0.0001837,0.0000623,82.06
1,7,2031,2038,0.0001828,0.0000643,81.07
1,8,2031,2039,0.0001845,0.0000670,80.07
1,9,2031,2040,0.0001904,0.0000717,79.08
1,10,2031,2041,0.0002017,0.0000796,78.09
1,11,2031,2042,0.0002200,0.0000914,77.09
1,12,2031,2043,0.0002484,0.0001092,76.10
1,13,2031,2044,0.0002934,0.0001382,75.11
1,14,2031,2045,0.0003624,0.0001863,74.12
1,15,2031,2046,0.0004596,0.0002594,73.13
1,16,2031,2047,0.0005802,0.0003540,72.15
1,17,2031,2048,0.0007098,0.0004550,71.18
1,18,2031,2049,0.0008321,0.0005488,70.21
1,19,2031,2050,0.0009391,0.0006273,69.25
1,20,2031,2051,0.0010297,0.0006897,68.29
1,21,2031,2052,0.0011033,0.0007352,67.34
1,22,2031,2053,0.0011584,0.0007655,66.38
1,23,2031,2054,0.0011978,0.0007884,65.44
1,24,2031,2055,0.0012275,0.0008055,64.49
1,25,2031,2056,0.0012521,0.0008100,63.54
1,26,2031,2057,0.0012759,0.0008111,62.59
1,27,2031,2058,0.0013058,0.0008198,61.64
1,28,2031,2059,0.0013446,0.0008468,60.69
1,29,2031,2060,0.0013859,0.0008689,59.74
1,30,2031,2061,0.0014216,0.0008735,58.79
1,31,2031,2062,0.0014530,0.0008732,57.84
1,32,2031,2063,0.0014859,0.0008746,56.89
1,33,2031,2064,0.0015203,0.0008697,55.94
1,34,2031,2065,0.0015540,0.0008535,54.99
1,35,2031,2066,0.0015941,0.0008309,54.04
1,36,2031,2067,0.0016525,0.0008250,53.08
1,37,2031,2068,0.0017318,0.0008346,52.13
1,38,2031,2069,0.0018255,0.0008651,51.17
1,39,2031,2070,0.0019305,0.0009126,50.21
1,40,2031,2071,0.0020513,0.0009749,49.26
1,41,2031,2072,0.0021897,0.0010518,48.31
1,42,2031,2073,0.0023342,0.0011315,47.36
1,43,2031,2074,0.0024669,0.0011954,46.41
1,44,2031,2075,0.0025867,0.0012356,45.46
1,45,2031,2076,0.0027191,0.0012574,44.52
1,46,2031,2077,0.0028925,0.0013104,43.57
1,47,2031,2078,0.0031101,0.0013950,42.63
1,48,2031,2079,0.0033571,0.0015056,41.69
1,49,2031,2080,0.0036304,0.0016238,40.75
1,50,2031,2081,0.0039379,0.0017383,39.82
1,51,2031,2082,0.0042708,0.0018552,38.89
1,52,2031,2083,0.0046082,0.0019666,37.96
1,53,2031,2084,0.0049489,0.0020555,37.03
1,54,2031,2085,0.0053157,0.0021516,36.11
1,55,2031,2086,0.0057365,0.0022676,35.18
1,56,2031,2087,0.0062406,0.0024468,34.26
1,57,2031,2088,0.0068502,0.0026994,33.35
1,58,2031,2089,0.0075521,0.0030195,32.43
1,59,2031,2090,0.0083035,0.0033491,31.53
1,60,2031,2091,0.0090849,0.0036542,30.64
1,61,2031,2092,0.0099105,0.0039471,29.75
1,62,2031,2093,0.0107829,0.0042305,28.86
1,63,2031,2094,0.0116995,0.0045126,27.98
1,64,2031,2095,0.0126957,0.0048307,27.11
1,65,2031,2096,0.0138071,0.0051974,26.24
1,66,2031,2097,0.0150054,0.0055978,25.37
1,67,2031,2098,0.0162315,0.0059489,24.51
1,68,2031,2099,0.0174919,0.0062399,23.65
1,69,2031,2100,0.0188954,0.0065665,22.80
1,70,2031,2101,0.0205786,0.0070291,21.95
1,71,2031,2102,0.0226142,0.0077322,21.10
1,72,2031,2103,0.0250119,0.0087150,20.26
1,73,2031,2104,0.0277519,0.0099581,19.43
1,74,2031,2105,0.0307579,0.0114070,18.62
1,75,2031,2106,0.0339099,0.0129081,17.83
1,76,2031,2107,0.0371478,0.0143576,17.06
1,77,2031,2108,0.0405123,0.0157391,16.30
1,78,2031,2109,0.0440886,0.0170919,15.55
1,79,2031,2110,0.0480027,0.0185236,14.81
1,80,2031,2111,0.0536037,0.0217962,14.08
1,81,2031,2112,0.0586892,0.0240028,13.39
1,82,2031,2113,0.0642414,0.0264433,12.70
1,83,2031,2114,0.0702997,0.0291720,12.04
1,84,2031,2115,0.0769067,0.0322557,11.38
1,85,2031,2116,0.0841076,0.0357317,10.75
1,86,2031,2117,0.0919504,0.0396820,10.12
1,87,2031,2118,0.1004863,0.0441737,9.52
1,88,2031,2119,0.1097689,0.0492393,8.94
1,89,2031,2120,0.1198550,0.0549130,8.38
1,90,2031,2121,0.1308036,0.0612560,7.83
1,91,2031,2122,0.1426766,0.0683710,7.31
1,92,2031,2123,0.1555375,0.0763542,6.81
1,93,2031,2124,0.1694519,0.0852536,6.33
1,94,2031,2125,0.1844867,0.0951337,5.88
1,95,2031,2126,0.2007091,0.1061335,5.44
1,96,2031,2127,0.2181866,0.1184274,5.03
1,97,2031,2128,0.2369856,0.1321617,4.64
1,98,2031,2129,0.2571705,0.1474136,4.27
1,99,2031,2130,0.2788028,0.1642796,3.92
1,100,2031,2131,0.3019394,0.1829526,3.59
1,101,2031,2132,0.3266317,0.2036626,3.29
1,102,2031,2133,0.3529236,0.2265874,3.00
1,103,2031,2134,0.3808502,0.2518086,2.73
1,104,2031,2135,0.4104359,0.2794317,2.48
1,105,2031,2136,0.4416930,0.3096652,2.25
1,106,2031,2137,0.4746198,0.3427330,2.04
1,107,2031,2138,0.5091990,0.3787716,1.84
1,108,2031,2139,0.5453968,0.4177843,1.66
1,109,2031,2140,0.5831612,0.4597732,1.50
1,110,2031,2141,0.6224217,0.5048146,1.34
1,111,2031,2142,0.6630882,0.5529519,1.20
1,112,2031,2143,0.7050519,0.6040968,1.07
1,113,2031,2144,0.7481851,0.6580163,0.94
1,114,2031,2145,0.7923424,0.7144591,0.79
1,115,2031,2146,1.0000000,1.0000000,0.50
1,0,2032,2032,0.0091938,0.0040123,87.77
1,1,2032,2033,0.0006668,0.0001967,87.12
1,2,2032,2034,0.0003367,0.0001019,86.14
1,3,2032,2035,0.0002291,0.0000681,85.15
1,4,2032,2036,0.0001930,0.0000575,84.16
1,5,2032,2037,0.0001870,0.0000586,83.16
1,6,2032,2038,0.0001837,0.0000598,82.17
1,7,2032,2039,0.0001828,0.0000619,81.17
1,8,2032,2040,0.0001845,0.0000644,80.18
1,9,2032,2041,0.0001904,0.0000690,79.18
1,10,2032,2042,0.0002017,0.0000770,78.19
1,11,2032,2043,0.0002200,0.0000889,77.19
1,12,2032,2044,0.0002484,0.0001064,76.20
1,13,2032,2045,0.0002934,0.0001348,75.21
1,14,2032,2046,0.0003624,0.0001823,74.22
1,15,2032,2047,0.0004596,0.0002551,73.23
1,16,2032,2048,0.0005802,0.0003494,72.25
1,17,2032,2049,0.0007098,0.0004497,71.27
1,18,2032,2050,0.0008321,0.0005423,70.31
1,19,2032,2051,0.0009391,0.0006202,69.34
1,20,2032,2052,0.0010297,0.0006826,68.39
1,21,2032,2053,0.0011033,0.0007282,67.43
1,22,2032,2054,0.0011584,0.0007579,66.48
1,23,2032,2055,0.0011978,0.0007800,65.53
1,24,2032,2056,0.0012275,0.0007969,64.58
1,25,2032,2057,0.0012521,0.0008018,63.63
1,26,2032,2058,0.0012759,0.0008033,62.68
1,27,2032,2059,0.0013058,0.0008118,61.73
1,28,2032,2060,0.0013446,0.0008380,60.78
1,29,2032,2061,0.0013859,0.0008597,59.83
1,30,2032,2062,0.0014216,0.0008647,58.89
1,31,2032,2063,0.0014530,0.0008648,57.94
1,32,2032,2064,0.0014859,0.0008658,56.99
1,33,2032,2065,0.0015203,0.0008599,56.03
1,34,2032,2066,0.0015540,0.0008431,55.08
1,35,2032,2067,0.0015941,0.0008207,54.13
1,36,2032,2068,0.0016525,0.0008151,53.17
1,37,2032,2069,0.0017318,0.0008240,52.22
1,38,2032,2070,0.0018255,0.0008530,51.26
1,39,2032,2071,0.0019305,0.0008997,50.30
1,40,2032,2072,0.0020513,0.0009623,49.35
1,41,2032,2073,0.0021897,0.0010397,48.39
1,42,2032,2074,0.0023342,0.0011187,47.44
1,43,2032,2075,0.0024669,0.0011810,46.50
1,44,2032,2076,0.0025867,0.0012202,45.55
1,45,2032,2077,0.0027191,0.0012423,44.61
1,46,2032,2078,0.0028925,0.0012955,43.66
1,47,2032,2079,0.0031101,0.0013786,42.72
1,48,2032,2080,0.0033571,0.0014866,41.77
1,49,2032,2081,0.0036304,0.0016031,40.84
1,50,2032,2082,0.0039379,0.0017174,39.90
1,51,2032,2083,0.0042708,0.0018345,38.97
1,52,2032,2084,0.0046082,0.0019440,38.04
1,53,2032,2085,0.0049489,0.0020293,37.11
1,54,2032,2086,0.0053157,0.0021232,36.19
1,55,2032,2087,0.0057365,0.0022390,35.26
1,56,2032,2088,0.0062406,0.0024183,34.34
1,57,2032,2089,0.0068502,0.0026676,33.42
1,58,2032,2090,0.0075521,0.0029818,32.51
1,59,2032,2091,0.0083035,0.0033072,31.61
1,60,2032,2092,0.0090849,0.0036116,30.71
1,61,2032,2093,0.0099105,0.0039046,29.82
1,62,2032,2094,0.0107829,0.0041835,28.93
1,63,2032,2095,0.0116995,0.0044576,28.05
1,64,2032,2096,0.0126957,0.0047703,27.18
1,65,2032,2097,0.0138071,0.0051364,26.30
1,66,2032,2098,0.0150054,0.0055372,25.44
1,67,2032,2099,0.0162315,0.0058826,24.58
1,68,2032,2100,0.0174919,0.0061630,23.72
1,69,2032,2101,0.0188954,0.0064826,22.86
1,70,2032,2102,0.0205786,0.0069441,22.01
1,71,2032,2103,0.0226142,0.0076462,21.16
1,72,2032,2104,0.0250119,0.0086179,20.32
1,73,2032,2105,0.0277519,0.0098417,19.49
1,74,2032,2106,0.0307579,0.0112762,18.68
1,75,2032,2107,0.0339099,0.0127738,17.89
1,76,2032,2108,0.0371478,0.0142223,17.11
1,77,2032,2109,0.0405123,0.0155888,16.35
1,78,2032,2110,0.0440886,0.0169153,15.60
1,79,2032,2111,0.0480027,0.0183287,14.86
1,80,2032,2112,0.0536037,0.0215941,14.13
1,81,2032,2113,0.0586892,0.0238005,13.43
1,82,2032,2114,0.0642414,0.0262196,12.75
1,83,2032,2115,0.0702997,0.0289084,12.08
1,84,2032,2116,0.0769067,0.0319637,11.42
1,85,2032,2117,0.0841076,0.0354340,10.78
1,86,2032,2118,0.0919504,0.0393825,10.16
1,87,2032,2119,0.1004863,0.0438396,9.56
1,88,2032,2120,0.1097689,0.0488460,8.97
1,89,2032,2121,0.1198550,0.0544795,8.41
1,90,2032,2122,0.1308036,0.0608169,7.86
1,91,2032,2123,0.1426766,0.0679335,7.34
1,92,2032,2124,0.1555375,0.0758723,6.84
1,93,2032,2125,0.1694519,0.0846917,6.36
1,94,2032,2126,0.1844867,0.0945195,5.90
1,95,2032,2127,0.2007091,0.1055174,5.46
1,96,2032,2128,0.2181866,0.1178219,5.05
1,97,2032,2129,0.2369856,0.1315057,4.65
1,98,2032,2130,0.2571705,0.1466598,4.28
1,99,2032,2131,0.2788028,0.1634679,3.93
1,100,2032,2132,0.3019394,0.1821512,3.61
1,101,2032,2133,0.3266317,0.2028849,3.30
1,102,2032,2134,0.3529236,0.2257545,3.01
1,103,2032,2135,0.3808502,0.2508711,2.74
1,104,2032,2136,0.4104359,0.2784490,2.49
1,105,2032,2137,0.4416930,0.3087250,2.26
1,106,2032,2138,0.4746198,0.3418578,2.04
1,107,2032,2139,0.5091990,0.3778803,1.85
1,108,2032,2140,0.5453968,0.4168282,1.67
1,109,2032,2141,0.5831612,0.4588202,1.50
1,110,2032,2142,0.6224217,0.5039540,1.35
1,111,2032,2143,0.6630882,0.5522023,1.20
1,112,2032,2144,0.7050519,0.6033907,1.07
1,113,2032,2145,0.7481851,0.6573274,0.94
1,114,2032,2146,0.7923424,0.7138489,0.79
1,115,2032,2147,1.0000000,1.0000000,0.50
1,0,2033,2033,0.0091938,0.0038556,87.89
1,1,2033,2034,0.0006668,0.0001858,87.23
1,2,2033,2035,0.0003367,0.0000962,86.24
1,3,2033,2036,0.0002291,0.0000643,85.25
1,4,2033,2037,0.0001930,0.0000546,84.26
1,5,2033,2038,0.0001870,0.0000561,83.26
1,6,2033,2039,0.0001837,0.0000574,82.27
1,7,2033,2040,0.0001828,0.0000593,81.27
1,8,2033,2041,0.0001845,0.0000618,80.28
1,9,2033,2042,0.0001904,0.0000666,79.28
1,10,2033,2043,0.0002017,0.0000747,78.29
1,11,2033,2044,0.0002200,0.0000865,77.29
1,12,2033,2045,0.0002484,0.0001035,76.30
1,13,2033,2046,0.0002934,0.0001314,75.31
1,14,2033,2047,0.0003624,0.0001787,74.32
1,15,2033,2048,0.0004596,0.0002511,73.33
1,16,2033,2049,0.0005802,0.0003447,72.35
1,17,2033,2050,0.0007098,0.0004439,71.37
1,18,2033,2051,0.0008321,0.0005358,70.40
1,19,2033,2052,0.0009391,0.0006136,69.44
1,20,2033,2053,0.0010297,0.0006760,68.48
1,21,2033,2054,0.0011033,0.0007210,67.53
1,22,2033,2055,0.0011584,0.0007498,66.58
1,23,2033,2056,0.0011978,0.0007715,65.63
1,24,2033,2057,0.0012275,0.0007888,64.68
1,25,2033,2058,0.0012521,0.0007942,63.73
1,26,2033,2059,0.0012759,0.0007954,62.78
1,27,2033,2060,0.0013058,0.0008031,61.83
1,28,2033,2061,0.0013446,0.0008291,60.88
1,29,2033,2062,0.0013859,0.0008512,59.93
1,30,2033,2063,0.0014216,0.0008566,58.98
1,31,2033,2064,0.0014530,0.0008563,58.03
1,32,2033,2065,0.0014859,0.0008563,57.08
1,33,2033,2066,0.0015203,0.0008499,56.13
1,34,2033,2067,0.0015540,0.0008334,55.17
1,35,2033,2068,0.0015941,0.0008113,54.22
1,36,2033,2069,0.0016525,0.0008051,53.26
1,37,2033,2070,0.0017318,0.0008125,52.31
1,38,2033,2071,0.0018255,0.0008408,51.35
1,39,2033,2072,0.0019305,0.0008878,50.39
1,40,2033,2073,0.0020513,0.0009508,49.43
1,41,2033,2074,0.0021897,0.0010275,48.48
1,42,2033,2075,0.0023342,0.0011049,47.53
1,43,2033,2076,0.0024669,0.0011664,46.58
1,44,2033,2077,0.0025867,0.0012059,45.64
1,45,2033,2078,0.0027191,0.0012283,44.69
1,46,2033,2079,0.0028925,0.0012803,43.74
1,47,2033,2080,0.0031101,0.0013610,42.80
1,48,2033,2081,0.0033571,0.0014674,41.86
1,49,2033,2082,0.0036304,0.0015838,40.92
1,50,2033,2083,0.0039379,0.0016983,39.98
1,51,2033,2084,0.0042708,0.0018135,39.05
1,52,2033,2085,0.0046082,0.0019197,38.12
1,53,2033,2086,0.0049489,0.0020029,37.19
1,54,2033,2087,0.0053157,0.0020967,36.27
1,55,2033,2088,0.0057365,0.0022128,35.34
1,56,2033,2089,0.0062406,0.0023893,34.42
1,57,2033,2090,0.0068502,0.0026333,33.50
1,58,2033,2091,0.0075521,0.0029437,32.59
1,59,2033,2092,0.0083035,0.0032683,31.68
1,60,2033,2093,0.0090849,0.0035726,30.78
1,61,2033,2094,0.0099105,0.0038613,29.89
1,62,2033,2095,0.0107829,0.0041328,29.01
1,63,2033,2096,0.0116995,0.0044020,28.12
1,64,2033,2097,0.0126957,0.0047142,27.25
1,65,2033,2098,0.0138071,0.0050806,26.37
1,66,2033,2099,0.0150054,0.0054758,25.51
1,67,2033,2100,0.0162315,0.0058112,24.64
1,68,2033,2101,0.0174919,0.0060853,23.78
1,69,2033,2102,0.0188954,0.0064045,22.93
1,70,2033,2103,0.0205786,0.0068659,22.07
1,71,2033,2104,0.0226142,0.0075586,21.22
1,72,2033,2105,0.0250119,0.0085132,20.38
1,73,2033,2106,0.0277519,0.0097238,19.55
1,74,2033,2107,0.0307579,0.0111544,18.74
1,75,2033,2108,0.0339099,0.0126503,17.94
1,76,2033,2109,0.0371478,0.0140845,17.17
1,77,2033,2110,0.0405123,0.0154265,16.40
1,78,2033,2111,0.0440886,0.0167363,15.65
1,79,2033,2112,0.0480027,0.0181470,14.91
1,80,2033,2113,0.0536037,0.0214091,14.18
1,81,2033,2114,0.0586892,0.0235959,13.48
1,82,2033,2115,0.0642414,0.0259785,12.79
1,83,2033,2116,0.0702997,0.0286411,12.12
1,84,2033,2117,0.0769067,0.0316908,11.46
1,85,2033,2118,0.0841076,0.0351591,10.82
1,86,2033,2119,0.0919504,0.0390755,10.19
1,87,2033,2120,0.1004863,0.0434777,9.59
1,88,2033,2121,0.1097689,0.0484464,9.00
1,89,2033,2122,0.1198550,0.0540740,8.43
1,90,2033,2123,0.1308036,0.0604123,7.89
1,91,2033,2124,0.1426766,0.0674870,7.36
1,92,2033,2125,0.1555375,0.0753505,6.86
1,93,2033,2126,0.1694519,0.0841199,6.38
1,94,2033,2127,0.1844867,0.0939445,5.92
1,95,2033,2128,0.2007091,0.1049506,5.48
1,96,2033,2129,0.2181866,0.1172058,5.06
1,97,2033,2130,0.2369856,0.1307952,4.67
1,98,2033,2131,0.2571705,0.1458917,4.30
1,99,2033,2132,0.2788028,0.1627061,3.95
1,100,2033,2133,0.3019394,0.1814081,3.62
1,101,2033,2134,0.3266317,0.2020846,3.31
1,102,2033,2135,0.3529236,0.2248482,3.02
1,103,2033,2136,0.3808502,0.2499143,2.75
1,104,2033,2137,0.4104359,0.2775263,2.50
1,105,2033,2138,0.4416930,0.3078584,2.26
1,106,2033,2139,0.4746198,0.3409663,2.05
1,107,2033,2140,0.5091990,0.3769128,1.85
1,108,2033,2141,0.5453968,0.4158508,1.67
1,109,2033,2142,0.5831612,0.4579239,1.50
1,110,2033,2143,0.6224217,0.5031589,1.35
1,111,2033,2144,0.6630882,0.5514365,1.21
1,112,2033,2145,0.7050519,0.6026227,1.07
1,113,2033,2146,0.7481851,0.6566225,0.94
1,114,2033,2147,0.7923424,0.7132741,0.79
1,115,2033,2148,1.0000000,1.0000000,0.50
1,0,2034,2034,0.0091938,0.0037020,88.00
1,1,2034,2035,0.0006668,0.0001746,87.33
1,2,2034,2036,0.0003367,0.0000907,86.34
1,3,2034,2037,0.0002291,0.0000609,85.35
1,4,2034,2038,0.0001930,0.0000521,84.36
1,5,2034,2039,0.0001870,0.0000536,83.36
1,6,2034,2040,0.0001837,0.0000548,82.37
1,7,2034,2041,0.0001828,0.0000568,81.37
1,8,2034,2042,0.0001845,0.0000595,80.38
1,9,2034,2043,0.0001904,0.0000644,79.38
1,10,2034,2044,0.0002017,0.0000725,78.38
1,11,2034,2045,0.0002200,0.0000839,77.39
1,12,2034,2046,0.0002484,0.0001006,76.40
1,13,2034,2047,0.0002934,0.0001284,75.40
1,14,2034,2048,0.0003624,0.0001753,74.41
1,15,2034,2049,0.0004596,0.0002471,73.43
1,16,2034,2050,0.0005802,0.0003396,72.45
1,17,2034,2051,0.0007098,0.0004380,71.47
1,18,2034,2052,0.0008321,0.0005298,70.50
1,19,2034,2053,0.0009391,0.0006075,69.54
1,20,2034,2054,0.0010297,0.0006692,68.58
1,21,2034,2055,0.0011033,0.0007132,67.63
1,22,2034,2056,0.0011584,0.0007415,66.67
1,23,2034,2057,0.0011978,0.0007635,65.72
1,24,2034,2058,0.0012275,0.0007815,64.77
1,25,2034,2059,0.0012521,0.0007866,63.82
1,26,2034,2060,0.0012759,0.0007870,62.87
1,27,2034,2061,0.0013058,0.0007943,61.92
1,28,2034,2062,0.0013446,0.0008207,60.97
1,29,2034,2063,0.0013859,0.0008434,60.02
1,30,2034,2064,0.0014216,0.0008483,59.07
1,31,2034,2065,0.0014530,0.0008472,58.12
1,32,2034,2066,0.0014859,0.0008467,57.17
1,33,2034,2067,0.0015203,0.0008406,56.22
1,34,2034,2068,0.0015540,0.0008245,55.26
1,35,2034,2069,0.0015941,0.0008018,54.31
1,36,2034,2070,0.0016525,0.0007942,53.35
1,37,2034,2071,0.0017318,0.0008010,52.39
1,38,2034,2072,0.0018255,0.0008295,51.44
1,39,2034,2073,0.0019305,0.0008770,50.48
1,40,2034,2074,0.0020513,0.0009394,49.52
1,41,2034,2075,0.0021897,0.0010146,48.57
1,42,2034,2076,0.0023342,0.0010910,47.62
1,43,2034,2077,0.0024669,0.0011528,46.67
1,44,2034,2078,0.0025867,0.0011927,45.72
1,45,2034,2079,0.0027191,0.0012141,44.78
1,46,2034,2080,0.0028925,0.0012639,43.83
1,47,2034,2081,0.0031101,0.0013432,42.88
1,48,2034,2082,0.0033571,0.0014496,41.94
1,49,2034,2083,0.0036304,0.0015662,41.00
1,50,2034,2084,0.0039379,0.0016790,40.06
1,51,2034,2085,0.0042708,0.0017910,39.13
1,52,2034,2086,0.0046082,0.0018951,38.20
1,53,2034,2087,0.0049489,0.0019783,37.27
1,54,2034,2088,0.0053157,0.0020724,36.35
1,55,2034,2089,0.0057365,0.0021861,35.42
1,56,2034,2090,0.0062406,0.0023581,34.50
1,57,2034,2091,0.0068502,0.0025987,33.58
1,58,2034,2092,0.0075521,0.0029082,32.66
1,59,2034,2093,0.0083035,0.0032326,31.76
1,60,2034,2094,0.0090849,0.0035330,30.86
1,61,2034,2095,0.0099105,0.0038148,29.97
1,62,2034,2096,0.0107829,0.0040816,29.08
1,63,2034,2097,0.0116995,0.0043503,28.20
1,64,2034,2098,0.0126957,0.0046629,27.32
1,65,2034,2099,0.0138071,0.0050241,26.44
1,66,2034,2100,0.0150054,0.0054099,25.57
1,67,2034,2101,0.0162315,0.0057391,24.71
1,68,2034,2102,0.0174919,0.0060129,23.85
1,69,2034,2103,0.0188954,0.0063328,22.99
1,70,2034,2104,0.0205786,0.0067864,22.13
1,71,2034,2105,0.0226142,0.0074642,21.28
1,72,2034,2106,0.0250119,0.0084073,20.44
1,73,2034,2107,0.0277519,0.0096141,19.61
1,74,2034,2108,0.0307579,0.0110424,18.79
1,75,2034,2109,0.0339099,0.0125244,18.00
1,76,2034,2110,0.0371478,0.0139356,17.22
1,77,2034,2111,0.0405123,0.0152621,16.45
1,78,2034,2112,0.0440886,0.0165695,15.70
1,79,2034,2113,0.0480027,0.0179809,14.96
1,80,2034,2114,0.0536037,0.0212221,14.22
1,81,2034,2115,0.0586892,0.0233755,13.52
1,82,2034,2116,0.0642414,0.0257339,12.83
1,83,2034,2117,0.0702997,0.0283912,12.16
1,84,2034,2118,0.0769067,0.0314389,11.50
1,85,2034,2119,0.0841076,0.0348775,10.86
1,86,2034,2120,0.0919504,0.0387431,10.23
1,87,2034,2121,0.1004863,0.0431101,9.62
1,88,2034,2122,0.1097689,0.0480729,9.03
1,89,2034,2123,0.1198550,0.0537006,8.46
1,90,2034,2124,0.1308036,0.0599994,7.92
1,91,2034,2125,0.1426766,0.0670035,7.39
1,92,2034,2126,0.1555375,0.0748197,6.88
1,93,2034,2127,0.1694519,0.0835849,6.40
1,94,2034,2128,0.1844867,0.0934157,5.94
1,95,2034,2129,0.2007091,0.1043741,5.50
1,96,2034,2130,0.2181866,0.1165388,5.08
1,97,2034,2131,0.2369856,0.1300715,4.69
1,98,2034,2132,0.2571705,0.1451710,4.31
1,99,2034,2133,0.2788028,0.1619999,3.96
1,100,2034,2134,0.3019394,0.1806438,3.63
1,101,2034,2135,0.3266317,0.2012141,3.32
1,102,2034,2136,0.3529236,0.2239234,3.03
1,103,2034,2137,0.3808502,0.2490163,2.76
1,104,2034,2138,0.4104359,0.2766762,2.50
1,105,2034,2139,0.4416930,0.3069759,2.27
1,106,2034,2140,0.4746198,0.3399988,2.05
1,107,2034,2141,0.5091990,0.3759241,1.86
1,108,2034,2142,0.5453968,0.4149320,1.67
1,109,2034,2143,0.5831612,0.4570960,1.50
1,110,2034,2144,0.6224217,0.5023467,1.35
1,111,2034,2145,0.6630882,0.5506039,1.21
1,112,2034,2146,0.7050519,0.6018371,1.07
1,113,2034,2147,0.7481851,0.6559586,0.94
1,114,2034,2148,0.7923424,0.7127408,0.79
1,115,2034,2149,1.0000000,1.0000000,0.50
1,0,2035,2035,0.0091937,0.0035418,88.12
1,1,2035,2036,0.0006668,0.0001638,87.43
1,2,2035,2037,0.0003367,0.0000857,86.44
1,3,2035,2038,0.0002291,0.0000579,85.45
1,4,2035,2039,0.0001930,0.0000496,84.46
1,5,2035,2040,0.0001870,0.0000510,83.46
1,6,2035,2041,0.0001837,0.0000523,82.47
1,7,2035,2042,0.0001828,0.0000545,81.47
1,8,2035,2043,0.0001845,0.0000574,80.47
1,9,2035,2044,0.0001904,0.0000623,79.48
1,10,2035,2045,0.0002017,0.0000701,78.48
1,11,2035,2046,0.0002200,0.0000813,77.49
1,12,2035,2047,0.0002484,0.0000979,76.50
1,13,2035,2048,0.0002934,0.0001256,75.50
1,14,2035,2049,0.0003624,0.0001720,74.51
1,15,2035,2050,0.0004596,0.0002428,73.53
1,16,2035,2051,0.0005802,0.0003345,72.54
1,17,2035,2052,0.0007098,0.0004326,71.57
1,18,2035,2053,0.0008321,0.0005241,70.60
1,19,2035,2054,0.0009391,0.0006012,69.63
1,20,2035,2055,0.0010297,0.0006619,68.68
1,21,2035,2056,0.0011033,0.0007052,67.72
1,22,2035,2057,0.0011584,0.0007337,66.77
1,23,2035,2058,0.0011978,0.0007563,65.82
1,24,2035,2059,0.0012275,0.0007740,64.87
1,25,2035,2060,0.0012521,0.0007783,63.92
1,26,2035,2061,0.0012759,0.0007784,62.97
1,27,2035,2062,0.0013058,0.0007861,62.01
1,28,2035,2063,0.0013446,0.0008131,61.06
1,29,2035,2064,0.0013859,0.0008354,60.11
1,30,2035,2065,0.0014216,0.0008395,59.16
1,31,2035,2066,0.0014530,0.0008379,58.21
1,32,2035,2067,0.0014859,0.0008378,57.26
1,33,2035,2068,0.0015203,0.0008321,56.31
1,34,2035,2069,0.0015540,0.0008154,55.35
1,35,2035,2070,0.0015941,0.0007915,54.40
1,36,2035,2071,0.0016525,0.0007833,53.44
1,37,2035,2072,0.0017318,0.0007902,52.48
1,38,2035,2073,0.0018255,0.0008192,51.52
1,39,2035,2074,0.0019305,0.0008661,50.57
1,40,2035,2075,0.0020513,0.0009272,49.61
1,41,2035,2076,0.0021897,0.0010015,48.65
1,42,2035,2077,0.0023342,0.0010781,47.70
1,43,2035,2078,0.0024669,0.0011402,46.75
1,44,2035,2079,0.0025867,0.0011793,45.81
1,45,2035,2080,0.0027191,0.0011987,44.86
1,46,2035,2081,0.0028925,0.0012474,43.91
1,47,2035,2082,0.0031101,0.0013266,42.97
1,48,2035,2083,0.0033571,0.0014333,42.02
1,49,2035,2084,0.0036304,0.0015484,41.08
1,50,2035,2085,0.0039379,0.0016583,40.15
1,51,2035,2086,0.0042708,0.0017683,39.21
1,52,2035,2087,0.0046082,0.0018723,38.28
1,53,2035,2088,0.0049489,0.0019557,37.35
1,54,2035,2089,0.0053157,0.0020478,36.42
1,55,2035,2090,0.0057365,0.0021574,35.50
1,56,2035,2091,0.0062406,0.0023265,34.57
1,57,2035,2092,0.0068502,0.0025665,33.65
1,58,2035,2093,0.0075521,0.0028757,32.74
1,59,2035,2094,0.0083035,0.0031964,31.83
1,60,2035,2095,0.0090849,0.0034903,30.93
1,61,2035,2096,0.0099105,0.0037677,30.04
1,62,2035,2097,0.0107829,0.0040339,29.15
1,63,2035,2098,0.0116995,0.0043030,28.27
1,64,2035,2099,0.0126957,0.0046110,27.39
1,65,2035,2100,0.0138071,0.0049635,26.51
1,66,2035,2101,0.0150054,0.0053432,25.64
1,67,2035,2102,0.0162315,0.0056719,24.78
1,68,2035,2103,0.0174919,0.0059465,23.91
1,69,2035,2104,0.0188954,0.0062597,23.05
1,70,2035,2105,0.0205786,0.0067006,22.20
1,71,2035,2106,0.0226142,0.0073687,21.34
1,72,2035,2107,0.0250119,0.0083087,20.50
1,73,2035,2108,0.0277519,0.0095132,19.66
1,74,2035,2109,0.0307579,0.0109283,18.85
1,75,2035,2110,0.0339099,0.0123886,18.05
1,76,2035,2111,0.0371478,0.0137849,17.27
1,77,2035,2112,0.0405123,0.0151089,16.51
1,78,2035,2113,0.0440886,0.0164169,15.75
1,79,2035,2114,0.0480027,0.0178130,15.01
1,80,2035,2115,0.0536037,0.0210207,14.27
1,81,2035,2116,0.0586892,0.0231519,13.57
1,82,2035,2117,0.0642414,0.0255054,12.87
1,83,2035,2118,0.0702997,0.0281606,12.20
1,84,2035,2119,0.0769067,0.0311809,11.54
1,85,2035,2120,0.0841076,0.0345726,10.89
1,86,2035,2121,0.0919504,0.0384055,10.27
1,87,2035,2122,0.1004863,0.0427666,9.66
1,88,2035,2123,0.1097689,0.0477289,9.06
1,89,2035,2124,0.1198550,0.0533197,8.49
1,90,2035,2125,0.1308036,0.0595526,7.94
1,91,2035,2126,0.1426766,0.0665120,7.41
1,92,2035,2127,0.1555375,0.0743231,6.91
1,93,2035,2128,0.1694519,0.0830929,6.42
1,94,2035,2129,0.1844867,0.0928779,5.96
1,95,2035,2130,0.2007091,0.1037501,5.52
1,96,2035,2131,0.2181866,0.1158595,5.10
1,97,2035,2132,0.2369856,0.1293926,4.70
1,98,2035,2133,0.2571705,0.1445031,4.33
1,99,2035,2134,0.2788028,0.1612738,3.97
1,100,2035,2135,0.3019394,0.1798126,3.64
1,101,2035,2136,0.3266317,0.2003261,3.33
1,102,2035,2137,0.3529236,0.2230557,3.04
1,103,2035,2138,0.3808502,0.2481890,2.76
1,104,2035,2139,0.4104359,0.2758107,2.51
1,105,2035,2140,0.4416930,0.3060185,2.28
1,106,2035,2141,0.4746198,0.3390105,2.06
1,107,2035,2142,0.5091990,0.3749949,1.86
1,108,2035,2143,0.5453968,0.4140834,1.68
1,109,2035,2144,0.5831612,0.4562505,1.51
1,110,2035,2145,0.6224217,0.5014639,1.35
1,111,2035,2146,0.6630882,0.5497522,1.21
1,112,2035,2147,0.7050519,0.6010973,1.08
1,113,2035,2148,0.7481851,0.6553428,0.94
1,114,2035,2149,0.7923424,0.7121928,0.79
1,115,2035,2150,1.0000000,1.0000000,0.50
1,0,2036,2036,0.0091937,0.0033849,
1,1,2036,2037,0.0006668,0.0001543,
1,2,2036,2038,0.0003367,0.0000814,
1,3,2036,2039,0.0002291,0.0000550,
1,4,2036,2040,0.0001930,0.0000470,
1,5,2036,2041,0.0001870,0.0000485,
1,6,2036,2042,0.0001837,0.0000500,
1,7,2036,2043,0.0001828,0.0000524,
1,8,2036,2044,0.0001845,0.0000554,
1,9,2036,2045,0.0001904,0.0000601,
1,10,2036,2046,0.0002017,0.0000677,
1,11,2036,2047,0.0002200,0.0000789,
1,12,2036,2048,0.0002484,0.0000955,
1,13,2036,2049,0.0002934,0.0001227,
1,14,2036,2050,0.0003624,0.0001684,
1,15,2036,2051,0.0004596,0.0002384,
1,16,2036,2052,0.0005802,0.0003298,
1,17,2036,2053,0.0007098,0.0004276,
1,18,2036,2054,0.0008321,0.0005184,
1,19,2036,2055,0.0009391,0.0005943,
1,20,2036,2056,0.0010297,0.0006544,
1,21,2036,2057,0.0011033,0.0006979,
1,22,2036,2058,0.0011584,0.0007267,
1,23,2036,2059,0.0011978,0.0007489,
1,24,2036,2060,0.0012275,0.0007660,
1,25,2036,2061,0.0012521,0.0007700,
1,26,2036,2062,0.0012759,0.0007704,
1,27,2036,2063,0.0013058,0.0007786,
1,28,2036,2064,0.0013446,0.0008054,
1,29,2036,2065,0.0013859,0.0008269,
1,30,2036,2066,0.0014216,0.0008305,
1,31,2036,2067,0.0014530,0.0008292,
1,32,2036,2068,0.0014859,0.0008295,
1,33,2036,2069,0.0015203,0.0008233,
1,34,2036,2070,0.0015540,0.0008055,
1,35,2036,2071,0.0015941,0.0007810,
1,36,2036,2072,0.0016525,0.0007731,
1,37,2036,2073,0.0017318,0.0007805,
1,38,2036,2074,0.0018255,0.0008089,
1,39,2036,2075,0.0019305,0.0008546,
1,40,2036,2076,0.0020513,0.0009148,
1,41,2036,2077,0.0021897,0.0009892,
1,42,2036,2078,0.0023342,0.0010662,
1,43,2036,2079,0.0024669,0.0011273,
1,44,2036,2080,0.0025867,0.0011647,
1,45,2036,2081,0.0027191,0.0011831,
1,46,2036,2082,0.0028925,0.0012319,
1,47,2036,2083,0.0031101,0.0013115,
1,48,2036,2084,0.0033571,0.0014168,
1,49,2036,2085,0.0036304,0.0015293,
1,50,2036,2086,0.0039379,0.0016373,
1,51,2036,2087,0.0042708,0.0017471,
1,52,2036,2088,0.0046082,0.0018513,
1,53,2036,2089,0.0049489,0.0019327,
1,54,2036,2090,0.0053157,0.0020212,
1,55,2036,2091,0.0057365,0.0021284,
1,56,2036,2092,0.0062406,0.0022972,
1,57,2036,2093,0.0068502,0.0025370,
1,58,2036,2094,0.0075521,0.0028428,
1,59,2036,2095,0.0083035,0.0031574,
1,60,2036,2096,0.0090849,0.0034472,
1,61,2036,2097,0.0099105,0.0037239,
1,62,2036,2098,0.0107829,0.0039904,
1,63,2036,2099,0.0116995,0.0042552,
1,64,2036,2100,0.0126957,0.0045553,
1,65,2036,2101,0.0138071,0.0049021,
1,66,2036,2102,0.0150054,0.0052811,
1,67,2036,2103,0.0162315,0.0056102,
1,68,2036,2104,0.0174919,0.0058787,
1,69,2036,2105,0.0188954,0.0061809,
1,70,2036,2106,0.0205786,0.0066138,
1,71,2036,2107,0.0226142,0.0072799,
1,72,2036,2108,0.0250119,0.0082181,
1,73,2036,2109,0.0277519,0.0094106,
1,74,2036,2110,0.0307579,0.0108052,
1,75,2036,2111,0.0339099,0.0122510,
1,76,2036,2112,0.0371478,0.0136444,
1,77,2036,2113,0.0405123,0.0149688,
1,78,2036,2114,0.0440886,0.0162628,
1,79,2036,2115,0.0480027,0.0176322,
1,80,2036,2116,0.0536037,0.0208163,
1,81,2036,2117,0.0586892,0.0229430,
1,82,2036,2118,0.0642414,0.0252945,
1,83,2036,2119,0.0702997,0.0279245,
1,84,2036,2120,0.0769067,0.0309016,
1,85,2036,2121,0.0841076,0.0342631,
1,86,2036,2122,0.0919504,0.0380902,
1,87,2036,2123,0.1004863,0.0424503,
1,88,2036,2124,0.1097689,0.0473781,
1,89,2036,2125,0.1198550,0.0529075,
1,90,2036,2126,0.1308036,0.0590984,
1,91,2036,2127,0.1426766,0.0660523,
1,92,2036,2128,0.1555375,0.0738667,
1,93,2036,2129,0.1694519,0.0825927,
1,94,2036,2130,0.1844867,0.0922960,
1,95,2036,2131,0.2007091,0.1031148,
1,96,2036,2132,0.2181866,0.1152225,
1,97,2036,2133,0.2369856,0.1287636,
1,98,2036,2134,0.2571705,0.1438165,
1,99,2036,2135,0.2788028,0.1604843,
1,100,2036,2136,0.3019394,0.1789650,
1,101,2036,2137,0.3266317,0.1994933,
1,102,2036,2138,0.3529236,0.2222567,
1,103,2036,2139,0.3808502,0.2473471,
1,104,2036,2140,0.4104359,0.2748719,
1,105,2036,2141,0.4416930,0.3050407,
1,106,2036,2142,0.4746198,0.3380818,
1,107,2036,2143,0.5091990,0.3741370,
1,108,2036,2144,0.5453968,0.4132172,
1,109,2036,2145,0.5831612,0.4553318,
1,110,2036,2146,0.6224217,0.5005610,
1,111,2036,2147,0.6630882,0.5489504,
1,112,2036,2148,0.7050519,0.6004112,
1,113,2036,2149,0.7481851,0.6547101,
1,114,2036,2150,0.7923424,0.7115957,
1,0,2037,2037,0.0091937,0.0032435,
1,1,2037,2038,0.0006668,0.0001460,
1,2,2037,2039,0.0003367,0.0000772,
1,3,2037,2040,0.0002291,0.0000520,
1,4,2037,2041,0.0001930,0.0000445,
1,5,2037,2042,0.0001870,0.0000463,
1,6,2037,2043,0.0001837,0.0000480,
1,7,2037,2044,0.0001828,0.0000504,
1,8,2037,2045,0.0001845,0.0000532,
1,9,2037,2046,0.0001904,0.0000579,
1,10,2037,2047,0.0002017,0.0000656,
1,11,2037,2048,0.0002200,0.0000768,
1,12,2037,2049,0.0002484,0.0000931,
1,13,2037,2050,0.0002934,0.0001197,
1,14,2037,2051,0.0003624,0.0001648,
1,15,2037,2052,0.0004596,0.0002344,
1,16,2037,2053,0.0005802,0.0003254,
1,17,2037,2054,0.0007098,0.0004224,
1,18,2037,2055,0.0008321,0.0005121,
1,19,2037,2056,0.0009391,0.0005874,
1,20,2037,2057,0.0010297,0.0006475,
1,21,2037,2058,0.0011033,0.0006911,
1,22,2037,2059,0.0011584,0.0007195,
1,23,2037,2060,0.0011978,0.0007410,
1,24,2037,2061,0.0012275,0.0007578,
1,25,2037,2062,0.0012521,0.0007622,
1,26,2037,2063,0.0012759,0.0007631,
1,27,2037,2064,0.0013058,0.0007709,
1,28,2037,2065,0.0013446,0.0007970,
1,29,2037,2066,0.0013859,0.0008182,
1,30,2037,2067,0.0014216,0.0008221,
1,31,2037,2068,0.0014530,0.0008212,
1,32,2037,2069,0.0014859,0.0008211,
1,33,2037,2070,0.0015203,0.0008139,
1,34,2037,2071,0.0015540,0.0007955,
1,35,2037,2072,0.0015941,0.0007714,
1,36,2037,2073,0.0016525,0.0007639,
1,37,2037,2074,0.0017318,0.0007708,
1,38,2037,2075,0.0018255,0.0007979,
1,39,2037,2076,0.0019305,0.0008429,
1,40,2037,2077,0.0020513,0.0009033,
1,41,2037,2078,0.0021897,0.0009780,
1,42,2037,2079,0.0023342,0.0010540,
1,43,2037,2080,0.0024669,0.0011135,
1,44,2037,2081,0.0025867,0.0011500,
1,45,2037,2082,0.0027191,0.0011687,
1,46,2037,2083,0.0028925,0.0012179,
1,47,2037,2084,0.0031101,0.0012962,
1,48,2037,2085,0.0033571,0.0013991,
1,49,2037,2086,0.0036304,0.0015100,
1,50,2037,2087,0.0039379,0.0016178,
1,51,2037,2088,0.0042708,0.0017276,
1,52,2037,2089,0.0046082,0.0018299,
1,53,2037,2090,0.0049489,0.0019080,
1,54,2037,2091,0.0053157,0.0019943,
1,55,2037,2092,0.0057365,0.0021014,
1,56,2037,2093,0.0062406,0.0022703,
1,57,2037,2094,0.0068502,0.0025071,
1,58,2037,2095,0.0075521,0.0028073,
1,59,2037,2096,0.0083035,0.0031180,
1,60,2037,2097,0.0090849,0.0034070,
1,61,2037,2098,0.0099105,0.0036839,
1,62,2037,2099,0.0107829,0.0039463,
1,63,2037,2100,0.0116995,0.0042038,
1,64,2037,2101,0.0126957,0.0044988,
1,65,2037,2102,0.0138071,0.0048450,
1,66,2037,2103,0.0150054,0.0052240,
1,67,2037,2104,0.0162315,0.0055473,
1,68,2037,2105,0.0174919,0.0058057,
1,69,2037,2106,0.0188954,0.0061012,
1,70,2037,2107,0.0205786,0.0065332,
1,71,2037,2108,0.0226142,0.0071983,
1,72,2037,2109,0.0250119,0.0081260,
1,73,2037,2110,0.0277519,0.0092999,
1,74,2037,2111,0.0307579,0.0106806,
1,75,2037,2112,0.0339099,0.0121228,
1,76,2037,2113,0.0371478,0.0135160,
1,77,2037,2114,0.0405123,0.0148272,
1,78,2037,2115,0.0440886,0.0160969,
1,79,2037,2116,0.0480027,0.0174490,
1,80,2037,2117,0.0536037,0.0206255,
1,81,2037,2118,0.0586892,0.0227503,
1,82,2037,2119,0.0642414,0.0250786,
1,83,2037,2120,0.0702997,0.0276689,
1,84,2037,2121,0.0769067,0.0306182,
1,85,2037,2122,0.0841076,0.0339740,
1,86,2037,2123,0.0919504,0.0377999,
1,87,2037,2124,0.1004863,0.0421279,
1,88,2037,2125,0.1097689,0.0469987,
1,89,2037,2126,0.1198550,0.0524887,
1,90,2037,2127,0.1308036,0.0586737,
1,91,2037,2128,0.1426766,0.0656298,
1,92,2037,2129,0.1555375,0.0734028,
1,93,2037,2130,0.1694519,0.0820517,
1,94,2037,2131,0.1844867,0.0917038,
1,95,2037,2132,0.2007091,0.1025193,
1,96,2037,2133,0.2181866,0.1146326,
1,97,2037,2134,0.2369856,0.1281173,
1,98,2037,2135,0.2571705,0.1430703,
1,99,2037,2136,0.2788028,0.1596796,
1,100,2037,2137,0.3019394,0.1781704,
1,101,2037,2138,0.3266317,0.1987266,
1,102,2037,2139,0.3529236,0.2214437,
1,103,2037,2140,0.3808502,0.2464342,
1,104,2037,2141,0.4104359,0.2739135,
1,105,2037,2142,0.4416930,0.3041223,
1,106,2037,2143,0.4746198,0.3372247,
1,107,2037,2144,0.5091990,0.3732613,
1,108,2037,2145,0.5453968,0.4122759,
1,109,2037,2146,0.5831612,0.4543923,
1,110,2037,2147,0.6224217,0.4997113,
1,111,2037,2148,0.6630882,0.5482069,
1,112,2037,2149,0.7050519,0.5997064,
1,113,2037,2150,0.7481851,0.6540206,
1,0,2038,2038,0.0091937,0.0031177,
1,1,2038,2039,0.0006668,0.0001379,
1,2,2038,2040,0.0003367,0.0000728,
1,3,2038,2041,0.0002291,0.0000491,
1,4,2038,2042,0.0001930,0.0000423,
1,5,2038,2043,0.0001870,0.0000443,
1,6,2038,2044,0.0001837,0.0000461,
1,7,2038,2045,0.0001828,0.0000484,
1,8,2038,2046,0.0001845,0.0000511,
1,9,2038,2047,0.0001904,0.0000558,
1,10,2038,2048,0.0002017,0.0000636,
1,11,2038,2049,0.0002200,0.0000747,
1,12,2038,2050,0.0002484,0.0000906,
1,13,2038,2051,0.0002934,0.0001168,
1,14,2038,2052,0.0003624,0.0001614,
1,15,2038,2053,0.0004596,0.0002307,
1,16,2038,2054,0.0005802,0.0003209,
1,17,2038,2055,0.0007098,0.0004168,
1,18,2038,2056,0.0008321,0.0005058,
1,19,2038,2057,0.0009391,0.0005810,
1,20,2038,2058,0.0010297,0.0006412,
1,21,2038,2059,0.0011033,0.0006843,
1,22,2038,2060,0.0011584,0.0007118,
1,23,2038,2061,0.0011978,0.0007330,
1,24,2038,2062,0.0012275,0.0007502,
1,25,2038,2063,0.0012521,0.0007551,
1,26,2038,2064,0.0012759,0.0007557,
1,27,2038,2065,0.0013058,0.0007627,
1,28,2038,2066,0.0013446,0.0007885,
1,29,2038,2067,0.0013859,0.0008101,
1,30,2038,2068,0.0014216,0.0008143,
1,31,2038,2069,0.0014530,0.0008130,
1,32,2038,2070,0.0014859,0.0008120,
1,33,2038,2071,0.0015203,0.0008043,
1,34,2038,2072,0.0015540,0.0007863,
1,35,2038,2073,0.0015941,0.0007626,
1,36,2038,2074,0.0016525,0.0007547,
1,37,2038,2075,0.0017318,0.0007604,
1,38,2038,2076,0.0018255,0.0007869,
1,39,2038,2077,0.0019305,0.0008320,
1,40,2038,2078,0.0020513,0.0008927,
1,41,2038,2079,0.0021897,0.0009665,
1,42,2038,2080,0.0023342,0.0010408,
1,43,2038,2081,0.0024669,0.0010994,
1,44,2038,2082,0.0025867,0.0011363,
1,45,2038,2083,0.0027191,0.0011555,
1,46,2038,2084,0.0028925,0.0012036,
1,47,2038,2085,0.0031101,0.0012797,
1,48,2038,2086,0.0033571,0.0013812,
1,49,2038,2087,0.0036304,0.0014920,
1,50,2038,2088,0.0039379,0.0015999,
1,51,2038,2089,0.0042708,0.0017079,
1,52,2038,2090,0.0046082,0.0018069,
1,53,2038,2091,0.0049489,0.0018830,
1,54,2038,2092,0.0053157,0.0019693,
1,55,2038,2093,0.0057365,0.0020767,
1,56,2038,2094,0.0062406,0.0022431,
1,57,2038,2095,0.0068502,0.0024749,
1,58,2038,2096,0.0075521,0.0027714,
1,59,2038,2097,0.0083035,0.0030813,
1,60,2038,2098,0.0090849,0.0033703,
1,61,2038,2099,0.0099105,0.0036434,
1,62,2038,2100,0.0107829,0.0038990,
1,63,2038,2101,0.0116995,0.0041518,
1,64,2038,2102,0.0126957,0.0044463,
1,65,2038,2103,0.0138071,0.0047925,
1,66,2038,2104,0.0150054,0.0051658,
1,67,2038,2105,0.0162315,0.0054794,
1,68,2038,2106,0.0174919,0.0057319,
1,69,2038,2107,0.0188954,0.0060271,
1,70,2038,2108,0.0205786,0.0064591,
1,71,2038,2109,0.0226142,0.0071154,
1,72,2038,2110,0.0250119,0.0080267,
1,73,2038,2111,0.0277519,0.0091879,
1,74,2038,2112,0.0307579,0.0105646,
1,75,2038,2113,0.0339099,0.0120057,
1,76,2038,2114,0.0371478,0.0133862,
1,77,2038,2115,0.0405123,0.0146748,
1,78,2038,2116,0.0440886,0.0159287,
1,79,2038,2117,0.0480027,0.0172780,
1,80,2038,2118,0.0536037,0.0204494,
1,81,2038,2119,0.0586892,0.0225530,
1,82,2038,2120,0.0642414,0.0248449,
1,83,2038,2121,0.0702997,0.0274096,
1,84,2038,2122,0.0769067,0.0303534,
1,85,2038,2123,0.0841076,0.0337080,
1,86,2038,2124,0.0919504,0.0375040,
1,87,2038,2125,0.1004863,0.0417792,
1,88,2038,2126,0.1097689,0.0466132,
1,89,2038,2127,0.1198550,0.0520972,
1,90,2038,2128,0.1308036,0.0582836,
1,91,2038,2129,0.1426766,0.0652005,
1,92,2038,2130,0.1555375,0.0729011,
1,93,2038,2131,0.1694519,0.0815013,
1,94,2038,2132,0.1844867,0.0911488,
1,95,2038,2133,0.2007091,0.1019679,
1,96,2038,2134,0.2181866,0.1140265,
1,97,2038,2135,0.2369856,0.1274150,
1,98,2038,2136,0.2571705,0.1423100,
1,99,2038,2137,0.2788028,0.1589253,
1,100,2038,2138,0.3019394,0.1774390,
1,101,2038,2139,0.3266317,0.1979467,
1,102,2038,2140,0.3529236,0.2205625,
1,103,2038,2141,0.3808502,0.2455025,
1,104,2038,2142,0.4104359,0.2730135,
1,105,2038,2143,0.4416930,0.3032748,
1,106,2038,2144,0.4746198,0.3363501,
1,107,2038,2145,0.5091990,0.3723102,
1,108,2038,2146,0.5453968,0.4113139,
1,109,2038,2147,0.5831612,0.4535085,
1,110,2038,2148,0.6224217,0.4989235,
1,111,2038,2149,0.6630882,0.5474433,
1,112,2038,2150,0.7050519,0.5989385,
1,0,2039,2039,0.0091936,0.0029936,
1,1,2039,2040,0.0006668,0.0001296,
1,2,2039,2041,0.0003367,0.0000686,
1,3,2039,2042,0.0002291,0.0000465,
1,4,2039,2043,0.0001930,0.0000403,
1,5,2039,2044,0.0001870,0.0000424,
1,6,2039,2045,0.0001837,0.0000440,
1,7,2039,2046,0.0001828,0.0000463,
1,8,2039,2047,0.0001845,0.0000492,
1,9,2039,2048,0.0001904,0.0000540,
1,10,2039,2049,0.0002017,0.0000617,
1,11,2039,2050,0.0002200,0.0000724,
1,12,2039,2051,0.0002484,0.0000880,
1,13,2039,2052,0.0002934,0.0001140,
1,14,2039,2053,0.0003624,0.0001584,
1,15,2039,2054,0.0004596,0.0002269,
1,16,2039,2055,0.0005802,0.0003161,
1,17,2039,2056,0.0007098,0.0004112,
1,18,2039,2057,0.0008321,0.0004999,
1,19,2039,2058,0.0009391,0.0005751,
1,20,2039,2059,0.0010297,0.0006347,
1,21,2039,2060,0.0011033,0.0006769,
1,22,2039,2061,0.0011584,0.0007040,
1,23,2039,2062,0.0011978,0.0007255,
1,24,2039,2063,0.0012275,0.0007433,
1,25,2039,2064,0.0012521,0.0007479,
1,26,2039,2065,0.0012759,0.0007476,
1,27,2039,2066,0.0013058,0.0007544,
1,28,2039,2067,0.0013446,0.0007806,
1,29,2039,2068,0.0013859,0.0008026,
1,30,2039,2069,0.0014216,0.0008064,
1,31,2039,2070,0.0014530,0.0008042,
1,32,2039,2071,0.0014859,0.0008027,
1,33,2039,2072,0.0015203,0.0007954,
1,34,2039,2073,0.0015540,0.0007779,
1,35,2039,2074,0.0015941,0.0007538,
1,36,2039,2075,0.0016525,0.0007448,
1,37,2039,2076,0.0017318,0.0007499,
1,38,2039,2077,0.0018255,0.0007765,
1,39,2039,2078,0.0019305,0.0008220,
1,40,2039,2079,0.0020513,0.0008818,
1,41,2039,2080,0.0021897,0.0009541,
1,42,2039,2081,0.0023342,0.0010275,
1,43,2039,2082,0.0024669,0.0010864,
1,44,2039,2083,0.0025867,0.0011238,
1,45,2039,2084,0.0027191,0.0011421,
1,46,2039,2085,0.0028925,0.0011884,
1,47,2039,2086,0.0031101,0.0012631,
1,48,2039,2087,0.0033571,0.0013645,
1,49,2039,2088,0.0036304,0.0014755,
1,50,2039,2089,0.0039379,0.0015817,
1,51,2039,2090,0.0042708,0.0016866,
1,52,2039,2091,0.0046082,0.0017837,
1,53,2039,2092,0.0049489,0.0018598,
1,54,2039,2093,0.0053157,0.0019464,
1,55,2039,2094,0.0057365,0.0020517,
1,56,2039,2095,0.0062406,0.0022138,
1,57,2039,2096,0.0068502,0.0024424,
1,58,2039,2097,0.0075521,0.0027380,
1,59,2039,2098,0.0083035,0.0030477,
1,60,2039,2099,0.0090849,0.0033332,
1,61,2039,2100,0.0099105,0.0035999,
1,62,2039,2101,0.0107829,0.0038511,
1,63,2039,2102,0.0116995,0.0041034,
1,64,2039,2103,0.0126957,0.0043980,
1,65,2039,2104,0.0138071,0.0047390,
1,66,2039,2105,0.0150054,0.0051031,
1,67,2039,2106,0.0162315,0.0054108,
1,68,2039,2107,0.0174919,0.0056632,
1,69,2039,2108,0.0188954,0.0059591,
1,70,2039,2109,0.0205786,0.0063838,
1,71,2039,2110,0.0226142,0.0070260,
1,72,2039,2111,0.0250119,0.0079262,
1,73,2039,2112,0.0277519,0.0090837,
1,74,2039,2113,0.0307579,0.0104587,
1,75,2039,2114,0.0339099,0.0118874,
1,76,2039,2115,0.0371478,0.0132466,
1,77,2039,2116,0.0405123,0.0145204,
1,78,2039,2117,0.0440886,0.0157717,
1,79,2039,2118,0.0480027,0.0171203,
1,80,2039,2119,0.0536037,0.0202692,
1,81,2039,2120,0.0586892,0.0223395,
1,82,2039,2121,0.0642414,0.0246079,
1,83,2039,2122,0.0702997,0.0271675,
1,84,2039,2123,0.0769067,0.0301099,
1,85,2039,2124,0.0841076,0.0334369,
1,86,2039,2125,0.0919504,0.0371841,
1,87,2039,2126,0.1004863,0.0414251,
1,88,2039,2127,0.1097689,0.0462530,
1,89,2039,2128,0.1198550,0.0517377,
1,90,2039,2129,0.1308036,0.0578873,
1,91,2039,2130,0.1426766,0.0647365,
1,92,2039,2131,0.1555375,0.0723908,
1,93,2039,2132,0.1694519,0.0809856,
1,94,2039,2133,0.1844867,0.0906351,
1,95,2039,2134,0.2007091,0.1014016,
1,96,2039,2135,0.2181866,0.1133682,
1,97,2039,2136,0.2369856,0.1266997,
1,98,2039,2137,0.2571705,0.1415975,
1,99,2039,2138,0.2788028,0.1582314,
1,100,2039,2139,0.3019394,0.1766952,
1,101,2039,2140,0.3266317,0.1971016,
1,102,2039,2141,0.3529236,0.2196634,
1,103,2039,2142,0.3808502,0.2446279,
1,104,2039,2143,0.4104359,0.2721834,
1,105,2039,2144,0.4416930,0.3024103,
1,106,2039,2145,0.4746198,0.3354003,
1,107,2039,2146,0.5091990,0.3713383,
1,108,2039,2147,0.5453968,0.4104089,
1,109,2039,2148,0.5831612,0.4526892,
1,110,2039,2149,0.6224217,0.4981146,
1,111,2039,2150,0.6630882,0.5466115,
1,0,2040,2040,0.0091936,0.0028640,
1,1,2040,2041,0.0006668,0.0001217,
1,2,2040,2042,0.0003367,0.0000649,
1,3,2040,2043,0.0002291,0.0000442,
1,4,2040,2044,0.0001930,0.0000384,
1,5,2040,2045,0.0001870,0.0000404,
1,6,2040,2046,0.0001837,0.0000420,
1,7,2040,2047,0.0001828,0.0000445,
1,8,2040,2048,0.0001845,0.0000475,
1,9,2040,2049,0.0001904,0.0000523,
1,10,2040,2050,0.0002017,0.0000597,
1,11,2040,2051,0.0002200,0.0000702,
1,12,2040,2052,0.0002484,0.0000857,
1,13,2040,2053,0.0002934,0.0001115,
1,14,2040,2054,0.0003624,0.0001553,
1,15,2040,2055,0.0004596,0.0002229,
1,16,2040,2056,0.0005802,0.0003112,
1,17,2040,2057,0.0007098,0.0004060,
1,18,2040,2058,0.0008321,0.0004945,
1,19,2040,2059,0.0009391,0.0005691,
1,20,2040,2060,0.0010297,0.0006278,
1,21,2040,2061,0.0011033,0.0006695,
1,22,2040,2062,0.0011584,0.0006967,
1,23,2040,2063,0.0011978,0.0007187,
1,24,2040,2064,0.0012275,0.0007362,
1,25,2040,2065,0.0012521,0.0007400,
1,26,2040,2066,0.0012759,0.0007395,
1,27,2040,2067,0.0013058,0.0007466,
1,28,2040,2068,0.0013446,0.0007733,
1,29,2040,2069,0.0013859,0.0007949,
1,30,2040,2070,0.0014216,0.0007978,
1,31,2040,2071,0.0014530,0.0007952,
1,32,2040,2072,0.0014859,0.0007941,
1,33,2040,2073,0.0015203,0.0007873,
1,34,2040,2074,0.0015540,0.0007694,
1,35,2040,2075,0.0015941,0.0007444,
1,36,2040,2076,0.0016525,0.0007349,
1,37,2040,2077,0.0017318,0.0007401,
1,38,2040,2078,0.0018255,0.0007670,
1,39,2040,2079,0.0019305,0.0008117,
1,40,2040,2080,0.0020513,0.0008701,
1,41,2040,2081,0.0021897,0.0009415,
1,42,2040,2082,0.0023342,0.0010151,
1,43,2040,2083,0.0024669,0.0010744,
1,44,2040,2084,0.0025867,0.0011111,
1,45,2040,2085,0.0027191,0.0011278,
1,46,2040,2086,0.0028925,0.0011729,
1,47,2040,2087,0.0031101,0.0012477,
1,48,2040,2088,0.0033571,0.0013493,
1,49,2040,2089,0.0036304,0.0014587,
1,50,2040,2090,0.0039379,0.0015620,
1,51,2040,2091,0.0042708,0.0016650,
1,52,2040,2092,0.0046082,0.0017620,
1,53,2040,2093,0.0049489,0.0018385,
1,54,2040,2094,0.0053157,0.0019232,
1,55,2040,2095,0.0057365,0.0020247,
1,56,2040,2096,0.0062406,0.0021841,
1,57,2040,2097,0.0068502,0.0024121,
1,58,2040,2098,0.0075521,0.0027075,
1,59,2040,2099,0.0083035,0.0030138,
1,60,2040,2100,0.0090849,0.0032933,
1,61,2040,2101,0.0099105,0.0035559,
1,62,2040,2102,0.0107829,0.0038065,
1,63,2040,2103,0.0116995,0.0040589,
1,64,2040,2104,0.0126957,0.0043489,
1,65,2040,2105,0.0138071,0.0046813,
1,66,2040,2106,0.0150054,0.0050396,
1,67,2040,2107,0.0162315,0.0053470,
1,68,2040,2108,0.0174919,0.0056001,
1,69,2040,2109,0.0188954,0.0058899,
1,70,2040,2110,0.0205786,0.0063026,
1,71,2040,2111,0.0226142,0.0069356,
1,72,2040,2112,0.0250119,0.0078328,
1,73,2040,2113,0.0277519,0.0089885,
1,74,2040,2114,0.0307579,0.0103517,
1,75,2040,2115,0.0339099,0.0117601,
1,76,2040,2116,0.0371478,0.0131051,
1,77,2040,2117,0.0405123,0.0143762,
1,78,2040,2118,0.0440886,0.0156270,
1,79,2040,2119,0.0480027,0.0169591,
1,80,2040,2120,0.0536037,0.0200742,
1,81,2040,2121,0.0586892,0.0221229,
1,82,2040,2122,0.0642414,0.0243866,
1,83,2040,2123,0.0702997,0.0269448,
1,84,2040,2124,0.0769067,0.0298618,
1,85,2040,2125,0.0841076,0.0331438,
1,86,2040,2126,0.0919504,0.0368594,
1,87,2040,2127,0.1004863,0.0410944,
1,88,2040,2128,0.1097689,0.0459223,
1,89,2040,2129,0.1198550,0.0513726,
1,90,2040,2130,0.1308036,0.0574590,
1,91,2040,2131,0.1426766,0.0642647,
1,92,2040,2132,0.1555375,0.0719130,
1,93,2040,2133,0.1694519,0.0805084,
1,94,2040,2134,0.1844867,0.0901077,
1,95,2040,2135,0.2007091,0.1007866,
1,96,2040,2136,0.2181866,0.1126978,
1,97,2040,2137,0.2369856,0.1260296,
1,98,2040,2138,0.2571705,0.1409421,
1,99,2040,2139,0.2788028,0.1575259,
1,100,2040,2140,0.3019394,0.1758896,
1,101,2040,2141,0.3266317,0.1962396,
1,102,2040,2142,0.3529236,0.2188196,
1,103,2040,2143,0.3808502,0.2438213,
1,104,2040,2144,0.4104359,0.2713367,
1,105,2040,2145,0.4416930,0.3014717,
1,106,2040,2146,0.4746198,0.3344300,
1,107,2040,2147,0.5091990,0.3704243,
1,108,2040,2148,0.5453968,0.4095702,
1,109,2040,2149,0.5831612,0.4518481,
1,110,2040,2150,0.6224217,0.4972337,
1,0,2041,2041,0.0091936,0.0027371,
1,1,2041,2042,0.0006668,0.0001146,
1,2,2041,2043,0.0003367,0.0000616,
1,3,2041,2044,0.0002291,0.0000420,
1,4,2041,2045,0.0001930,0.0000364,
1,5,2041,2046,0.0001870,0.0000384,
1,6,2041,2047,0.0001837,0.0000403,
1,7,2041,2048,0.0001828,0.0000428,
1,8,2041,2049,0.0001845,0.0000458,
1,9,2041,2050,0.0001904,0.0000504,
1,10,2041,2051,0.0002017,0.0000576,
1,11,2041,2052,0.0002200,0.0000681,
1,12,2041,2053,0.0002484,0.0000836,
1,13,2041,2054,0.0002934,0.0001089,
1,14,2041,2055,0.0003624,0.0001519,
1,15,2041,2056,0.0004596,0.0002188,
1,16,2041,2057,0.0005802,0.0003067,
1,17,2041,2058,0.0007098,0.0004012,
1,18,2041,2059,0.0008321,0.0004891,
1,19,2041,2060,0.0009391,0.0005627,
1,20,2041,2061,0.0010297,0.0006208,
1,21,2041,2062,0.0011033,0.0006625,
1,22,2041,2063,0.0011584,0.0006900,
1,23,2041,2064,0.0011978,0.0007117,
1,24,2041,2065,0.0012275,0.0007286,
1,25,2041,2066,0.0012521,0.0007321,
1,26,2041,2067,0.0012759,0.0007319,
1,27,2041,2068,0.0013058,0.0007394,
1,28,2041,2069,0.0013446,0.0007658,
1,29,2041,2070,0.0013859,0.0007867,
1,30,2041,2071,0.0014216,0.0007892,
1,31,2041,2072,0.0014530,0.0007869,
1,32,2041,2073,0.0014859,0.0007863,
1,33,2041,2074,0.0015203,0.0007792,
1,34,2041,2075,0.0015540,0.0007604,
1,35,2041,2076,0.0015941,0.0007348,
1,36,2041,2077,0.0016525,0.0007256,
1,37,2041,2078,0.0017318,0.0007311,
1,38,2041,2079,0.0018255,0.0007573,
1,39,2041,2080,0.0019305,0.0008007,
1,40,2041,2081,0.0020513,0.0008583,
1,41,2041,2082,0.0021897,0.0009298,
1,42,2041,2083,0.0023342,0.0010038,
1,43,2041,2084,0.0024669,0.0010624,
1,44,2041,2085,0.0025867,0.0010975,
1,45,2041,2086,0.0027191,0.0011133,
1,46,2041,2087,0.0028925,0.0011585,
1,47,2041,2088,0.0031101,0.0012335,
1,48,2041,2089,0.0033571,0.0013337,
1,49,2041,2090,0.0036304,0.0014406,
1,50,2041,2091,0.0039379,0.0015422,
1,51,2041,2092,0.0042708,0.0016450,
1,52,2041,2093,0.0046082,0.0017422,
1,53,2041,2094,0.0049489,0.0018168,
1,54,2041,2095,0.0053157,0.0018983,
1,55,2041,2096,0.0057365,0.0019975,
1,56,2041,2097,0.0062406,0.0021566,
1,57,2041,2098,0.0068502,0.0023845,
1,58,2041,2099,0.0075521,0.0026767,
1,59,2041,2100,0.0083035,0.0029774,
1,60,2041,2101,0.0090849,0.0032530,
1,61,2041,2102,0.0099105,0.0035149,
1,62,2041,2103,0.0107829,0.0037654,
1,63,2041,2104,0.0116995,0.0040136,
1,64,2041,2105,0.0126957,0.0042958,
1,65,2041,2106,0.0138071,0.0046229,
1,66,2041,2107,0.0150054,0.0049806,
1,67,2041,2108,0.0162315,0.0052883,
1,68,2041,2109,0.0174919,0.0055359,
1,69,2041,2110,0.0188954,0.0058153,
1,70,2041,2111,0.0205786,0.0062206,
1,71,2041,2112,0.0226142,0.0068516,
1,72,2041,2113,0.0250119,0.0077475,
1,73,2041,2114,0.0277519,0.0088925,
1,74,2041,2115,0.0307579,0.0102366,
1,75,2041,2116,0.0339099,0.0116312,
1,76,2041,2117,0.0371478,0.0129731,
1,77,2041,2118,0.0405123,0.0142434,
1,78,2041,2119,0.0440886,0.0154790,
1,79,2041,2120,0.0480027,0.0167847,
1,80,2041,2121,0.0536037,0.0198765,
1,81,2041,2122,0.0586892,0.0219208,
1,82,2041,2123,0.0642414,0.0241831,
1,83,2041,2124,0.0702997,0.0267179,
1,84,2041,2125,0.0769067,0.0295937,
1,85,2041,2126,0.0841076,0.0328464,
1,86,2041,2127,0.0919504,0.0365561,
1,87,2041,2128,0.1004863,0.0407907,
1,88,2041,2129,0.1097689,0.0455866,
1,89,2041,2130,0.1198550,0.0509781,
1,90,2041,2131,0.1308036,0.0570237,
1,91,2041,2132,0.1426766,0.0638229,
1,92,2041,2133,0.1555375,0.0714709,
1,93,2041,2134,0.1694519,0.0800186,
1,94,2041,2135,0.1844867,0.0895351,
1,95,2041,2136,0.2007091,0.1001606,
1,96,2041,2137,0.2181866,0.1120701,
1,97,2041,2138,0.2369856,0.1254135,
1,98,2041,2139,0.2571705,0.1402761,
1,99,2041,2140,0.2788028,0.1567619,
1,100,2041,2141,0.3019394,0.1750681,
1,101,2041,2142,0.3266317,0.1954309,
1,102,2041,2143,0.3529236,0.2180417,
1,103,2041,2144,0.3808502,0.2429990,
1,104,2041,2145,0.4104359,0.2704178,
1,105,2041,2146,0.4416930,0.3005133,
1,106,2041,2147,0.4746198,0.3335178,
1,107,2041,2148,0.5091990,0.3695775,
1,108,2041,2149,0.5453968,0.4087095,
1,109,2041,2150,0.5831612,0.4509324,
1,0,2042,2042,0.0091936,0.0026227,
1,1,2042,2043,0.0006668,0.0001084,
1,2,2042,2044,0.0003367,0.0000585,
1,3,2042,2045,0.0002291,0.0000398,
1,4,2042,2046,0.0001930,0.0000345,
1,5,2042,2047,0.0001870,0.0000366,
1,6,2042,2048,0.0001837,0.0000387,
1,7,2042,2049,0.0001828,0.0000412,
1,8,2042,2050,0.0001845,0.0000441,
1,9,2042,2051,0.0001904,0.0000485,
1,10,2042,2052,0.0002017,0.0000558,
1,11,2042,2053,0.0002200,0.0000663,
1,12,2042,2054,0.0002484,0.0000814,
1,13,2042,2055,0.0002934,0.0001062,
1,14,2042,2056,0.0003624,0.0001486,
1,15,2042,2057,0.0004596,0.0002150,
1,16,2042,2058,0.0005802,0.0003026,
1,17,2042,2059,0.0007098,0.0003963,
1,18,2042,2060,0.0008321,0.0004833,
1,19,2042,2061,0.0009391,0.0005562,
1,20,2042,2062,0.0010297,0.0006143,
1,21,2042,2063,0.0011033,0.0006562,
1,22,2042,2064,0.0011584,0.0006832,
1,23,2042,2065,0.0011978,0.0007042,
1,24,2042,2066,0.0012275,0.0007209,
1,25,2042,2067,0.0012521,0.0007248,
1,26,2042,2068,0.0012759,0.0007250,
1,27,2042,2069,0.0013058,0.0007321,
1,28,2042,2070,0.0013446,0.0007578,
1,29,2042,2071,0.0013859,0.0007783,
1,30,2042,2072,0.0014216,0.0007811,
1,31,2042,2073,0.0014530,0.0007793,
1,32,2042,2074,0.0014859,0.0007785,
1,33,2042,2075,0.0015203,0.0007705,
1,34,2042,2076,0.0015540,0.0007513,
1,35,2042,2077,0.0015941,0.0007260,
1,36,2042,2078,0.0016525,0.0007170,
1,37,2042,2079,0.0017318,0.0007219,
1,38,2042,2080,0.0018255,0.0007469,
1,39,2042,2081,0.0019305,0.0007895,
1,40,2042,2082,0.0020513,0.0008473,
1,41,2042,2083,0.0021897,0.0009192,
1,42,2042,2084,0.0023342,0.0009923,
1,43,2042,2085,0.0024669,0.0010494,
1,44,2042,2086,0.0025867,0.0010837,
1,45,2042,2087,0.0027191,0.0010998,
1,46,2042,2088,0.0028925,0.0011453,
1,47,2042,2089,0.0031101,0.0012191,
1,48,2042,2090,0.0033571,0.0013169,
1,49,2042,2091,0.0036304,0.0014223,
1,50,2042,2092,0.0039379,0.0015237,
1,51,2042,2093,0.0042708,0.0016266,
1,52,2042,2094,0.0046082,0.0017221,
1,53,2042,2095,0.0049489,0.0017936,
1,54,2042,2096,0.0053157,0.0018730,
1,55,2042,2097,0.0057365,0.0019722,
1,56,2042,2098,0.0062406,0.0021315,
1,57,2042,2099,0.0068502,0.0023566,
1,58,2042,2100,0.0075521,0.0026436,
1,59,2042,2101,0.0083035,0.0029405,
1,60,2042,2102,0.0090849,0.0032154,
1,61,2042,2103,0.0099105,0.0034772,
1,62,2042,2104,0.0107829,0.0037237,
1,63,2042,2105,0.0116995,0.0039647,
1,64,2042,2106,0.0126957,0.0042422,
1,65,2042,2107,0.0138071,0.0045686,
1,66,2042,2108,0.0150054,0.0049263,
1,67,2042,2109,0.0162315,0.0052287,
1,68,2042,2110,0.0174919,0.0054668,
1,69,2042,2111,0.0188954,0.0057400,
1,70,2042,2112,0.0205786,0.0061443,
1,71,2042,2113,0.0226142,0.0067749,
1,72,2042,2114,0.0250119,0.0076615,
1,73,2042,2115,0.0277519,0.0087892,
1,74,2042,2116,0.0307579,0.0101200,
1,75,2042,2117,0.0339099,0.0115109,
1,76,2042,2118,0.0371478,0.0128514,
1,77,2042,2119,0.0405123,0.0141075,
1,78,2042,2120,0.0440886,0.0153190,
1,79,2042,2121,0.0480027,0.0166080,
1,80,2042,2122,0.0536037,0.0196920,
1,81,2042,2123,0.0586892,0.0217350,
1,82,2042,2124,0.0642414,0.0239758,
1,83,2042,2125,0.0702997,0.0264728,
1,84,2042,2126,0.0769067,0.0293216,
1,85,2042,2127,0.0841076,0.0325687,
1,86,2042,2128,0.0919504,0.0362778,
1,87,2042,2129,0.1004863,0.0404826,
1,88,2042,2130,0.1097689,0.0452239,
1,89,2042,2131,0.1198550,0.0505773,
1,90,2042,2132,0.1308036,0.0566162,
1,91,2042,2133,0.1426766,0.0634143,
1,92,2042,2134,0.1555375,0.0710172,
1,93,2042,2135,0.1694519,0.0794871,
1,94,2042,2136,0.1844867,0.0889524,
1,95,2042,2137,0.2007091,0.0995746,
1,96,2042,2138,0.2181866,0.1114930,
1,97,2042,2139,0.2369856,0.1247874,
1,98,2042,2140,0.2571705,0.1395551,
1,99,2042,2141,0.2788028,0.1559831,
1,100,2042,2142,0.3019394,0.1742976,
1,101,2042,2143,0.3266317,0.1946856,
1,102,2042,2144,0.3529236,0.2172488,
1,103,2042,2145,0.3808502,0.2421067,
1,104,2042,2146,0.4104359,0.2694797,
1,105,2042,2147,0.4416930,0.2996124,
1,106,2042,2148,0.4746198,0.3326730,
1,107,2042,2149,0.5091990,0.3687087,
1,108,2042,2150,0.5453968,0.4077727,
1,0,2043,2043,0.0091936,0.0025214,
1,1,2043,2044,0.0006668,0.0001025,
1,2,2043,2045,0.0003367,0.0000552,
1,3,2043,2046,0.0002291,0.0000376,
1,4,2043,2047,0.0001930,0.0000328,
1,5,2043,2048,0.0001870,0.0000351,
1,6,2043,2049,0.0001837,0.0000371,
1,7,2043,2050,0.0001828,0.0000395,
1,8,2043,2051,0.0001845,0.0000423,
1,9,2043,2052,0.0001904,0.0000468,
1,10,2043,2053,0.0002017,0.0000541,
1,11,2043,2054,0.0002200,0.0000644,
1,12,2043,2055,0.0002484,0.0000791,
1,13,2043,2056,0.0002934,0.0001035,
1,14,2043,2057,0.0003624,0.0001455,
1,15,2043,2058,0.0004596,0.0002116,
1,16,2043,2059,0.0005802,0.0002984,
1,17,2043,2060,0.0007098,0.0003911,
1,18,2043,2061,0.0008321,0.0004774,
1,19,2043,2062,0.0009391,0.0005502,
1,20,2043,2063,0.0010297,0.0006083,
1,21,2043,2064,0.0011033,0.0006497,
1,22,2043,2065,0.0011584,0.0006759,
1,23,2043,2066,0.0011978,0.0006966,
1,24,2043,2067,0.0012275,0.0007137,
1,25,2043,2068,0.0012521,0.0007179,
1,26,2043,2069,0.0012759,0.0007178,
1,27,2043,2070,0.0013058,0.0007241,
1,28,2043,2071,0.0013446,0.0007496,
1,29,2043,2072,0.0013859,0.0007705,
1,30,2043,2073,0.0014216,0.0007737,
1,31,2043,2074,0.0014530,0.0007717,
1,32,2043,2075,0.0014859,0.0007701,
1,33,2043,2076,0.0015203,0.0007617,
1,34,2043,2077,0.0015540,0.0007428,
1,35,2043,2078,0.0015941,0.0007178,
1,36,2043,2079,0.0016525,0.0007083,
1,37,2043,2080,0.0017318,0.0007120,
1,38,2043,2081,0.0018255,0.0007363,
1,39,2043,2082,0.0019305,0.0007791,
1,40,2043,2083,0.0020513,0.0008373,
1,41,2043,2084,0.0021897,0.0009084,
1,42,2043,2085,0.0023342,0.0009800,
1,43,2043,2086,0.0024669,0.0010363,
1,44,2043,2087,0.0025867,0.0010709,
1,45,2043,2088,0.0027191,0.0010874,
1,46,2043,2089,0.0028925,0.0011319,
1,47,2043,2090,0.0031101,0.0012035,
1,48,2043,2091,0.0033571,0.0013000,
1,49,2043,2092,0.0036304,0.0014052,
1,50,2043,2093,0.0039379,0.0015068,
1,51,2043,2094,0.0042708,0.0016080,
1,52,2043,2095,0.0046082,0.0017004,
1,53,2043,2096,0.0049489,0.0017701,
1,54,2043,2097,0.0053157,0.0018496,
1,55,2043,2098,0.0057365,0.0019491,
1,56,2043,2099,0.0062406,0.0021061,
1,57,2043,2100,0.0068502,0.0023266,
1,58,2043,2101,0.0075521,0.0026101,
1,59,2043,2102,0.0083035,0.0029062,
1,60,2043,2103,0.0090849,0.0031808,
1,61,2043,2104,0.0099105,0.0034388,
1,62,2043,2105,0.0107829,0.0036786,
1,63,2043,2106,0.0116995,0.0039153,
1,64,2043,2107,0.0126957,0.0041922,
1,65,2043,2108,0.0138071,0.0045187,
1,66,2043,2109,0.0150054,0.0048711,
1,67,2043,2110,0.0162315,0.0051644,
1,68,2043,2111,0.0174919,0.0053969,
1,69,2043,2112,0.0188954,0.0056699,
1,70,2043,2113,0.0205786,0.0060747,
1,71,2043,2114,0.0226142,0.0066976,
1,72,2043,2115,0.0250119,0.0075691,
1,73,2043,2116,0.0277519,0.0086847,
1,74,2043,2117,0.0307579,0.0100114,
1,75,2043,2118,0.0339099,0.0114001,
1,76,2043,2119,0.0371478,0.0127270,
1,77,2043,2120,0.0405123,0.0139606,
1,78,2043,2121,0.0440886,0.0151569,
1,79,2043,2122,0.0480027,0.0164432,
1,80,2043,2123,0.0536037,0.0195224,
1,81,2043,2124,0.0586892,0.0215457,
1,82,2043,2125,0.0642414,0.0237519,
1,83,2043,2126,0.0702997,0.0262241,
1,84,2043,2127,0.0769067,0.0290676,
1,85,2043,2128,0.0841076,0.0323139,
1,86,2043,2129,0.0919504,0.0359954,
1,87,2043,2130,0.1004863,0.0401498,
1,88,2043,2131,0.1097689,0.0448555,
1,89,2043,2132,0.1198550,0.0502022,
1,90,2043,2133,0.1308036,0.0562395,
1,91,2043,2134,0.1426766,0.0629952,
1,92,2043,2135,0.1555375,0.0705251,
1,93,2043,2136,0.1694519,0.0789463,
1,94,2043,2137,0.1844867,0.0884071,
1,95,2043,2138,0.2007091,0.0990361,
1,96,2043,2139,0.2181866,0.1109069,
1,97,2043,2140,0.2369856,0.1241099,
1,98,2043,2141,0.2571705,0.1388204,
1,99,2043,2142,0.2788028,0.1552529,
1,100,2043,2143,0.3019394,0.1735877,
1,101,2043,2144,0.3266317,0.1939262,
1,102,2043,2145,0.3529236,0.2163888,
1,103,2043,2146,0.3808502,0.2411961,
1,104,2043,2147,0.4104359,0.2685983,
1,105,2043,2148,0.4416930,0.2987784,
1,106,2043,2149,0.4746198,0.3318064,
1,107,2043,2150,0.5091990,0.3677633,
1,0,2044,2044,0.0091936,0.0024220,
1,1,2044,2045,0.0006668,0.0000964,
1,2,2044,2046,0.0003367,0.0000521,
1,3,2044,2047,0.0002291,0.0000356,
1,4,2044,2048,0.0001930,0.0000313,
1,5,2044,2049,0.0001870,0.0000336,
1,6,2044,2050,0.0001837,0.0000354,
1,7,2044,2051,0.0001828,0.0000378,
1,8,2044,2052,0.0001845,0.0000407,
1,9,2044,2053,0.0001904,0.0000453,
1,10,2044,2054,0.0002017,0.0000525,
1,11,2044,2055,0.0002200,0.0000624,
1,12,2044,2056,0.0002484,0.0000768,
1,13,2044,2057,0.0002934,0.0001010,
1,14,2044,2058,0.0003624,0.0001427,
1,15,2044,2059,0.0004596,0.0002081,
1,16,2044,2060,0.0005802,0.0002940,
1,17,2044,2061,0.0007098,0.0003859,
1,18,2044,2062,0.0008321,0.0004719,
1,19,2044,2063,0.0009391,0.0005446,
1,20,2044,2064,0.0010297,0.0006023,
1,21,2044,2065,0.0011033,0.0006427,
1,22,2044,2066,0.0011584,0.0006685,
1,23,2044,2067,0.0011978,0.0006895,
1,24,2044,2068,0.0012275,0.0007070,
1,25,2044,2069,0.0012521,0.0007110,
1,26,2044,2070,0.0012759,0.0007101,
1,27,2044,2071,0.0013058,0.0007161,
1,28,2044,2072,0.0013446,0.0007419,
1,29,2044,2073,0.0013859,0.0007634,
1,30,2044,2074,0.0014216,0.0007664,
1,31,2044,2075,0.0014530,0.0007635,
1,32,2044,2076,0.0014859,0.0007616,
1,33,2044,2077,0.0015203,0.0007535,
1,34,2044,2078,0.0015540,0.0007349,
1,35,2044,2079,0.0015941,0.0007094,
1,36,2044,2080,0.0016525,0.0006989,
1,37,2044,2081,0.0017318,0.0007019,
1,38,2044,2082,0.0018255,0.0007265,
1,39,2044,2083,0.0019305,0.0007697,
1,40,2044,2084,0.0020513,0.0008272,
1,41,2044,2085,0.0021897,0.0008968,
1,42,2044,2086,0.0023342,0.0009676,
1,43,2044,2087,0.0024669,0.0010241,
1,44,2044,2088,0.0025867,0.0010592,
1,45,2044,2089,0.0027191,0.0010748,
1,46,2044,2090,0.0028925,0.0011175,
1,47,2044,2091,0.0031101,0.0011878,
1,48,2044,2092,0.0033571,0.0012842,
1,49,2044,2093,0.0036304,0.0013896,
1,50,2044,2094,0.0039379,0.0014896,
1,51,2044,2095,0.0042708,0.0015879,
1,52,2044,2096,0.0046082,0.0016785,
1,53,2044,2097,0.0049489,0.0017482,
1,54,2044,2098,0.0053157,0.0018281,
1,55,2044,2099,0.0057365,0.0019258,
1,56,2044,2100,0.0062406,0.0020788,
1,57,2044,2101,0.0068502,0.0022963,
1,58,2044,2102,0.0075521,0.0025789,
1,59,2044,2103,0.0083035,0.0028746,
1,60,2044,2104,0.0090849,0.0031456,
1,61,2044,2105,0.0099105,0.0033973,
1,62,2044,2106,0.0107829,0.0036330,
1,63,2044,2107,0.0116995,0.0038693,
1,64,2044,2108,0.0126957,0.0041464,
1,65,2044,2109,0.0138071,0.0044679,
1,66,2044,2110,0.0150054,0.0048116,
1,67,2044,2111,0.0162315,0.0050993,
1,68,2044,2112,0.0174919,0.0053318,
1,69,2044,2113,0.0188954,0.0056060,
1,70,2044,2114,0.0205786,0.0060046,
1,71,2044,2115,0.0226142,0.0066145,
1,72,2044,2116,0.0250119,0.0074756,
1,73,2044,2117,0.0277519,0.0085873,
1,74,2044,2118,0.0307579,0.0099113,
1,75,2044,2119,0.0339099,0.0112868,
1,76,2044,2120,0.0371478,0.0125925,
1,77,2044,2121,0.0405123,0.0138117,
1,78,2044,2122,0.0440886,0.0150057,
1,79,2044,2123,0.0480027,0.0162918,
1,80,2044,2124,0.0536037,0.0193497,
1,81,2044,2125,0.0586892,0.0213413,
1,82,2044,2126,0.0642414,0.0235248,
1,83,2044,2127,0.0702997,0.0259920,
1,84,2044,2128,0.0769067,0.0288346,
1,85,2044,2129,0.0841076,0.0320554,
1,86,2044,2130,0.0919504,0.0356905,
1,87,2044,2131,0.1004863,0.0398118,
1,88,2044,2132,0.1097689,0.0445109,
1,89,2044,2133,0.1198550,0.0498555,
1,90,2044,2134,0.1308036,0.0558531,
1,91,2044,2135,0.1426766,0.0625406,
1,92,2044,2136,0.1555375,0.0700245,
1,93,2044,2137,0.1694519,0.0784404,
1,94,2044,2138,0.1844867,0.0879062,
1,95,2044,2139,0.2007091,0.0984892,
1,96,2044,2140,0.2181866,0.1102727,
1,97,2044,2141,0.2369856,0.1234197,
1,98,2044,2142,0.2571705,0.1381317,
1,99,2044,2143,0.2788028,0.1545804,
1,100,2044,2144,0.3019394,0.1728646,
1,101,2044,2145,0.3266317,0.1931027,
1,102,2044,2146,0.3529236,0.2155113,
1,103,2044,2147,0.3808502,0.2403408,
1,104,2044,2148,0.4104359,0.2677824,
1,105,2044,2149,0.4416930,0.2979230,
1,106,2044,2150,0.4746198,0.3308637,
1,0,2045,2045,0.0091935,0.0023183,
1,1,2045,2046,0.0006668,0.0000905,
1,2,2045,2047,0.0003367,0.0000493,
1,3,2045,2048,0.0002291,0.0000339,
1,4,2045,2049,0.0001930,0.0000298,
1,5,2045,2050,0.0001870,0.0000320,
1,6,2045,2051,0.0001837,0.0000338,
1,7,2045,2052,0.0001828,0.0000363,
1,8,2045,2053,0.0001845,0.0000393,
1,9,2045,2054,0.0001904,0.0000438,
1,10,2045,2055,0.0002017,0.0000507,
1,11,2045,2056,0.0002200,0.0000604,
1,12,2045,2057,0.0002484,0.0000748,
1,13,2045,2058,0.0002934,0.0000987,
1,14,2045,2059,0.0003624,0.0001399,
1,15,2045,2060,0.0004596,0.0002044,
1,16,2045,2061,0.0005802,0.0002895,
1,17,2045,2062,0.0007098,0.0003810,
1,18,2045,2063,0.0008321,0.0004668,
1,19,2045,2064,0.0009391,0.0005390,
1,20,2045,2065,0.0010297,0.0005957,
1,21,2045,2066,0.0011033,0.0006357,
1,22,2045,2067,0.0011584,0.0006616,
1,23,2045,2068,0.0011978,0.0006829,
1,24,2045,2069,0.0012275,0.0007002,
1,25,2045,2070,0.0012521,0.0007034,
1,26,2045,2071,0.0012759,0.0007022,
1,27,2045,2072,0.0013058,0.0007086,
1,28,2045,2073,0.0013446,0.0007350,
1,29,2045,2074,0.0013859,0.0007562,
1,30,2045,2075,0.0014216,0.0007585,
1,31,2045,2076,0.0014530,0.0007553,
1,32,2045,2077,0.0014859,0.0007536,
1,33,2045,2078,0.0015203,0.0007459,
1,34,2045,2079,0.0015540,0.0007269,
1,35,2045,2080,0.0015941,0.0007004,
1,36,2045,2081,0.0016525,0.0006893,
1,37,2045,2082,0.0017318,0.0006926,
1,38,2045,2083,0.0018255,0.0007175,
1,39,2045,2084,0.0019305,0.0007601,
1,40,2045,2085,0.0020513,0.0008163,
1,41,2045,2086,0.0021897,0.0008851,
1,42,2045,2087,0.0023342,0.0009560,
1,43,2045,2088,0.0024669,0.0010129,
1,44,2045,2089,0.0025867,0.0010472,
1,45,2045,2090,0.0027191,0.0010612,
1,46,2045,2091,0.0028925,0.0011029,
1,47,2045,2092,0.0031101,0.0011732,
1,48,2045,2093,0.0033571,0.0012698,
1,49,2045,2094,0.0036304,0.0013738,
1,50,2045,2095,0.0039379,0.0014711,
1,51,2045,2096,0.0042708,0.0015676,
1,52,2045,2097,0.0046082,0.0016582,
1,53,2045,2098,0.0049489,0.0017283,
1,54,2045,2099,0.0053157,0.0018065,
1,55,2045,2100,0.0057365,0.0019007,
1,56,2045,2101,0.0062406,0.0020512,
1,57,2045,2102,0.0068502,0.0022680,
1,58,2045,2103,0.0075521,0.0025502,
1,59,2045,2104,0.0083035,0.0028425,
1,60,2045,2105,0.0090849,0.0031077,
1,61,2045,2106,0.0099105,0.0033554,
1,62,2045,2107,0.0107829,0.0035906,
1,63,2045,2108,0.0116995,0.0038270,
1,64,2045,2109,0.0126957,0.0040997,
1,65,2045,2110,0.0138071,0.0044132,
1,66,2045,2111,0.0150054,0.0047515,
1,67,2045,2112,0.0162315,0.0050389,
1,68,2045,2113,0.0174919,0.0052725,
1,69,2045,2114,0.0188954,0.0055415,
1,70,2045,2115,0.0205786,0.0059292,
1,71,2045,2116,0.0226142,0.0065305,
1,72,2045,2117,0.0250119,0.0073885,
1,73,2045,2118,0.0277519,0.0084977,
1,74,2045,2119,0.0307579,0.0098090,
1,75,2045,2120,0.0339099,0.0111644,
1,76,2045,2121,0.0371478,0.0124562,
1,77,2045,2122,0.0405123,0.0136730,
1,78,2045,2123,0.0440886,0.0148667,
1,79,2045,2124,0.0480027,0.0161378,
1,80,2045,2125,0.0536037,0.0191631,
1,81,2045,2126,0.0586892,0.0211340,
1,82,2045,2127,0.0642414,0.0233129,
1,83,2045,2128,0.0702997,0.0257792,
1,84,2045,2129,0.0769067,0.0285983,
1,85,2045,2130,0.0841076,0.0317765,
1,86,2045,2131,0.0919504,0.0353809,
1,87,2045,2132,0.1004863,0.0394957,
1,88,2045,2133,0.1097689,0.0441925,
1,89,2045,2134,0.1198550,0.0495000,
1,90,2045,2135,0.1308036,0.0554341,
1,91,2045,2136,0.1426766,0.0620784,
1,92,2045,2137,0.1555375,0.0695564,
1,93,2045,2138,0.1694519,0.0779757,
1,94,2045,2139,0.1844867,0.0873976,
1,95,2045,2140,0.2007091,0.0978977,
1,96,2045,2141,0.2181866,0.1096269,
1,97,2045,2142,0.2369856,0.1227730,
1,98,2045,2143,0.2571705,0.1374976,
1,99,2045,2144,0.2788028,0.1538955,
1,100,2045,2145,0.3019394,0.1720807,
1,101,2045,2146,0.3266317,0.1922628,
1,102,2045,2147,0.3529236,0.2146874,
1,103,2045,2148,0.3808502,0.2395493,
1,104,2045,2149,0.4104359,0.2669460,
1,105,2045,2150,0.4416930,0.2969927,
1,0,2046,2046,0.0091935,0.0022168,
1,1,2046,2047,0.0006668,0.0000853,
1,2,2046,2048,0.0003367,0.0000468,
1,3,2046,2049,0.0002291,0.0000322,
1,4,2046,2050,0.0001930,0.0000282,
1,5,2046,2051,0.0001870,0.0000304,
1,6,2046,2052,0.0001837,0.0000324,
1,7,2046,2053,0.0001828,0.0000350,
1,8,2046,2054,0.0001845,0.0000379,
1,9,2046,2055,0.0001904,0.0000422,
1,10,2046,2056,0.0002017,0.0000489,
1,11,2046,2057,0.0002200,0.0000586,
1,12,2046,2058,0.0002484,0.0000729,
1,13,2046,2059,0.0002934,0.0000965,
1,14,2046,2060,0.0003624,0.0001369,
1,15,2046,2061,0.0004596,0.0002007,
1,16,2046,2062,0.0005802,0.0002853,
1,17,2046,2063,0.0007098,0.0003766,
1,18,2046,2064,0.0008321,0.0004617,
1,19,2046,2065,0.0009391,0.0005330,
1,20,2046,2066,0.0010297,0.0005891,
1,21,2046,2067,0.0011033,0.0006291,
1,22,2046,2068,0.0011584,0.0006553,
1,23,2046,2069,0.0011978,0.0006762,
1,24,2046,2070,0.0012275,0.0006928,
1,25,2046,2071,0.0012521,0.0006958,
1,26,2046,2072,0.0012759,0.0006949,
1,27,2046,2073,0.0013058,0.0007018,
1,28,2046,2074,0.0013446,0.0007281,
1,29,2046,2075,0.0013859,0.0007486,
1,30,2046,2076,0.0014216,0.0007504,
1,31,2046,2077,0.0014530,0.0007476,
1,32,2046,2078,0.0014859,0.0007463,
1,33,2046,2079,0.0015203,0.0007381,
1,34,2046,2080,0.0015540,0.0007182,
1,35,2046,2081,0.0015941,0.0006913,
1,36,2046,2082,0.0016525,0.0006805,
1,37,2046,2083,0.0017318,0.0006841,
1,38,2046,2084,0.0018255,0.0007085,
1,39,2046,2085,0.0019305,0.0007499,
1,40,2046,2086,0.0020513,0.0008053,
1,41,2046,2087,0.0021897,0.0008742,
1,42,2046,2088,0.0023342,0.0009454,
1,43,2046,2089,0.0024669,0.0010015,
1,44,2046,2090,0.0025867,0.0010343,
1,45,2046,2091,0.0027191,0.0010475,
1,46,2046,2092,0.0028925,0.0010893,
1,47,2046,2093,0.0031101,0.0011598,
1,48,2046,2094,0.0033571,0.0012552,
1,49,2046,2095,0.0036304,0.0013567,
1,50,2046,2096,0.0039379,0.0014524,
1,51,2046,2097,0.0042708,0.0015487,
1,52,2046,2098,0.0046082,0.0016396,
1,53,2046,2099,0.0049489,0.0017081,
1,54,2046,2100,0.0053157,0.0017832,
1,55,2046,2101,0.0057365,0.0018754,
1,56,2046,2102,0.0062406,0.0020256,
1,57,2046,2103,0.0068502,0.0022421,
1,58,2046,2104,0.0075521,0.0025211,
1,59,2046,2105,0.0083035,0.0028078,
1,60,2046,2106,0.0090849,0.0030693,
1,61,2046,2107,0.0099105,0.0033164,
1,62,2046,2108,0.0107829,0.0035516,
1,63,2046,2109,0.0116995,0.0037840,
1,64,2046,2110,0.0126957,0.0040494,
1,65,2046,2111,0.0138071,0.0043579,
1,66,2046,2112,0.0150054,0.0046955,
1,67,2046,2113,0.0162315,0.0049837,
1,68,2046,2114,0.0174919,0.0052127,
1,69,2046,2115,0.0188954,0.0054723,
1,70,2046,2116,0.0205786,0.0058530,
1,71,2046,2117,0.0226142,0.0064523,
1,72,2046,2118,0.0250119,0.0073084,
1,73,2046,2119,0.0277519,0.0084061,
1,74,2046,2120,0.0307579,0.0096986,
1,75,2046,2121,0.0339099,0.0110404,
1,76,2046,2122,0.0371478,0.0123292,
1,77,2046,2123,0.0405123,0.0135454,
1,78,2046,2124,0.0440886,0.0147254,
1,79,2046,2125,0.0480027,0.0159715,
1,80,2046,2126,0.0536037,0.0189740,
1,81,2046,2127,0.0586892,0.0209406,
1,82,2046,2128,0.0642414,0.0231186,
1,83,2046,2129,0.0702997,0.0255634,
1,84,2046,2130,0.0769067,0.0283433,
1,85,2046,2131,0.0841076,0.0314933,
1,86,2046,2132,0.0919504,0.0350915,
1,87,2046,2133,0.1004863,0.0392038,
1,88,2046,2134,0.1097689,0.0438661,
1,89,2046,2135,0.1198550,0.0491147,
1,90,2046,2136,0.1308036,0.0550083,
1,91,2046,2137,0.1426766,0.0616463,
1,92,2046,2138,0.1555375,0.0691266,
1,93,2046,2139,0.1694519,0.0775042,
1,94,2046,2140,0.1844867,0.0868477,
1,95,2046,2141,0.2007091,0.0972956,
1,96,2046,2142,0.2181866,0.1090220,
1,97,2046,2143,0.2369856,0.1221777,
1,98,2046,2144,0.2571705,0.1368520,
1,99,2046,2145,0.2788028,0.1531533,
1,100,2046,2146,0.3019394,0.1712814,
1,101,2046,2147,0.3266317,0.1914743,
1,102,2046,2148,0.3529236,0.2139252,
1,103,2046,2149,0.3808502,0.2387380,
1,104,2046,2150,0.4104359,0.2660365,
1,0,2047,2047,0.0091935,0.0021251,
1,1,2047,2048,0.0006668,0.0000808,
1,2,2047,2049,0.0003367,0.0000444,
1,3,2047,2050,0.0002291,0.0000305,
1,4,2047,2051,0.0001930,0.0000268,
1,5,2047,2052,0.0001870,0.0000290,
1,6,2047,2053,0.0001837,0.0000311,
1,7,2047,2054,0.0001828,0.0000336,
1,8,2047,2055,0.0001845,0.0000364,
1,9,2047,2056,0.0001904,0.0000406,
1,10,2047,2057,0.0002017,0.0000473,
1,11,2047,2058,0.0002200,0.0000570,
1,12,2047,2059,0.0002484,0.0000710,
1,13,2047,2060,0.0002934,0.0000941,
1,14,2047,2061,0.0003624,0.0001340,
1,15,2047,2062,0.0004596,0.0001973,
1,16,2047,2063,0.0005802,0.0002815,
1,17,2047,2064,0.0007098,0.0003720,
1,18,2047,2065,0.0008321,0.0004562,
1,19,2047,2066,0.0009391,0.0005268,
1,20,2047,2067,0.0010297,0.0005829,
1,21,2047,2068,0.0011033,0.0006230,
1,22,2047,2069,0.0011584,0.0006487,
1,23,2047,2070,0.0011978,0.0006690,
1,24,2047,2071,0.0012275,0.0006853,
1,25,2047,2072,0.0012521,0.0006887,
1,26,2047,2073,0.0012759,0.0006883,
1,27,2047,2074,0.0013058,0.0006950,
1,28,2047,2075,0.0013446,0.0007206,
1,29,2047,2076,0.0013859,0.0007408,
1,30,2047,2077,0.0014216,0.0007430,
1,31,2047,2078,0.0014530,0.0007404,
1,32,2047,2079,0.0014859,0.0007388,
1,33,2047,2080,0.0015203,0.0007298,
1,34,2047,2081,0.0015540,0.0007094,
1,35,2047,2082,0.0015941,0.0006828,
1,36,2047,2083,0.0016525,0.0006724,
1,37,2047,2084,0.0017318,0.0006756,
1,38,2047,2085,0.0018255,0.0006988,
1,39,2047,2086,0.0019305,0.0007395,
1,40,2047,2087,0.0020513,0.0007951,
1,41,2047,2088,0.0021897,0.0008642,
1,42,2047,2089,0.0023342,0.0009346,
1,43,2047,2090,0.0024669,0.0009892,
1,44,2047,2091,0.0025867,0.0010213,
1,45,2047,2092,0.0027191,0.0010347,
1,46,2047,2093,0.0028925,0.0010768,
1,47,2047,2094,0.0031101,0.0011463,
1,48,2047,2095,0.0033571,0.0012394,
1,49,2047,2096,0.0036304,0.0013395,
1,50,2047,2097,0.0039379,0.0014350,
1,51,2047,2098,0.0042708,0.0015315,
1,52,2047,2099,0.0046082,0.0016208,
1,53,2047,2100,0.0049489,0.0016864,
1,54,2047,2101,0.0053157,0.0017597,
1,55,2047,2102,0.0057365,0.0018518,
1,56,2047,2103,0.0062406,0.0020020,
1,57,2047,2104,0.0068502,0.0022157,
1,58,2047,2105,0.0075521,0.0024896,
1,59,2047,2106,0.0083035,0.0027727,
1,60,2047,2107,0.0090849,0.0030335,
1,61,2047,2108,0.0099105,0.0032806,
1,62,2047,2109,0.0107829,0.0035120,
1,63,2047,2110,0.0116995,0.0037377,
1,64,2047,2111,0.0126957,0.0039986,
1,65,2047,2112,0.0138071,0.0043064,
1,66,2047,2113,0.0150054,0.0046444,
1,67,2047,2114,0.0162315,0.0049280,
1,68,2047,2115,0.0174919,0.0051484,
1,69,2047,2116,0.0188954,0.0054023,
1,70,2047,2117,0.0205786,0.0057821,
1,71,2047,2118,0.0226142,0.0063804,
1,72,2047,2119,0.0250119,0.0072265,
1,73,2047,2120,0.0277519,0.0083072,
1,74,2047,2121,0.0307579,0.0095867,
1,75,2047,2122,0.0339099,0.0109248,
1,76,2047,2123,0.0371478,0.0122125,
1,77,2047,2124,0.0405123,0.0134157,
1,78,2047,2125,0.0440886,0.0145729,
1,79,2047,2126,0.0480027,0.0158030,
1,80,2047,2127,0.0536037,0.0187976,
1,81,2047,2128,0.0586892,0.0207633,
1,82,2047,2129,0.0642414,0.0229216,
1,83,2047,2130,0.0702997,0.0253305,
1,84,2047,2131,0.0769067,0.0280846,
1,85,2047,2132,0.0841076,0.0312286,
1,86,2047,2133,0.0919504,0.0348242,
1,87,2047,2134,0.1004863,0.0389046,
1,88,2047,2135,0.1097689,0.0435123,
1,89,2047,2136,0.1198550,0.0487232,
1,90,2047,2137,0.1308036,0.0546103,
1,91,2047,2138,0.1426766,0.0612497,
1,92,2047,2139,0.1555375,0.0686905,
1,93,2047,2140,0.1694519,0.0769944,
1,94,2047,2141,0.1844867,0.0862881,
1,95,2047,2142,0.2007091,0.0967317,
1,96,2047,2143,0.2181866,0.1084653,
1,97,2047,2144,0.2369856,0.1215718,
1,98,2047,2145,0.2571705,0.1361526,
1,99,2047,2146,0.2788028,0.1523968,
1,100,2047,2147,0.3019394,0.1705314,
1,101,2047,2148,0.3266317,0.1907451,
1,102,2047,2149,0.3529236,0.2131442,
1,103,2047,2150,0.3808502,0.2378563,
1,0,2048,2048,0.0091935,0.0020435,
1,1,2048,2049,0.0006668,0.0000764,
1,2,2048,2050,0.0003367,0.0000419,
1,3,2048,2051,0.0002291,0.0000288,
1,4,2048,2052,0.0001930,0.0000254,
1,5,2048,2053,0.0001870,0.0000278,
1,6,2048,2054,0.0001837,0.0000298,
1,7,2048,2055,0.0001828,0.0000322,
1,8,2048,2056,0.0001845,0.0000349,
1,9,2048,2057,0.0001904,0.0000391,
1,10,2048,2058,0.0002017,0.0000459,
1,11,2048,2059,0.0002200,0.0000554,
1,12,2048,2060,0.0002484,0.0000690,
1,13,2048,2061,0.0002934,0.0000917,
1,14,2048,2062,0.0003624,0.0001312,
1,15,2048,2063,0.0004596,0.0001941,
1,16,2048,2064,0.0005802,0.0002777,
1,17,2048,2065,0.0007098,0.0003672,
1,18,2048,2066,0.0008321,0.0004506,
1,19,2048,2067,0.0009391,0.0005211,
1,20,2048,2068,0.0010297,0.0005772,
1,21,2048,2069,0.0011033,0.0006168,
1,22,2048,2070,0.0011584,0.0006417,
1,23,2048,2071,0.0011978,0.0006617,
1,24,2048,2072,0.0012275,0.0006784,
1,25,2048,2073,0.0012521,0.0006822,
1,26,2048,2074,0.0012759,0.0006816,
1,27,2048,2075,0.0013058,0.0006877,
1,28,2048,2076,0.0013446,0.0007130,
1,29,2048,2077,0.0013859,0.0007336,
1,30,2048,2078,0.0014216,0.0007360,
1,31,2048,2079,0.0014530,0.0007332,
1,32,2048,2080,0.0014859,0.0007307,
1,33,2048,2081,0.0015203,0.0007213,
1,34,2048,2082,0.0015540,0.0007012,
1,35,2048,2083,0.0015941,0.0006750,
1,36,2048,2084,0.0016525,0.0006642,
1,37,2048,2085,0.0017318,0.0006664,
1,38,2048,2086,0.0018255,0.0006890,
1,39,2048,2087,0.0019305,0.0007299,
1,40,2048,2088,0.0020513,0.0007857,
1,41,2048,2089,0.0021897,0.0008541,
1,42,2048,2090,0.0023342,0.0009230,
1,43,2048,2091,0.0024669,0.0009768,
1,44,2048,2092,0.0025867,0.0010092,
1,45,2048,2093,0.0027191,0.0010230,
1,46,2048,2094,0.0028925,0.0010642,
1,47,2048,2095,0.0031101,0.0011317,
1,48,2048,2096,0.0033571,0.0012234,
1,49,2048,2097,0.0036304,0.0013235,
1,50,2048,2098,0.0039379,0.0014191,
1,51,2048,2099,0.0042708,0.0015141,
1,52,2048,2100,0.0046082,0.0016006,
1,53,2048,2101,0.0049489,0.0016645,
1,54,2048,2102,0.0053157,0.0017379,
1,55,2048,2103,0.0057365,0.0018302,
1,56,2048,2104,0.0062406,0.0019780,
1,57,2048,2105,0.0068502,0.0021873,
1,58,2048,2106,0.0075521,0.0024578,
1,59,2048,2107,0.0083035,0.0027401,
1,60,2048,2108,0.0090849,0.0030007,
1,61,2048,2109,0.0099105,0.0032441,
1,62,2048,2110,0.0107829,0.0034692,
1,63,2048,2111,0.0116995,0.0036908,
1,64,2048,2112,0.0126957,0.0039513,
1,65,2048,2113,0.0138071,0.0042595,
1,66,2048,2114,0.0150054,0.0045929,
1,67,2048,2115,0.0162315,0.0048682,
1,68,2048,2116,0.0174919,0.0050834,
1,69,2048,2117,0.0188954,0.0053371,
1,70,2048,2118,0.0205786,0.0057169,
1,71,2048,2119,0.0226142,0.0063069,
1,72,2048,2120,0.0250119,0.0071382,
1,73,2048,2121,0.0277519,0.0082072,
1,74,2048,2122,0.0307579,0.0094825,
1,75,2048,2123,0.0339099,0.0108187,
1,76,2048,2124,0.0371478,0.0120938,
1,77,2048,2125,0.0405123,0.0132757,
1,78,2048,2126,0.0440886,0.0144183,
1,79,2048,2127,0.0480027,0.0156460,
1,80,2048,2128,0.0536037,0.0186358,
1,81,2048,2129,0.0586892,0.0205836,
1,82,2048,2130,0.0642414,0.0227090,
1,83,2048,2131,0.0702997,0.0250942,
1,84,2048,2132,0.0769067,0.0278428,
1,85,2048,2133,0.0841076,0.0309842,
1,86,2048,2134,0.0919504,0.0345503,
1,87,2048,2135,0.1004863,0.0385804,
1,88,2048,2136,0.1097689,0.0431531,
1,89,2048,2137,0.1198550,0.0483573,
1,90,2048,2138,0.1308036,0.0542451,
1,91,2048,2139,0.1426766,0.0608473,
1,92,2048,2140,0.1555375,0.0682192,
1,93,2048,2141,0.1694519,0.0764758,
1,94,2048,2142,0.1844867,0.0857642,
1,95,2048,2143,0.2007091,0.0962130,
1,96,2048,2144,0.2181866,0.1078988,
1,97,2048,2145,0.2369856,0.1209156,
1,98,2048,2146,0.2571705,0.1354399,
1,99,2048,2147,0.2788028,0.1516870,
1,100,2048,2148,0.3019394,0.1698379,
1,101,2048,2149,0.3266317,0.1899982,
1,102,2048,2150,0.3529236,0.2122956,
1,0,2049,2049,0.0091935,0.0019629,
1,1,2049,2050,0.0006668,0.0000718,
1,2,2049,2051,0.0003367,0.0000395,
1,3,2049,2052,0.0002291,0.0000273,
1,4,2049,2053,0.0001930,0.0000242,
1,5,2049,2054,0.0001870,0.0000265,
1,6,2049,2055,0.0001837,0.0000284,
1,7,2049,2056,0.0001828,0.0000308,
1,8,2049,2057,0.0001845,0.0000336,
1,9,2049,2058,0.0001904,0.0000378,
1,10,2049,2059,0.0002017,0.0000445,
1,11,2049,2060,0.0002200,0.0000537,
1,12,2049,2061,0.0002484,0.0000670,
1,13,2049,2062,0.0002934,0.0000895,
1,14,2049,2063,0.0003624,0.0001287,
1,15,2049,2064,0.0004596,0.0001910,
1,16,2049,2065,0.0005802,0.0002735,
1,17,2049,2066,0.0007098,0.0003623,
1,18,2049,2067,0.0008321,0.0004454,
1,19,2049,2068,0.0009391,0.0005158,
1,20,2049,2069,0.0010297,0.0005714,
1,21,2049,2070,0.0011033,0.0006101,
1,22,2049,2071,0.0011584,0.0006345,
1,23,2049,2072,0.0011978,0.0006548,
1,24,2049,2073,0.0012275,0.0006721,
1,25,2049,2074,0.0012521,0.0006757,
1,26,2049,2075,0.0012759,0.0006745,
1,27,2049,2076,0.0013058,0.0006802,
1,28,2049,2077,0.0013446,0.0007060,
1,29,2049,2078,0.0013859,0.0007269,
1,30,2049,2079,0.0014216,0.0007290,
1,31,2049,2080,0.0014530,0.0007253,
1,32,2049,2081,0.0014859,0.0007225,
1,33,2049,2082,0.0015203,0.0007134,
1,34,2049,2083,0.0015540,0.0006938,
1,35,2049,2084,0.0015941,0.0006672,
1,36,2049,2085,0.0016525,0.0006555,
1,37,2049,2086,0.0017318,0.0006571,
1,38,2049,2087,0.0018255,0.0006799,
1,39,2049,2088,0.0019305,0.0007211,
1,40,2049,2089,0.0020513,0.0007762,
1,41,2049,2090,0.0021897,0.0008431,
1,42,2049,2091,0.0023342,0.0009112,
1,43,2049,2092,0.0024669,0.0009652,
1,44,2049,2093,0.0025867,0.0009981,
1,45,2049,2094,0.0027191,0.0010111,
1,46,2049,2095,0.0028925,0.0010506,
1,47,2049,2096,0.0031101,0.0011169,
1,48,2049,2097,0.0033571,0.0012086,
1,49,2049,2098,0.0036304,0.0013088,
1,50,2049,2099,0.0039379,0.0014030,
1,51,2049,2100,0.0042708,0.0014954,
1,52,2049,2101,0.0046082,0.0015802,
1,53,2049,2102,0.0049489,0.0016441,
1,54,2049,2103,0.0053157,0.0017178,
1,55,2049,2104,0.0057365,0.0018081,
1,56,2049,2105,0.0062406,0.0019522,
1,57,2049,2106,0.0068502,0.0021585,
1,58,2049,2107,0.0075521,0.0024282,
1,59,2049,2108,0.0083035,0.0027101,
1,60,2049,2109,0.0090849,0.0029673,
1,61,2049,2110,0.0099105,0.0032048,
1,62,2049,2111,0.0107829,0.0034260,
1,63,2049,2112,0.0116995,0.0036472,
1,64,2049,2113,0.0126957,0.0039081,
1,65,2049,2114,0.0138071,0.0042121,
1,66,2049,2115,0.0150054,0.0045375,
1,67,2049,2116,0.0162315,0.0048076,
1,68,2049,2117,0.0174919,0.0050229,
1,69,2049,2118,0.0188954,0.0052771,
1,70,2049,2119,0.0205786,0.0056503,
1,71,2049,2120,0.0226142,0.0062277,
1,72,2049,2121,0.0250119,0.0070489,
1,73,2049,2122,0.0277519,0.0081140,
1,74,2049,2123,0.0307579,0.0093869,
1,75,2049,2124,0.0339099,0.0107108,
1,76,2049,2125,0.0371478,0.0119657,
1,77,2049,2126,0.0405123,0.0131339,
1,78,2049,2127,0.0440886,0.0142742,
1,79,2049,2128,0.0480027,0.0155021,
1,80,2049,2129,0.0536037,0.0184719,
1,81,2049,2130,0.0586892,0.0203897,
1,82,2049,2131,0.0642414,0.0224935,
1,83,2049,2132,0.0702997,0.0248735,
1,84,2049,2133,0.0769067,0.0276195,
1,85,2049,2134,0.0841076,0.0307339,
1,86,2049,2135,0.0919504,0.0342537,
1,87,2049,2136,0.1004863,0.0382513,
1,88,2049,2137,0.1097689,0.0428174,
1,89,2049,2138,0.1198550,0.0480217,
1,90,2049,2139,0.1308036,0.0538747,
1,91,2049,2140,0.1426766,0.0604127,
1,92,2049,2141,0.1555375,0.0677399,
1,93,2049,2142,0.1694519,0.0759905,
1,94,2049,2143,0.1844867,0.0852824,
1,95,2049,2144,0.2007091,0.0956853,
1,96,2049,2145,0.2181866,0.1072855,
1,97,2049,2146,0.2369856,0.1202471,
1,98,2049,2147,0.2571705,0.1347716,
1,99,2049,2148,0.2788028,0.1510311,
1,100,2049,2149,0.3019394,0.1691278,
1,101,2049,2150,0.3266317,0.1891868,
1,0,2050,2050,0.0091935,0.0018786,
1,1,2050,2051,0.0006668,0.0000674,
1,2,2050,2052,0.0003367,0.0000374,
1,3,2050,2053,0.0002291,0.0000259,
1,4,2050,2054,0.0001930,0.0000231,
1,5,2050,2055,0.0001870,0.0000252,
1,6,2050,2056,0.0001837,0.0000271,
1,7,2050,2057,0.0001828,0.0000295,
1,8,2050,2058,0.0001845,0.0000324,
1,9,2050,2059,0.0001904,0.0000366,
1,10,2050,2060,0.0002017,0.0000430,
1,11,2050,2061,0.0002200,0.0000520,
1,12,2050,2062,0.0002484,0.0000652,
1,13,2050,2063,0.0002934,0.0000875,
1,14,2050,2064,0.0003624,0.0001262,
1,15,2050,2065,0.0004596,0.0001876,
1,16,2050,2066,0.0005802,0.0002694,
1,17,2050,2067,0.0007098,0.0003577,
1,18,2050,2068,0.0008321,0.0004406,
1,19,2050,2069,0.0009391,0.0005104,
1,20,2050,2070,0.0010297,0.0005651,
1,21,2050,2071,0.0011033,0.0006033,
1,22,2050,2072,0.0011584,0.0006279,
1,23,2050,2073,0.0011978,0.0006486,
1,24,2050,2074,0.0012275,0.0006657,
1,25,2050,2075,0.0012521,0.0006688,
1,26,2050,2076,0.0012759,0.0006673,
1,27,2050,2077,0.0013058,0.0006733,
1,28,2050,2078,0.0013446,0.0006995,
1,29,2050,2079,0.0013859,0.0007200,
1,30,2050,2080,0.0014216,0.0007213,
1,31,2050,2081,0.0014530,0.0007173,
1,32,2050,2082,0.0014859,0.0007148,
1,33,2050,2083,0.0015203,0.0007061,
1,34,2050,2084,0.0015540,0.0006862,
1,35,2050,2085,0.0015941,0.0006588,
1,36,2050,2086,0.0016525,0.0006466,
1,37,2050,2087,0.0017318,0.0006484,
1,38,2050,2088,0.0018255,0.0006715,
1,39,2050,2089,0.0019305,0.0007121,
1,40,2050,2090,0.0020513,0.0007659,
1,41,2050,2091,0.0021897,0.0008321,
1,42,2050,2092,0.0023342,0.0009003,
1,43,2050,2093,0.0024669,0.0009546,
1,44,2050,2094,0.0025867,0.0009868,
1,45,2050,2095,0.0027191,0.0009984,
1,46,2050,2096,0.0028925,0.0010369,
1,47,2050,2097,0.0031101,0.0011032,
1,48,2050,2098,0.0033571,0.0011951,
1,49,2050,2099,0.0036304,0.0012940,
1,50,2050,2100,0.0039379,0.0013858,
1,51,2050,2101,0.0042708,0.0014764,
1,52,2050,2102,0.0046082,0.0015612,
1,53,2050,2103,0.0049489,0.0016254,
1,54,2050,2104,0.0053157,0.0016974,
1,55,2050,2105,0.0057365,0.0017844,
1,56,2050,2106,0.0062406,0.0019261,
1,57,2050,2107,0.0068502,0.0021318,
1,58,2050,2108,0.0075521,0.0024010,
1,59,2050,2109,0.0083035,0.0026796,
1,60,2050,2110,0.0090849,0.0029313,
1,61,2050,2111,0.0099105,0.0031651,
1,62,2050,2112,0.0107829,0.0033858,
1,63,2050,2113,0.0116995,0.0036074,
1,64,2050,2114,0.0126957,0.0038646,
1,65,2050,2115,0.0138071,0.0041612,
1,66,2050,2116,0.0150054,0.0044815,
1,67,2050,2117,0.0162315,0.0047513,
1,68,2050,2118,0.0174919,0.0049672,
1,69,2050,2119,0.0188954,0.0052159,
1,70,2050,2120,0.0205786,0.0055784,
1,71,2050,2121,0.0226142,0.0061476,
1,72,2050,2122,0.0250119,0.0069658,
1,73,2050,2123,0.0277519,0.0080285,
1,74,2050,2124,0.0307579,0.0092897,
1,75,2050,2125,0.0339099,0.0105944,
1,76,2050,2126,0.0371478,0.0118360,
1,77,2050,2127,0.0405123,0.0130017,
1,78,2050,2128,0.0440886,0.0141423,
1,79,2050,2129,0.0480027,0.0153563,
1,80,2050,2130,0.0536037,0.0182951,
1,81,2050,2131,0.0586892,0.0201930,
1,82,2050,2132,0.0642414,0.0222921,
1,83,2050,2133,0.0702997,0.0246698,
1,84,2050,2134,0.0769067,0.0273909,
1,85,2050,2135,0.0841076,0.0304628,
1,86,2050,2136,0.0919504,0.0339526,
1,87,2050,2137,0.1004863,0.0379439,
1,88,2050,2138,0.1097689,0.0425096,
1,89,2050,2139,0.1198550,0.0476815,
1,90,2050,2140,0.1308036,0.0534748,
1,91,2050,2141,0.1426766,0.0599708,
1,92,2050,2142,0.1555375,0.0672915,
1,93,2050,2143,0.1694519,0.0755443,
1,94,2050,2144,0.1844867,0.0847924,
1,95,2050,2145,0.2007091,0.0951142,
1,96,2050,2146,0.2181866,0.1066610,
1,97,2050,2147,0.2369856,0.1196205,
1,98,2050,2148,0.2571705,0.1341540,
1,99,2050,2149,0.2788028,0.1503595,
1,100,2050,2150,0.3019394,0.1683567,
1,0,2051,2051,0.0091935,0.0017961,
1,1,2051,2052,0.0006668,0.0000635,
1,2,2051,2053,0.0003367,0.0000355,
1,3,2051,2054,0.0002291,0.0000246,
1,4,2051,2055,0.0001930,0.0000218,
1,5,2051,2056,0.0001870,0.0000240,
1,6,2051,2057,0.0001837,0.0000259,
1,7,2051,2058,0.0001828,0.0000284,
1,8,2051,2059,0.0001845,0.0000312,
1,9,2051,2060,0.0001904,0.0000352,
1,10,2051,2061,0.0002017,0.0000415,
1,11,2051,2062,0.0002200,0.0000505,
1,12,2051,2063,0.0002484,0.0000636,
1,13,2051,2064,0.0002934,0.0000855,
1,14,2051,2065,0.0003624,0.0001235,
1,15,2051,2066,0.0004596,0.0001842,
1,16,2051,2067,0.0005802,0.0002655,
1,17,2051,2068,0.0007098,0.0003535,
1,18,2051,2069,0.0008321,0.0004358,
1,19,2051,2070,0.0009391,0.0005046,
1,20,2051,2071,0.0010297,0.0005587,
1,21,2051,2072,0.0011033,0.0005969,
1,22,2051,2073,0.0011584,0.0006219,
1,23,2051,2074,0.0011978,0.0006424,
1,24,2051,2075,0.0012275,0.0006589,
1,25,2051,2076,0.0012521,0.0006617,
1,26,2051,2077,0.0012759,0.0006605,
1,27,2051,2078,0.0013058,0.0006669,
1,28,2051,2079,0.0013446,0.0006928,
1,29,2051,2080,0.0013859,0.0007126,
1,30,2051,2081,0.0014216,0.0007135,
1,31,2051,2082,0.0014530,0.0007098,
1,32,2051,2083,0.0014859,0.0007078,
1,33,2051,2084,0.0015203,0.0006988,
1,34,2051,2085,0.0015540,0.0006781,
1,35,2051,2086,0.0015941,0.0006503,
1,36,2051,2087,0.0016525,0.0006384,
1,37,2051,2088,0.0017318,0.0006405,
1,38,2051,2089,0.0018255,0.0006630,
1,39,2051,2090,0.0019305,0.0007024,
1,40,2051,2091,0.0020513,0.0007556,
1,41,2051,2092,0.0021897,0.0008218,
1,42,2051,2093,0.0023342,0.0008902,
1,43,2051,2094,0.0024669,0.0009439,
1,44,2051,2095,0.0025867,0.0009746,
1,45,2051,2096,0.0027191,0.0009855,
1,46,2051,2097,0.0028925,0.0010241,
1,47,2051,2098,0.0031101,0.0010906,
1,48,2051,2099,0.0033571,0.0011814,
1,49,2051,2100,0.0036304,0.0012781,
1,50,2051,2101,0.0039379,0.0013683,
1,51,2051,2102,0.0042708,0.0014588,
1,52,2051,2103,0.0046082,0.0015437,
1,53,2051,2104,0.0049489,0.0016064,
1,54,2051,2105,0.0053157,0.0016753,
1,55,2051,2106,0.0057365,0.0017604,
1,56,2051,2107,0.0062406,0.0019018,
1,57,2051,2108,0.0068502,0.0021073,
1,58,2051,2109,0.0075521,0.0023734,
1,59,2051,2110,0.0083035,0.0026467,
1,60,2051,2111,0.0090849,0.0028948,
1,61,2051,2112,0.0099105,0.0031281,
1,62,2051,2113,0.0107829,0.0033491,
1,63,2051,2114,0.0116995,0.0035673,
1,64,2051,2115,0.0126957,0.0038178,
1,65,2051,2116,0.0138071,0.0041097,
1,66,2051,2117,0.0150054,0.0044294,
1,67,2051,2118,0.0162315,0.0046994,
1,68,2051,2119,0.0174919,0.0049104,
1,69,2051,2120,0.0188954,0.0051499,
1,70,2051,2121,0.0205786,0.0055059,
1,71,2051,2122,0.0226142,0.0060731,
1,72,2051,2123,0.0250119,0.0068895,
1,73,2051,2124,0.0277519,0.0079417,
1,74,2051,2125,0.0307579,0.0091849,
1,75,2051,2126,0.0339099,0.0104765,
1,76,2051,2127,0.0371478,0.0117151,
1,77,2051,2128,0.0405123,0.0128807,
1,78,2051,2129,0.0440886,0.0140086,
1,79,2051,2130,0.0480027,0.0151993,
1,80,2051,2131,0.0536037,0.0181159,
1,81,2051,2132,0.0586892,0.0200094,
1,82,2051,2133,0.0642414,0.0221062,
1,83,2051,2134,0.0702997,0.0244612,
1,84,2051,2135,0.0769067,0.0271435,
1,85,2051,2136,0.0841076,0.0301877,
1,86,2051,2137,0.0919504,0.0336715,
1,87,2051,2138,0.1004863,0.0376620,
1,88,2051,2139,0.1097689,0.0421976,
1,89,2051,2140,0.1198550,0.0473142,
1,90,2051,2141,0.1308036,0.0530682,
1,91,2051,2142,0.1426766,0.0595575,
1,92,2051,2143,0.1555375,0.0668793,
1,93,2051,2144,0.1694519,0.0750906,
1,94,2051,2145,0.1844867,0.0842622,
1,95,2051,2146,0.2007091,0.0945328,
1,96,2051,2147,0.2181866,0.1060757,
1,97,2051,2148,0.2369856,0.1190416,
1,98,2051,2149,0.2571705,0.1335220,
1,99,2051,2150,0.2788028,0.1496304,
1,0,2052,2052,0.0091935,0.0017215,
1,1,2052,2053,0.0006668,0.0000601,
1,2,2052,2054,0.0003367,0.0000336,
1,3,2052,2055,0.0002291,0.0000233,
1,4,2052,2056,0.0001930,0.0000207,
1,5,2052,2057,0.0001870,0.0000228,
1,6,2052,2058,0.0001837,0.0000249,
1,7,2052,2059,0.0001828,0.0000273,
1,8,2052,2060,0.0001845,0.0000300,
1,9,2052,2061,0.0001904,0.0000339,
1,10,2052,2062,0.0002017,0.0000401,
1,11,2052,2063,0.0002200,0.0000491,
1,12,2052,2064,0.0002484,0.0000620,
1,13,2052,2065,0.0002934,0.0000834,
1,14,2052,2066,0.0003624,0.0001208,
1,15,2052,2067,0.0004596,0.0001810,
1,16,2052,2068,0.0005802,0.0002619,
1,17,2052,2069,0.0007098,0.0003492,
1,18,2052,2070,0.0008321,0.0004305,
1,19,2052,2071,0.0009391,0.0004987,
1,20,2052,2072,0.0010297,0.0005527,
1,21,2052,2073,0.0011033,0.0005912,
1,22,2052,2074,0.0011584,0.0006158,
1,23,2052,2075,0.0011978,0.0006357,
1,24,2052,2076,0.0012275,0.0006520,
1,25,2052,2077,0.0012521,0.0006551,
1,26,2052,2078,0.0012759,0.0006543,
1,27,2052,2079,0.0013058,0.0006604,
1,28,2052,2080,0.0013446,0.0006856,
1,29,2052,2081,0.0013859,0.0007051,
1,30,2052,2082,0.0014216,0.0007063,
1,31,2052,2083,0.0014530,0.0007030,
1,32,2052,2084,0.0014859,0.0007007,
1,33,2052,2085,0.0015203,0.0006909,
1,34,2052,2086,0.0015540,0.0006699,
1,35,2052,2087,0.0015941,0.0006424,
1,36,2052,2088,0.0016525,0.0006308,
1,37,2052,2089,0.0017318,0.0006324,
1,38,2052,2090,0.0018255,0.0006539,
1,39,2052,2091,0.0019305,0.0006927,
1,40,2052,2092,0.0020513,0.0007459,
1,41,2052,2093,0.0021897,0.0008124,
1,42,2052,2094,0.0023342,0.0008800,
1,43,2052,2095,0.0024669,0.0009323,
1,44,2052,2096,0.0025867,0.0009624,
1,45,2052,2097,0.0027191,0.0009734,
1,46,2052,2098,0.0028925,0.0010124,
1,47,2052,2099,0.0031101,0.0010779,
1,48,2052,2100,0.0033571,0.0011667,
1,49,2052,2101,0.0036304,0.0012620,
1,50,2052,2102,0.0039379,0.0013520,
1,51,2052,2103,0.0042708,0.0014426,
1,52,2052,2104,0.0046082,0.0015259,
1,53,2052,2105,0.0049489,0.0015858,
1,54,2052,2106,0.0053157,0.0016531,
1,55,2052,2107,0.0057365,0.0017381,
1,56,2052,2108,0.0062406,0.0018795,
1,57,2052,2109,0.0068502,0.0020823,
1,58,2052,2110,0.0075521,0.0023436,
1,59,2052,2111,0.0083035,0.0026135,
1,60,2052,2112,0.0090849,0.0028610,
1,61,2052,2113,0.0099105,0.0030944,
1,62,2052,2114,0.0107829,0.0033121,
1,63,2052,2115,0.0116995,0.0035242,
1,64,2052,2116,0.0126957,0.0037705,
1,65,2052,2117,0.0138071,0.0040617,
1,66,2052,2118,0.0150054,0.0043814,
1,67,2052,2119,0.0162315,0.0046465,
1,68,2052,2120,0.0174919,0.0048490,
1,69,2052,2121,0.0188954,0.0050832,
1,70,2052,2122,0.0205786,0.0054383,
1,71,2052,2123,0.0226142,0.0060047,
1,72,2052,2124,0.0250119,0.0068121,
1,73,2052,2125,0.0277519,0.0078481,
1,74,2052,2126,0.0307579,0.0090787,
1,75,2052,2127,0.0339099,0.0103667,
1,76,2052,2128,0.0371478,0.0116044,
1,77,2052,2129,0.0405123,0.0127580,
1,78,2052,2130,0.0440886,0.0138645,
1,79,2052,2131,0.0480027,0.0150401,
1,80,2052,2132,0.0536037,0.0179484,
1,81,2052,2133,0.0586892,0.0198399,
1,82,2052,2134,0.0642414,0.0219159,
1,83,2052,2135,0.0702997,0.0242354,
1,84,2052,2136,0.0769067,0.0268923,
1,85,2052,2137,0.0841076,0.0299309,
1,86,2052,2138,0.0919504,0.0334138,
1,87,2052,2139,0.1004863,0.0373764,
1,88,2052,2140,0.1097689,0.0418609,
1,89,2052,2141,0.1198550,0.0469409,
1,90,2052,2142,0.1308036,0.0526881,
1,91,2052,2143,0.1426766,0.0591776,
1,92,2052,2144,0.1555375,0.0664604,
1,93,2052,2145,0.1694519,0.0745998,
1,94,2052,2146,0.1844867,0.0837226,
1,95,2052,2147,0.2007091,0.0939880,
1,96,2052,2148,0.2181866,0.1055352,
1,97,2052,2149,0.2369856,0.1184493,
1,98,2052,2150,0.2571705,0.1328360,
1,0,2053,2053,0.0091934,0.0016546,
1,1,2053,2054,0.0006668,0.0000567,
1,2,2053,2055,0.0003367,0.0000317,
1,3,2053,2056,0.0002291,0.0000219,
1,4,2053,2057,0.0001930,0.0000196,
1,5,2053,2058,0.0001870,0.0000218,
1,6,2053,2059,0.0001837,0.0000238,
1,7,2053,2060,0.0001828,0.0000261,
1,8,2053,2061,0.0001845,0.0000288,
1,9,2053,2062,0.0001904,0.0000327,
1,10,2053,2063,0.0002017,0.0000389,
1,11,2053,2064,0.0002200,0.0000477,
1,12,2053,2065,0.0002484,0.0000602,
1,13,2053,2066,0.0002934,0.0000813,
1,14,2053,2067,0.0003624,0.0001183,
1,15,2053,2068,0.0004596,0.0001781,
1,16,2053,2069,0.0005802,0.0002583,
1,17,2053,2070,0.0007098,0.0003446,
1,18,2053,2071,0.0008321,0.0004251,
1,19,2053,2072,0.0009391,0.0004932,
1,20,2053,2073,0.0010297,0.0005473,
1,21,2053,2074,0.0011033,0.0005854,
1,22,2053,2075,0.0011584,0.0006093,
1,23,2053,2076,0.0011978,0.0006289,
1,24,2053,2077,0.0012275,0.0006456,
1,25,2053,2078,0.0012521,0.0006490,
1,26,2053,2079,0.0012759,0.0006479,
1,27,2053,2080,0.0013058,0.0006533,
1,28,2053,2081,0.0013446,0.0006782,
1,29,2053,2082,0.0013859,0.0006981,
1,30,2053,2083,0.0014216,0.0006997,
1,31,2053,2084,0.0014530,0.0006961,
1,32,2053,2085,0.0014859,0.0006931,
1,33,2053,2086,0.0015203,0.0006830,
1,34,2053,2087,0.0015540,0.0006622,
1,35,2053,2088,0.0015941,0.0006351,
1,36,2053,2089,0.0016525,0.0006232,
1,37,2053,2090,0.0017318,0.0006238,
1,38,2053,2091,0.0018255,0.0006447,
1,39,2053,2092,0.0019305,0.0006836,
1,40,2053,2093,0.0020513,0.0007371,
1,41,2053,2094,0.0021897,0.0008028,
1,42,2053,2095,0.0023342,0.0008691,
1,43,2053,2096,0.0024669,0.0009206,
1,44,2053,2097,0.0025867,0.0009509,
1,45,2053,2098,0.0027191,0.0009625,
1,46,2053,2099,0.0028925,0.0010007,
1,47,2053,2100,0.0031101,0.0010643,
1,48,2053,2101,0.0033571,0.0011518,
1,49,2053,2102,0.0036304,0.0012470,
1,50,2053,2103,0.0039379,0.0013371,
1,51,2053,2104,0.0042708,0.0014261,
1,52,2053,2105,0.0046082,0.0015067,
1,53,2053,2106,0.0049489,0.0015650,
1,54,2053,2107,0.0053157,0.0016324,
1,55,2053,2108,0.0057365,0.0017177,
1,56,2053,2109,0.0062406,0.0018569,
1,57,2053,2110,0.0068502,0.0020554,
1,58,2053,2111,0.0075521,0.0023135,
1,59,2053,2112,0.0083035,0.0025826,
1,60,2053,2113,0.0090849,0.0028300,
1,61,2053,2114,0.0099105,0.0030603,
1,62,2053,2115,0.0107829,0.0032723,
1,63,2053,2116,0.0116995,0.0034806,
1,64,2053,2117,0.0126957,0.0037264,
1,65,2053,2118,0.0138071,0.0040176,
1,66,2053,2119,0.0150054,0.0043323,
1,67,2053,2120,0.0162315,0.0045894,
1,68,2053,2121,0.0174919,0.0047870,
1,69,2053,2122,0.0188954,0.0050211,
1,70,2053,2123,0.0205786,0.0053764,
1,71,2053,2124,0.0226142,0.0059354,
1,72,2053,2125,0.0250119,0.0067287,
1,73,2053,2126,0.0277519,0.0077534,
1,74,2053,2127,0.0307579,0.0089799,
1,75,2053,2128,0.0339099,0.0102661,
1,76,2053,2129,0.0371478,0.0114923,
1,77,2053,2130,0.0405123,0.0126259,
1,78,2053,2131,0.0440886,0.0137185,
1,79,2053,2132,0.0480027,0.0148916,
1,80,2053,2133,0.0536037,0.0177940,
1,81,2053,2134,0.0586892,0.0196664,
1,82,2053,2135,0.0642414,0.0217101,
1,83,2053,2136,0.0702997,0.0240063,
1,84,2053,2137,0.0769067,0.0266580,
1,85,2053,2138,0.0841076,0.0296956,
1,86,2053,2139,0.0919504,0.0331528,
1,87,2053,2140,0.1004863,0.0370683,
1,88,2053,2141,0.1097689,0.0415188,
1,89,2053,2142,0.1198550,0.0465920,
1,90,2053,2143,0.1308036,0.0523389,
1,91,2053,2144,0.1426766,0.0587917,
1,92,2053,2145,0.1555375,0.0660073,
1,93,2053,2146,0.1694519,0.0741006,
1,94,2053,2147,0.1844867,0.0832172,
1,95,2053,2148,0.2007091,0.0934851,
1,96,2053,2149,0.2181866,0.1049823,
1,97,2053,2150,0.2369856,0.1178066,
1,0,2054,2054,0.0091934,0.0015878,
1,1,2054,2055,0.0006668,0.0000533,
1,2,2054,2056,0.0003367,0.0000299,
1,3,2054,2057,0.0002291,0.0000208,
1,4,2054,2058,0.0001930,0.0000187,
1,5,2054,2059,0.0001870,0.0000209,
1,6,2054,2060,0.0001837,0.0000227,
1,7,2054,2061,0.0001828,0.0000250,
1,8,2054,2062,0.0001845,0.0000277,
1,9,2054,2063,0.0001904,0.0000316,
1,10,2054,2064,0.0002017,0.0000377,
1,11,2054,2065,0.0002200,0.0000462,
1,12,2054,2066,0.0002484,0.0000585,
1,13,2054,2067,0.0002934,0.0000793,
1,14,2054,2068,0.0003624,0.0001161,
1,15,2054,2069,0.0004596,0.0001752,
1,16,2054,2070,0.0005802,0.0002544,
1,17,2054,2071,0.0007098,0.0003399,
1,18,2054,2072,0.0008321,0.0004202,
1,19,2054,2073,0.0009391,0.0004882,
1,20,2054,2074,0.0010297,0.0005419,
1,21,2054,2075,0.0011033,0.0005792,
1,22,2054,2076,0.0011584,0.0006027,
1,23,2054,2077,0.0011978,0.0006226,
1,24,2054,2078,0.0012275,0.0006397,
1,25,2054,2079,0.0012521,0.0006428,
1,26,2054,2080,0.0012759,0.0006410,
1,27,2054,2081,0.0013058,0.0006461,
1,28,2054,2082,0.0013446,0.0006714,
1,29,2054,2083,0.0013859,0.0006917,
1,30,2054,2084,0.0014216,0.0006930,
1,31,2054,2085,0.0014530,0.0006887,
1,32,2054,2086,0.0014859,0.0006853,
1,33,2054,2087,0.0015203,0.0006755,
1,34,2054,2088,0.0015540,0.0006552,
1,35,2054,2089,0.0015941,0.0006277,
1,36,2054,2090,0.0016525,0.0006149,
1,37,2054,2091,0.0017318,0.0006150,
1,38,2054,2092,0.0018255,0.0006361,
1,39,2054,2093,0.0019305,0.0006753,
1,40,2054,2094,0.0020513,0.0007281,
1,41,2054,2095,0.0021897,0.0007925,
1,42,2054,2096,0.0023342,0.0008580,
1,43,2054,2097,0.0024669,0.0009097,
1,44,2054,2098,0.0025867,0.0009405,
1,45,2054,2099,0.0027191,0.0009514,
1,46,2054,2100,0.0028925,0.0009880,
1,47,2054,2101,0.0031101,0.0010506,
1,48,2054,2102,0.0033571,0.0011379,
1,49,2054,2103,0.0036304,0.0012332,
1,50,2054,2104,0.0039379,0.0013219,
1,51,2054,2105,0.0042708,0.0014083,
1,52,2054,2106,0.0046082,0.0014873,
1,53,2054,2107,0.0049489,0.0015457,
1,54,2054,2108,0.0053157,0.0016134,
1,55,2054,2109,0.0057365,0.0016969,
1,56,2054,2110,0.0062406,0.0018325,
1,57,2054,2111,0.0068502,0.0020283,
1,58,2054,2112,0.0075521,0.0022855,
1,59,2054,2113,0.0083035,0.0025544,
1,60,2054,2114,0.0090849,0.0027988,
1,61,2054,2115,0.0099105,0.0030237,
1,62,2054,2116,0.0107829,0.0032320,
1,63,2054,2117,0.0116995,0.0034400,
1,64,2054,2118,0.0126957,0.0036858,
1,65,2054,2119,0.0138071,0.0039725,
1,66,2054,2120,0.0150054,0.0042794,
1,67,2054,2121,0.0162315,0.0045316,
1,68,2054,2122,0.0174919,0.0047294,
1,69,2054,2123,0.0188954,0.0049642,
1,70,2054,2124,0.0205786,0.0053136,
1,71,2054,2125,0.0226142,0.0058607,
1,72,2054,2126,0.0250119,0.0066444,
1,73,2054,2127,0.0277519,0.0076653,
1,74,2054,2128,0.0307579,0.0088895,
1,75,2054,2129,0.0339099,0.0101643,
1,76,2054,2130,0.0371478,0.0113715,
1,77,2054,2131,0.0405123,0.0124920,
1,78,2054,2132,0.0440886,0.0135823,
1,79,2054,2133,0.0480027,0.0147546,
1,80,2054,2134,0.0536037,0.0176359,
1,81,2054,2135,0.0586892,0.0194788,
1,82,2054,2136,0.0642414,0.0215012,
1,83,2054,2137,0.0702997,0.0237926,
1,84,2054,2138,0.0769067,0.0264433,
1,85,2054,2139,0.0841076,0.0294572,
1,86,2054,2140,0.0919504,0.0328711,
1,87,2054,2141,0.1004863,0.0367553,
1,88,2054,2142,0.1097689,0.0411992,
1,89,2054,2143,0.1198550,0.0462716,
1,90,2054,2144,0.1308036,0.0519841,
1,91,2054,2145,0.1426766,0.0583745,
1,92,2054,2146,0.1555375,0.0655465,
1,93,2054,2147,0.1694519,0.0736330,
1,94,2054,2148,0.1844867,0.0827508,
1,95,2054,2149,0.2007091,0.0929708,
1,96,2054,2150,0.2181866,0.1043826,
1,0,2055,2055,0.0091934,0.0015178,
1,1,2055,2056,0.0006668,0.0000499,
1,2,2055,2057,0.0003367,0.0000282,
1,3,2055,2058,0.0002291,0.0000197,
1,4,2055,2059,0.0001930,0.0000178,
1,5,2055,2060,0.0001870,0.0000199,
1,6,2055,2061,0.0001837,0.0000217,
1,7,2055,2062,0.0001828,0.0000240,
1,8,2055,2063,0.0001845,0.0000267,
1,9,2055,2064,0.0001904,0.0000306,
1,10,2055,2065,0.0002017,0.0000365,
1,11,2055,2066,0.0002200,0.0000448,
1,12,2055,2067,0.0002484,0.0000570,
1,13,2055,2068,0.0002934,0.0000775,
1,14,2055,2069,0.0003624,0.0001138,
1,15,2055,2070,0.0004596,0.0001720,
1,16,2055,2071,0.0005802,0.0002504,
1,17,2055,2072,0.0007098,0.0003355,
1,18,2055,2073,0.0008321,0.0004157,
1,19,2055,2074,0.0009391,0.0004832,
1,20,2055,2075,0.0010297,0.0005361,
1,21,2055,2076,0.0011033,0.0005729,
1,22,2055,2077,0.0011584,0.0005966,
1,23,2055,2078,0.0011978,0.0006168,
1,24,2055,2079,0.0012275,0.0006336,
1,25,2055,2080,0.0012521,0.0006361,
1,26,2055,2081,0.0012759,0.0006340,
1,27,2055,2082,0.0013058,0.0006394,
1,28,2055,2083,0.0013446,0.0006652,
1,29,2055,2084,0.0013859,0.0006852,
1,30,2055,2085,0.0014216,0.0006858,
1,31,2055,2086,0.0014530,0.0006812,
1,32,2055,2087,0.0014859,0.0006781,
1,33,2055,2088,0.0015203,0.0006687,
1,34,2055,2089,0.0015540,0.0006480,
1,35,2055,2090,0.0015941,0.0006197,
1,36,2055,2091,0.0016525,0.0006065,
1,37,2055,2092,0.0017318,0.0006069,
1,38,2055,2093,0.0018255,0.0006283,
1,39,2055,2094,0.0019305,0.0006669,
1,40,2055,2095,0.0020513,0.0007185,
1,41,2055,2096,0.0021897,0.0007821,
1,42,2055,2097,0.0023342,0.0008477,
1,43,2055,2098,0.0024669,0.0008997,
1,44,2055,2099,0.0025867,0.0009299,
1,45,2055,2100,0.0027191,0.0009395,
1,46,2055,2101,0.0028925,0.0009752,
1,47,2055,2102,0.0031101,0.0010377,
1,48,2055,2103,0.0033571,0.0011252,
1,49,2055,2104,0.0036304,0.0012192,
1,50,2055,2105,0.0039379,0.0013055,
1,51,2055,2106,0.0042708,0.0013903,
1,52,2055,2107,0.0046082,0.0014693,
1,53,2055,2108,0.0049489,0.0015280,
1,54,2055,2109,0.0053157,0.0015940,
1,55,2055,2110,0.0057365,0.0016745,
1,56,2055,2111,0.0062406,0.0018078,
1,57,2055,2112,0.0068502,0.0020030,
1,58,2055,2113,0.0075521,0.0022599,
1,59,2055,2114,0.0083035,0.0025259,
1,60,2055,2115,0.0090849,0.0027653,
1,61,2055,2116,0.0099105,0.0029867,
1,62,2055,2117,0.0107829,0.0031945,
1,63,2055,2118,0.0116995,0.0034026,
1,64,2055,2119,0.0126957,0.0036444,
1,65,2055,2120,0.0138071,0.0039239,
1,66,2055,2121,0.0150054,0.0042259,
1,67,2055,2122,0.0162315,0.0044778,
1,68,2055,2123,0.0174919,0.0046765,
1,69,2055,2124,0.0188954,0.0049064,
1,70,2055,2125,0.0205786,0.0052459,
1,71,2055,2126,0.0226142,0.0057852,
1,72,2055,2127,0.0250119,0.0065659,
1,73,2055,2128,0.0277519,0.0075846,
1,74,2055,2129,0.0307579,0.0087980,
1,75,2055,2130,0.0339099,0.0100546,
1,76,2055,2131,0.0371478,0.0112491,
1,77,2055,2132,0.0405123,0.0123670,
1,78,2055,2133,0.0440886,0.0134567,
1,79,2055,2134,0.0480027,0.0146145,
1,80,2055,2135,0.0536037,0.0174649,
1,81,2055,2136,0.0586892,0.0192884,
1,82,2055,2137,0.0642414,0.0213064,
1,83,2055,2138,0.0702997,0.0235968,
1,84,2055,2139,0.0769067,0.0262259,
1,85,2055,2140,0.0841076,0.0292002,
1,86,2055,2141,0.0919504,0.0325852,
1,87,2055,2142,0.1004863,0.0364630,
1,88,2055,2143,0.1097689,0.0409057,
1,89,2055,2144,0.1198550,0.0459461,
1,90,2055,2145,0.1308036,0.0516007,
1,91,2055,2146,0.1426766,0.0579503,
1,92,2055,2147,0.1555375,0.0651152,
1,93,2055,2148,0.1694519,0.0732017,
1,94,2055,2149,0.1844867,0.0822739,
1,95,2055,2150,0.2007091,0.0924131,
1,0,2056,2056,0.0091934,0.0014493,
1,1,2056,2057,0.0006668,0.0000470,
1,2,2056,2058,0.0003367,0.0000268,
1,3,2056,2059,0.0002291,0.0000187,
1,4,2056,2060,0.0001930,0.0000168,
1,5,2056,2061,0.0001870,0.0000189,
1,6,2056,2062,0.0001837,0.0000207,
1,7,2056,2063,0.0001828,0.0000231,
1,8,2056,2064,0.0001845,0.0000257,
1,9,2056,2065,0.0001904,0.0000294,
1,10,2056,2066,0.0002017,0.0000352,
1,11,2056,2067,0.0002200,0.0000434,
1,12,2056,2068,0.0002484,0.0000555,
1,13,2056,2069,0.0002934,0.0000757,
1,14,2056,2070,0.0003624,0.0001113,
1,15,2056,2071,0.0004596,0.0001689,
1,16,2056,2072,0.0005802,0.0002468,
1,17,2056,2073,0.0007098,0.0003316,
1,18,2056,2074,0.0008321,0.0004112,
1,19,2056,2075,0.0009391,0.0004779,
1,20,2056,2076,0.0010297,0.0005302,
1,21,2056,2077,0.0011033,0.0005671,
1,22,2056,2078,0.0011584,0.0005909,
1,23,2056,2079,0.0011978,0.0006108,
1,24,2056,2080,0.0012275,0.0006270,
1,25,2056,2081,0.0012521,0.0006292,
1,26,2056,2082,0.0012759,0.0006275,
1,27,2056,2083,0.0013058,0.0006333,
1,28,2056,2084,0.0013446,0.0006588,
1,29,2056,2085,0.0013859,0.0006782,
1,30,2056,2086,0.0014216,0.0006785,
1,31,2056,2087,0.0014530,0.0006742,
1,32,2056,2088,0.0014859,0.0006715,
1,33,2056,2089,0.0015203,0.0006618,
1,34,2056,2090,0.0015540,0.0006403,
1,35,2056,2091,0.0015941,0.0006117,
1,36,2056,2092,0.0016525,0.0005988,
1,37,2056,2093,0.0017318,0.0005995,
1,38,2056,2094,0.0018255,0.0006203,
1,39,2056,2095,0.0019305,0.0006578,
1,40,2056,2096,0.0020513,0.0007088,
1,41,2056,2097,0.0021897,0.0007725,
1,42,2056,2098,0.0023342,0.0008383,
1,43,2056,2099,0.0024669,0.0008897,
1,44,2056,2100,0.0025867,0.0009186,
1,45,2056,2101,0.0027191,0.0009274,
1,46,2056,2102,0.0028925,0.0009633,
1,47,2056,2103,0.0031101,0.0010260,
1,48,2056,2104,0.0033571,0.0011123,
1,49,2056,2105,0.0036304,0.0012041,
1,50,2056,2106,0.0039379,0.0012889,
1,51,2056,2107,0.0042708,0.0013736,
1,52,2056,2108,0.0046082,0.0014527,
1,53,2056,2109,0.0049489,0.0015099,
1,54,2056,2110,0.0053157,0.0015732,
1,55,2056,2111,0.0057365,0.0016518,
1,56,2056,2112,0.0062406,0.0017849,
1,57,2056,2113,0.0068502,0.0019800,
1,58,2056,2114,0.0075521,0.0022342,
1,59,2056,2115,0.0083035,0.0024954,
1,60,2056,2116,0.0090849,0.0027314,
1,61,2056,2117,0.0099105,0.0029522,
1,62,2056,2118,0.0107829,0.0031600,
1,63,2056,2119,0.0116995,0.0033644,
1,64,2056,2120,0.0126957,0.0035997,
1,65,2056,2121,0.0138071,0.0038747,
1,66,2056,2122,0.0150054,0.0041762,
1,67,2056,2123,0.0162315,0.0044285,
1,68,2056,2124,0.0174919,0.0046227,
1,69,2056,2125,0.0188954,0.0048442,
1,70,2056,2126,0.0205786,0.0051775,
1,71,2056,2127,0.0226142,0.0057149,
1,72,2056,2128,0.0250119,0.0064941,
1,73,2056,2129,0.0277519,0.0075031,
1,74,2056,2130,0.0307579,0.0086994,
1,75,2056,2131,0.0339099,0.0099436,
1,76,2056,2132,0.0371478,0.0111349,
1,77,2056,2133,0.0405123,0.0122519,
1,78,2056,2134,0.0440886,0.0133283,
1,79,2056,2135,0.0480027,0.0144631,
1,80,2056,2136,0.0536037,0.0172915,
1,81,2056,2137,0.0586892,0.0191109,
1,82,2056,2138,0.0642414,0.0211280,
1,83,2056,2139,0.0702997,0.0233987,
1,84,2056,2140,0.0769067,0.0259914,
1,85,2056,2141,0.0841076,0.0289392,
1,86,2056,2142,0.0919504,0.0323182,
1,87,2056,2143,0.1004863,0.0361946,
1,88,2056,2144,0.1097689,0.0406077,
1,89,2056,2145,0.1198550,0.0455945,
1,90,2056,2146,0.1308036,0.0512110,
1,91,2056,2147,0.1426766,0.0575533,
1,92,2056,2148,0.1555375,0.0647173,
1,93,2056,2149,0.1694519,0.0727608,
1,94,2056,2150,0.1844867,0.0817570,
1,0,2057,2057,0.0091934,0.0013876,
1,1,2057,2058,0.0006668,0.0000444,
1,2,2057,2059,0.0003367,0.0000254,
1,3,2057,2060,0.0002291,0.0000177,
1,4,2057,2061,0.0001930,0.0000159,
1,5,2057,2062,0.0001870,0.0000180,
1,6,2057,2063,0.0001837,0.0000199,
1,7,2057,2064,0.0001828,0.0000222,
1,8,2057,2065,0.0001845,0.0000247,
1,9,2057,2066,0.0001904,0.0000283,
1,10,2057,2067,0.0002017,0.0000341,
1,11,2057,2068,0.0002200,0.0000422,
1,12,2057,2069,0.0002484,0.0000541,
1,13,2057,2070,0.0002934,0.0000738,
1,14,2057,2071,0.0003624,0.0001089,
1,15,2057,2072,0.0004596,0.0001659,
1,16,2057,2073,0.0005802,0.0002435,
1,17,2057,2074,0.0007098,0.0003276,
1,18,2057,2075,0.0008321,0.0004063,
1,19,2057,2076,0.0009391,0.0004724,
1,20,2057,2077,0.0010297,0.0005247,
1,21,2057,2078,0.0011033,0.0005617,
1,22,2057,2079,0.0011584,0.0005851,
1,23,2057,2080,0.0011978,0.0006043,
1,24,2057,2081,0.0012275,0.0006203,
1,25,2057,2082,0.0012521,0.0006229,
1,26,2057,2083,0.0012759,0.0006215,
1,27,2057,2084,0.0013058,0.0006271,
1,28,2057,2085,0.0013446,0.0006520,
1,29,2057,2086,0.0013859,0.0006711,
1,30,2057,2087,0.0014216,0.0006716,
1,31,2057,2088,0.0014530,0.0006677,
1,32,2057,2089,0.0014859,0.0006648,
1,33,2057,2090,0.0015203,0.0006543,
1,34,2057,2091,0.0015540,0.0006325,
1,35,2057,2092,0.0015941,0.0006042,
1,36,2057,2093,0.0016525,0.0005917,
1,37,2057,2094,0.0017318,0.0005919,
1,38,2057,2095,0.0018255,0.0006118,
1,39,2057,2096,0.0019305,0.0006487,
1,40,2057,2097,0.0020513,0.0006998,
1,41,2057,2098,0.0021897,0.0007636,
1,42,2057,2099,0.0023342,0.0008287,
1,43,2057,2100,0.0024669,0.0008788,
1,44,2057,2101,0.0025867,0.0009071,
1,45,2057,2102,0.0027191,0.0009162,
1,46,2057,2103,0.0028925,0.0009523,
1,47,2057,2104,0.0031101,0.0010140,
1,48,2057,2105,0.0033571,0.0010983,
1,49,2057,2106,0.0036304,0.0011888,
1,50,2057,2107,0.0039379,0.0012735,
1,51,2057,2108,0.0042708,0.0013582,
1,52,2057,2109,0.0046082,0.0014359,
1,53,2057,2110,0.0049489,0.0014905,
1,54,2057,2111,0.0053157,0.0015522,
1,55,2057,2112,0.0057365,0.0016308,
1,56,2057,2113,0.0062406,0.0017640,
1,57,2057,2114,0.0068502,0.0019568,
1,58,2057,2115,0.0075521,0.0022065,
1,59,2057,2116,0.0083035,0.0024644,
1,60,2057,2117,0.0090849,0.0026998,
1,61,2057,2118,0.0099105,0.0029205,
1,62,2057,2119,0.0107829,0.0031248,
1,63,2057,2120,0.0116995,0.0033232,
1,64,2057,2121,0.0126957,0.0035545,
1,65,2057,2122,0.0138071,0.0038289,
1,66,2057,2123,0.0150054,0.0041305,
1,67,2057,2124,0.0162315,0.0043784,
1,68,2057,2125,0.0174919,0.0045649,
1,69,2057,2126,0.0188954,0.0047813,
1,70,2057,2127,0.0205786,0.0051139,
1,71,2057,2128,0.0226142,0.0056507,
1,72,2057,2129,0.0250119,0.0064216,
1,73,2057,2130,0.0277519,0.0074153,
1,74,2057,2131,0.0307579,0.0085997,
1,75,2057,2132,0.0339099,0.0098400,
1,76,2057,2133,0.0371478,0.0110297,
1,77,2057,2134,0.0405123,0.0121341,
1,78,2057,2135,0.0440886,0.0131894,
1,79,2057,2136,0.0480027,0.0143096,
1,80,2057,2137,0.0536037,0.0171299,
1,81,2057,2138,0.0586892,0.0189483,
1,82,2057,2139,0.0642414,0.0209474,
1,83,2057,2140,0.0702997,0.0231850,
1,84,2057,2141,0.0769067,0.0257535,
1,85,2057,2142,0.0841076,0.0286956,
1,86,2057,2143,0.0919504,0.0320731,
1,87,2057,2144,0.1004863,0.0359222,
1,88,2057,2145,0.1097689,0.0402859,
1,89,2057,2146,0.1198550,0.0452372,
1,90,2057,2147,0.1308036,0.0508464,
1,91,2057,2148,0.1426766,0.0571872,
1,92,2057,2149,0.1555375,0.0643108,
1,93,2057,2150,0.1694519,0.0722831,
1,0,2058,2058,0.0091934,0.0013329,
1,1,2058,2059,0.0006668,0.0000419,
1,2,2058,2060,0.0003367,0.0000239,
1,3,2058,2061,0.0002291,0.0000167,
1,4,2058,2062,0.0001930,0.0000151,
1,5,2058,2063,0.0001870,0.0000172,
1,6,2058,2064,0.0001837,0.0000191,
1,7,2058,2065,0.0001828,0.0000213,
1,8,2058,2066,0.0001845,0.0000237,
1,9,2058,2067,0.0001904,0.0000273,
1,10,2058,2068,0.0002017,0.0000330,
1,11,2058,2069,0.0002200,0.0000410,
1,12,2058,2070,0.0002484,0.0000525,
1,13,2058,2071,0.0002934,0.0000719,
1,14,2058,2072,0.0003624,0.0001066,
1,15,2058,2073,0.0004596,0.0001633,
1,16,2058,2074,0.0005802,0.0002402,
1,17,2058,2075,0.0007098,0.0003234,
1,18,2058,2076,0.0008321,0.0004014,
1,19,2058,2077,0.0009391,0.0004674,
1,20,2058,2078,0.0010297,0.0005197,
1,21,2058,2079,0.0011033,0.0005561,
1,22,2058,2080,0.0011584,0.0005788,
1,23,2058,2081,0.0011978,0.0005978,
1,24,2058,2082,0.0012275,0.0006141,
1,25,2058,2083,0.0012521,0.0006170,
1,26,2058,2084,0.0012759,0.0006155,
1,27,2058,2085,0.0013058,0.0006205,
1,28,2058,2086,0.0013446,0.0006451,
1,29,2058,2087,0.0013859,0.0006645,
1,30,2058,2088,0.0014216,0.0006654,
1,31,2058,2089,0.0014530,0.0006611,
1,32,2058,2090,0.0014859,0.0006575,
1,33,2058,2091,0.0015203,0.0006467,
1,34,2058,2092,0.0015540,0.0006252,
1,35,2058,2093,0.0015941,0.0005974,
1,36,2058,2094,0.0016525,0.0005845,
1,37,2058,2095,0.0017318,0.0005838,
1,38,2058,2096,0.0018255,0.0006032,
1,39,2058,2097,0.0019305,0.0006402,
1,40,2058,2098,0.0020513,0.0006915,
1,41,2058,2099,0.0021897,0.0007547,
1,42,2058,2100,0.0023342,0.0008185,
1,43,2058,2101,0.0024669,0.0008679,
1,44,2058,2102,0.0025867,0.0008964,
1,45,2058,2103,0.0027191,0.0009059,
1,46,2058,2104,0.0028925,0.0009412,
1,47,2058,2105,0.0031101,0.0010011,
1,48,2058,2106,0.0033571,0.0010842,
1,49,2058,2107,0.0036304,0.0011745,
1,50,2058,2108,0.0039379,0.0012593,
1,51,2058,2109,0.0042708,0.0013426,
1,52,2058,2110,0.0046082,0.0014178,
1,53,2058,2111,0.0049489,0.0014709,
1,54,2058,2112,0.0053157,0.0015327,
1,55,2058,2113,0.0057365,0.0016117,
1,56,2058,2114,0.0062406,0.0017430,
1,57,2058,2115,0.0068502,0.0019319,
1,58,2058,2116,0.0075521,0.0021785,
1,59,2058,2117,0.0083035,0.0024356,
1,60,2058,2118,0.0090849,0.0026707,
1,61,2058,2119,0.0099105,0.0028881,
1,62,2058,2120,0.0107829,0.0030868,
1,63,2058,2121,0.0116995,0.0032815,
1,64,2058,2122,0.0126957,0.0035125,
1,65,2058,2123,0.0138071,0.0037869,
1,66,2058,2124,0.0150054,0.0040841,
1,67,2058,2125,0.0162315,0.0043245,
1,68,2058,2126,0.0174919,0.0045064,
1,69,2058,2127,0.0188954,0.0047229,
1,70,2058,2128,0.0205786,0.0050558,
1,71,2058,2129,0.0226142,0.0055858,
1,72,2058,2130,0.0250119,0.0063436,
1,73,2058,2131,0.0277519,0.0073265,
1,74,2058,2132,0.0307579,0.0085067,
1,75,2058,2133,0.0339099,0.0097445,
1,76,2058,2134,0.0371478,0.0109221,
1,77,2058,2135,0.0405123,0.0120068,
1,78,2058,2136,0.0440886,0.0130488,
1,79,2058,2137,0.0480027,0.0141666,
1,80,2058,2138,0.0536037,0.0169818,
1,81,2058,2139,0.0586892,0.0187838,
1,82,2058,2140,0.0642414,0.0207527,
1,83,2058,2141,0.0702997,0.0229682,
1,84,2058,2142,0.0769067,0.0255314,
1,85,2058,2143,0.0841076,0.0284721,
1,86,2058,2144,0.0919504,0.0318245,
1,87,2058,2145,0.1004863,0.0356280,
1,88,2058,2146,0.1097689,0.0399589,
1,89,2058,2147,0.1198550,0.0449031,
1,90,2058,2148,0.1308036,0.0505103,
1,91,2058,2149,0.1426766,0.0568132,
1,92,2058,2150,0.1555375,0.0638705,
1,0,2059,2059,0.0091934,0.0012793,
1,1,2059,2060,0.0006668,0.0000394,
1,2,2059,2061,0.0003367,0.0000225,
1,3,2059,2062,0.0002291,0.0000158,
1,4,2059,2063,0.0001930,0.0000144,
1,5,2059,2064,0.0001870,0.0000164,
1,6,2059,2065,0.0001837,0.0000182,
1,7,2059,2066,0.0001828,0.0000204,
1,8,2059,2067,0.0001845,0.0000228,
1,9,2059,2068,0.0001904,0.0000264,
1,10,2059,2069,0.0002017,0.0000320,
1,11,2059,2070,0.0002200,0.0000398,
1,12,2059,2071,0.0002484,0.0000510,
1,13,2059,2072,0.0002934,0.0000702,
1,14,2059,2073,0.0003624,0.0001046,
1,15,2059,2074,0.0004596,0.0001606,
1,16,2059,2075,0.0005802,0.0002366,
1,17,2059,2076,0.0007098,0.0003191,
1,18,2059,2077,0.0008321,0.0003969,
1,19,2059,2078,0.0009391,0.0004627,
1,20,2059,2079,0.0010297,0.0005145,
1,21,2059,2080,0.0011033,0.0005501,
1,22,2059,2081,0.0011584,0.0005724,
1,23,2059,2082,0.0011978,0.0005917,
1,24,2059,2083,0.0012275,0.0006084,
1,25,2059,2084,0.0012521,0.0006111,
1,26,2059,2085,0.0012759,0.0006090,
1,27,2059,2086,0.0013058,0.0006137,
1,28,2059,2087,0.0013446,0.0006387,
1,29,2059,2088,0.0013859,0.0006584,
1,30,2059,2089,0.0014216,0.0006590,
1,31,2059,2090,0.0014530,0.0006541,
1,32,2059,2091,0.0014859,0.0006501,
1,33,2059,2092,0.0015203,0.0006396,
1,34,2059,2093,0.0015540,0.0006186,
1,35,2059,2094,0.0015941,0.0005904,
1,36,2059,2095,0.0016525,0.0005767,
1,37,2059,2096,0.0017318,0.0005756,
1,38,2059,2097,0.0018255,0.0005951,
1,39,2059,2098,0.0019305,0.0006325,
1,40,2059,2099,0.0020513,0.0006832,
1,41,2059,2100,0.0021897,0.0007451,
1,42,2059,2101,0.0023342,0.0008082,
1,43,2059,2102,0.0024669,0.0008577,
1,44,2059,2103,0.0025867,0.0008866,
1,45,2059,2104,0.0027191,0.0008954,
1,46,2059,2105,0.0028925,0.0009292,
1,47,2059,2106,0.0031101,0.0009880,
1,48,2059,2107,0.0033571,0.0010710,
1,49,2059,2108,0.0036304,0.0011615,
1,50,2059,2109,0.0039379,0.0012449,
1,51,2059,2110,0.0042708,0.0013258,
1,52,2059,2111,0.0046082,0.0013994,
1,53,2059,2112,0.0049489,0.0014527,
1,54,2059,2113,0.0053157,0.0015149,
1,55,2059,2114,0.0057365,0.0015923,
1,56,2059,2115,0.0062406,0.0017204,
1,57,2059,2116,0.0068502,0.0019067,
1,58,2059,2117,0.0075521,0.0021525,
1,59,2059,2118,0.0083035,0.0024091,
1,60,2059,2119,0.0090849,0.0026410,
1,61,2059,2120,0.0099105,0.0028531,
1,62,2059,2121,0.0107829,0.0030484,
1,63,2059,2122,0.0116995,0.0032428,
1,64,2059,2123,0.0126957,0.0034739,
1,65,2059,2124,0.0138071,0.0037443,
1,66,2059,2125,0.0150054,0.0040342,
1,67,2059,2126,0.0162315,0.0042700,
1,68,2059,2127,0.0174919,0.0044521,
1,69,2059,2128,0.0188954,0.0046694,
1,70,2059,2129,0.0205786,0.0049970,
1,71,2059,2130,0.0226142,0.0055161,
1,72,2059,2131,0.0250119,0.0062646,
1,73,2059,2132,0.0277519,0.0072438,
1,74,2059,2133,0.0307579,0.0084210,
1,75,2059,2134,0.0339099,0.0096470,
1,76,2059,2135,0.0371478,0.0108058,
1,77,2059,2136,0.0405123,0.0118778,
1,78,2059,2137,0.0440886,0.0129177,
1,79,2059,2138,0.0480027,0.0140358,
1,80,2059,2139,0.0536037,0.0168320,
1,81,2059,2140,0.0586892,0.0186065,
1,82,2059,2141,0.0642414,0.0205552,
1,83,2059,2142,0.0702997,0.0227659,
1,84,2059,2143,0.0769067,0.0253277,
1,85,2059,2144,0.0841076,0.0282453,
1,86,2059,2145,0.0919504,0.0315560,
1,87,2059,2146,0.1004863,0.0353293,
1,88,2059,2147,0.1097689,0.0396532,
1,89,2059,2148,0.1198550,0.0445951,
1,90,2059,2149,0.1308036,0.0501671,
1,91,2059,2150,0.1426766,0.0564083,
1,0,2060,2060,0.0091934,0.0012233,
1,1,2060,2061,0.0006668,0.0000369,
1,2,2060,2062,0.0003367,0.0000213,
1,3,2060,2063,0.0002291,0.0000150,
1,4,2060,2064,0.0001930,0.0000137,
1,5,2060,2065,0.0001870,0.0000156,
1,6,2060,2066,0.0001837,0.0000174,
1,7,2060,2067,0.0001828,0.0000195,
1,8,2060,2068,0.0001845,0.0000220,
1,9,2060,2069,0.0001904,0.0000255,
1,10,2060,2070,0.0002017,0.0000309,
1,11,2060,2071,0.0002200,0.0000385,
1,12,2060,2072,0.0002484,0.0000496,
1,13,2060,2073,0.0002934,0.0000686,
1,14,2060,2074,0.0003624,0.0001025,
1,15,2060,2075,0.0004596,0.0001578,
1,16,2060,2076,0.0005802,0.0002331,
1,17,2060,2077,0.0007098,0.0003152,
1,18,2060,2078,0.0008321,0.0003926,
1,19,2060,2079,0.0009391,0.0004579,
1,20,2060,2080,0.0010297,0.0005089,
1,21,2060,2081,0.0011033,0.0005441,
1,22,2060,2082,0.0011584,0.0005665,
1,23,2060,2083,0.0011978,0.0005861,
1,24,2060,2084,0.0012275,0.0006026,
1,25,2060,2085,0.0012521,0.0006048,
1,26,2060,2086,0.0012759,0.0006024,
1,27,2060,2087,0.0013058,0.0006074,
1,28,2060,2088,0.0013446,0.0006328,
1,29,2060,2089,0.0013859,0.0006522,
1,30,2060,2090,0.0014216,0.0006521,
1,31,2060,2091,0.0014530,0.0006469,
1,32,2060,2092,0.0014859,0.0006432,
1,33,2060,2093,0.0015203,0.0006332,
1,34,2060,2094,0.0015540,0.0006118,
1,35,2060,2095,0.0015941,0.0005829,
1,36,2060,2096,0.0016525,0.0005689,
1,37,2060,2097,0.0017318,0.0005680,
1,38,2060,2098,0.0018255,0.0005878,
1,39,2060,2099,0.0019305,0.0006247,
1,40,2060,2100,0.0020513,0.0006742,
1,41,2060,2101,0.0021897,0.0007355,
1,42,2060,2102,0.0023342,0.0007985,
1,43,2060,2103,0.0024669,0.0008483,
1,44,2060,2104,0.0025867,0.0008766,
1,45,2060,2105,0.0027191,0.0008841,
1,46,2060,2106,0.0028925,0.0009170,
1,47,2060,2107,0.0031101,0.0009759,
1,48,2060,2108,0.0033571,0.0010590,
1,49,2060,2109,0.0036304,0.0011482,
1,50,2060,2110,0.0039379,0.0012293,
1,51,2060,2111,0.0042708,0.0013088,
1,52,2060,2112,0.0046082,0.0013824,
1,53,2060,2113,0.0049489,0.0014360,
1,54,2060,2114,0.0053157,0.0014969,
1,55,2060,2115,0.0057365,0.0015716,
1,56,2060,2116,0.0062406,0.0016975,
1,57,2060,2117,0.0068502,0.0018832,
1,58,2060,2118,0.0075521,0.0021285,
1,59,2060,2119,0.0083035,0.0023820,
1,60,2060,2120,0.0090849,0.0026090,
1,61,2060,2121,0.0099105,0.0028177,
1,62,2060,2122,0.0107829,0.0030126,
1,63,2060,2123,0.0116995,0.0032072,
1,64,2060,2124,0.0126957,0.0034347,
1,65,2060,2125,0.0138071,0.0036984,
1,66,2060,2126,0.0150054,0.0039836,
1,67,2060,2127,0.0162315,0.0042192,
1,68,2060,2128,0.0174919,0.0044023,
1,69,2060,2129,0.0188954,0.0046154,
1,70,2060,2130,0.0205786,0.0049339,
1,71,2060,2131,0.0226142,0.0054455,
1,72,2060,2132,0.0250119,0.0061911,
1,73,2060,2133,0.0277519,0.0071676,
1,74,2060,2134,0.0307579,0.0083335,
1,75,2060,2135,0.0339099,0.0095415,
1,76,2060,2136,0.0371478,0.0106879,
1,77,2060,2137,0.0405123,0.0117576,
1,78,2060,2138,0.0440886,0.0127977,
1,79,2060,2139,0.0480027,0.0139035,
1,80,2060,2140,0.0536037,0.0166705,
1,81,2060,2141,0.0586892,0.0184266,
1,82,2060,2142,0.0642414,0.0203709,
1,83,2060,2143,0.0702997,0.0225803,
1,84,2060,2144,0.0769067,0.0251211,
1,85,2060,2145,0.0841076,0.0280005,
1,86,2060,2146,0.0919504,0.0312834,
1,87,2060,2147,0.1004863,0.0350501,
1,88,2060,2148,0.1097689,0.0393715,
1,89,2060,2149,0.1198550,0.0442807,
1,90,2060,2150,0.1308036,0.0497955,
1,0,2061,2061,0.0091934,0.0011686,
1,1,2061,2062,0.0006668,0.0000348,
1,2,2061,2063,0.0003367,0.0000202,
1,3,2061,2064,0.0002291,0.0000143,
1,4,2061,2065,0.0001930,0.0000130,
1,5,2061,2066,0.0001870,0.0000149,
1,6,2061,2067,0.0001837,0.0000166,
1,7,2061,2068,0.0001828,0.0000188,
1,8,2061,2069,0.0001845,0.0000212,
1,9,2061,2070,0.0001904,0.0000246,
1,10,2061,2071,0.0002017,0.0000298,
1,11,2061,2072,0.0002200,0.0000373,
1,12,2061,2073,0.0002484,0.0000484,
1,13,2061,2074,0.0002934,0.0000671,
1,14,2061,2075,0.0003624,0.0001004,
1,15,2061,2076,0.0004596,0.0001550,
1,16,2061,2077,0.0005802,0.0002298,
1,17,2061,2078,0.0007098,0.0003115,
1,18,2061,2079,0.0008321,0.0003883,
1,19,2061,2080,0.0009391,0.0004527,
1,20,2061,2081,0.0010297,0.0005032,
1,21,2061,2082,0.0011033,0.0005384,
1,22,2061,2083,0.0011584,0.0005611,
1,23,2061,2084,0.0011978,0.0005804,
1,24,2061,2085,0.0012275,0.0005964,
1,25,2061,2086,0.0012521,0.0005983,
1,26,2061,2087,0.0012759,0.0005962,
1,27,2061,2088,0.0013058,0.0006016,
1,28,2061,2089,0.0013446,0.0006267,
1,29,2061,2090,0.0013859,0.0006455,
1,30,2061,2091,0.0014216,0.0006451,
1,31,2061,2092,0.0014530,0.0006402,
1,32,2061,2093,0.0014859,0.0006369,
1,33,2061,2094,0.0015203,0.0006266,
1,34,2061,2095,0.0015540,0.0006045,
1,35,2061,2096,0.0015941,0.0005753,
1,36,2061,2097,0.0016525,0.0005616,
1,37,2061,2098,0.0017318,0.0005611,
1,38,2061,2099,0.0018255,0.0005804,
1,39,2061,2100,0.0019305,0.0006163,
1,40,2061,2101,0.0020513,0.0006652,
1,41,2061,2102,0.0021897,0.0007264,
1,42,2061,2103,0.0023342,0.0007897,
1,43,2061,2104,0.0024669,0.0008388,
1,44,2061,2105,0.0025867,0.0008658,
1,45,2061,2106,0.0027191,0.0008727,
1,46,2061,2107,0.0028925,0.0009057,
1,47,2061,2108,0.0031101,0.0009647,
1,48,2061,2109,0.0033571,0.0010467,
1,49,2061,2110,0.0036304,0.0011339,
1,50,2061,2111,0.0039379,0.0012136,
1,51,2061,2112,0.0042708,0.0012929,
1,52,2061,2113,0.0046082,0.0013668,
1,53,2061,2114,0.0049489,0.0014192,
1,54,2061,2115,0.0053157,0.0014776,
1,55,2061,2116,0.0057365,0.0015506,
1,56,2061,2117,0.0062406,0.0016763,
1,57,2061,2118,0.0068502,0.0018616,
1,58,2061,2119,0.0075521,0.0021040,
1,59,2061,2120,0.0083035,0.0023528,
1,60,2061,2121,0.0090849,0.0025766,
1,61,2061,2122,0.0099105,0.0027848,
1,62,2061,2123,0.0107829,0.0029797,
1,63,2061,2124,0.0116995,0.0031711,
1,64,2061,2125,0.0126957,0.0033925,
1,65,2061,2126,0.0138071,0.0036520,
1,66,2061,2127,0.0150054,0.0039366,
1,67,2061,2128,0.0162315,0.0041729,
1,68,2061,2129,0.0174919,0.0043521,
1,69,2061,2130,0.0188954,0.0045573,
1,70,2061,2131,0.0205786,0.0048700,
1,71,2061,2132,0.0226142,0.0053798,
1,72,2061,2133,0.0250119,0.0061235,
1,73,2061,2134,0.0277519,0.0070898,
1,74,2061,2135,0.0307579,0.0082389,
1,75,2061,2136,0.0339099,0.0094348,
1,76,2061,2137,0.0371478,0.0105782,
1,77,2061,2138,0.0405123,0.0116476,
1,78,2061,2139,0.0440886,0.0126764,
1,79,2061,2140,0.0480027,0.0137609,
1,80,2061,2141,0.0536037,0.0165068,
1,81,2061,2142,0.0586892,0.0182588,
1,82,2061,2143,0.0642414,0.0202019,
1,83,2061,2144,0.0702997,0.0223921,
1,84,2061,2145,0.0769067,0.0248981,
1,85,2061,2146,0.0841076,0.0277521,
1,86,2061,2147,0.0919504,0.0310287,
1,87,2061,2148,0.1004863,0.0347928,
1,88,2061,2149,0.1097689,0.0390840,
1,89,2061,2150,0.1198550,0.0439404,
1,0,2062,2062,0.0091934,0.0011192,
1,1,2062,2063,0.0006668,0.0000329,
1,2,2062,2064,0.0003367,0.0000192,
1,3,2062,2065,0.0002291,0.0000135,
1,4,2062,2066,0.0001930,0.0000123,
1,5,2062,2067,0.0001870,0.0000142,
1,6,2062,2068,0.0001837,0.0000159,
1,7,2062,2069,0.0001828,0.0000181,
1,8,2062,2070,0.0001845,0.0000203,
1,9,2062,2071,0.0001904,0.0000237,
1,10,2062,2072,0.0002017,0.0000289,
1,11,2062,2073,0.0002200,0.0000363,
1,12,2062,2074,0.0002484,0.0000472,
1,13,2062,2075,0.0002934,0.0000654,
1,14,2062,2076,0.0003624,0.0000982,
1,15,2062,2077,0.0004596,0.0001524,
1,16,2062,2078,0.0005802,0.0002267,
1,17,2062,2079,0.0007098,0.0003078,
1,18,2062,2080,0.0008321,0.0003837,
1,19,2062,2081,0.0009391,0.0004475,
1,20,2062,2082,0.0010297,0.0004979,
1,21,2062,2083,0.0011033,0.0005332,
1,22,2062,2084,0.0011584,0.0005556,
1,23,2062,2085,0.0011978,0.0005743,
1,24,2062,2086,0.0012275,0.0005901,
1,25,2062,2087,0.0012521,0.0005923,
1,26,2062,2088,0.0012759,0.0005906,
1,27,2062,2089,0.0013058,0.0005957,
1,28,2062,2090,0.0013446,0.0006202,
1,29,2062,2091,0.0013859,0.0006387,
1,30,2062,2092,0.0014216,0.0006386,
1,31,2062,2093,0.0014530,0.0006340,
1,32,2062,2094,0.0014859,0.0006305,
1,33,2062,2095,0.0015203,0.0006195,
1,34,2062,2096,0.0015540,0.0005972,
1,35,2062,2097,0.0015941,0.0005683,
1,36,2062,2098,0.0016525,0.0005549,
1,37,2062,2099,0.0017318,0.0005541,
1,38,2062,2100,0.0018255,0.0005725,
1,39,2062,2101,0.0019305,0.0006078,
1,40,2062,2102,0.0020513,0.0006568,
1,41,2062,2103,0.0021897,0.0007182,
1,42,2062,2104,0.0023342,0.0007807,
1,43,2062,2105,0.0024669,0.0008285,
1,44,2062,2106,0.0025867,0.0008549,
1,45,2062,2107,0.0027191,0.0008621,
1,46,2062,2108,0.0028925,0.0008954,
1,47,2062,2109,0.0031101,0.0009534,
1,48,2062,2110,0.0033571,0.0010335,
1,49,2062,2111,0.0036304,0.0011194,
1,50,2062,2112,0.0039379,0.0011990,
1,51,2062,2113,0.0042708,0.0012785,
1,52,2062,2114,0.0046082,0.0013511,
1,53,2062,2115,0.0049489,0.0014012,
1,54,2062,2116,0.0053157,0.0014581,
1,55,2062,2117,0.0057365,0.0015311,
1,56,2062,2118,0.0062406,0.0016567,
1,57,2062,2119,0.0068502,0.0018396,
1,58,2062,2120,0.0075521,0.0020776,
1,59,2062,2121,0.0083035,0.0023233,
1,60,2062,2122,0.0090849,0.0025464,
1,61,2062,2123,0.0099105,0.0027546,
1,62,2062,2124,0.0107829,0.0029464,
1,63,2062,2125,0.0116995,0.0031322,
1,64,2062,2126,0.0126957,0.0033499,
1,65,2062,2127,0.0138071,0.0036088,
1,66,2062,2128,0.0150054,0.0038937,
1,67,2062,2129,0.0162315,0.0041260,
1,68,2062,2130,0.0174919,0.0042980,
1,69,2062,2131,0.0188954,0.0044986,
1,70,2062,2132,0.0205786,0.0048106,
1,71,2062,2133,0.0226142,0.0053194,
1,72,2062,2134,0.0250119,0.0060544,
1,73,2062,2135,0.0277519,0.0070058,
1,74,2062,2136,0.0307579,0.0081432,
1,75,2062,2137,0.0339099,0.0093353,
1,76,2062,2138,0.0371478,0.0104778,
1,77,2062,2139,0.0405123,0.0115364,
1,78,2062,2140,0.0440886,0.0125458,
1,79,2062,2141,0.0480027,0.0136165,
1,80,2062,2142,0.0536037,0.0163541,
1,81,2062,2143,0.0586892,0.0181049,
1,82,2062,2144,0.0642414,0.0200305,
1,83,2062,2145,0.0702997,0.0221891,
1,84,2062,2146,0.0769067,0.0246718,
1,85,2062,2147,0.0841076,0.0275200,
1,86,2062,2148,0.0919504,0.0307941,
1,87,2062,2149,0.1004863,0.0345304,
1,88,2062,2150,0.1097689,0.0387729,
1,0,2063,2063,0.0091934,0.0010754,
1,1,2063,2064,0.0006668,0.0000311,
1,2,2063,2065,0.0003367,0.0000181,
1,3,2063,2066,0.0002291,0.0000127,
1,4,2063,2067,0.0001930,0.0000117,
1,5,2063,2068,0.0001870,0.0000136,
1,6,2063,2069,0.0001837,0.0000153,
1,7,2063,2070,0.0001828,0.0000173,
1,8,2063,2071,0.0001845,0.0000195,
1,9,2063,2072,0.0001904,0.0000228,
1,10,2063,2073,0.0002017,0.0000280,
1,11,2063,2074,0.0002200,0.0000353,
1,12,2063,2075,0.0002484,0.0000459,
1,13,2063,2076,0.0002934,0.0000638,
1,14,2063,2077,0.0003624,0.0000962,
1,15,2063,2078,0.0004596,0.0001500,
1,16,2063,2079,0.0005802,0.0002236,
1,17,2063,2080,0.0007098,0.0003037,
1,18,2063,2081,0.0008321,0.0003790,
1,19,2063,2082,0.0009391,0.0004426,
1,20,2063,2083,0.0010297,0.0004930,
1,21,2063,2084,0.0011033,0.0005280,
1,22,2063,2085,0.0011584,0.0005497,
1,23,2063,2086,0.0011978,0.0005681,
1,24,2063,2087,0.0012275,0.0005842,
1,25,2063,2088,0.0012521,0.0005868,
1,26,2063,2089,0.0012759,0.0005848,
1,27,2063,2090,0.0013058,0.0005894,
1,28,2063,2091,0.0013446,0.0006136,
1,29,2063,2092,0.0013859,0.0006324,
1,30,2063,2093,0.0014216,0.0006326,
1,31,2063,2094,0.0014530,0.0006278,
1,32,2063,2095,0.0014859,0.0006236,
1,33,2063,2096,0.0015203,0.0006123,
1,34,2063,2097,0.0015540,0.0005903,
1,35,2063,2098,0.0015941,0.0005619,
1,36,2063,2099,0.0016525,0.0005482,
1,37,2063,2100,0.0017318,0.0005465,
1,38,2063,2101,0.0018255,0.0005645,
1,39,2063,2102,0.0019305,0.0005999,
1,40,2063,2103,0.0020513,0.0006490,
1,41,2063,2104,0.0021897,0.0007097,
1,42,2063,2105,0.0023342,0.0007709,
1,43,2063,2106,0.0024669,0.0008181,
1,44,2063,2107,0.0025867,0.0008448,
1,45,2063,2108,0.0027191,0.0008523,
1,46,2063,2109,0.0028925,0.0008848,
1,47,2063,2110,0.0031101,0.0009412,
1,48,2063,2111,0.0033571,0.0010201,
1,49,2063,2112,0.0036304,0.0011059,
1,50,2063,2113,0.0039379,0.0011857,
1,51,2063,2114,0.0042708,0.0012639,
1,52,2063,2115,0.0046082,0.0013343,
1,53,2063,2116,0.0049489,0.0013830,
1,54,2063,2117,0.0053157,0.0014400,
1,55,2063,2118,0.0057365,0.0015132,
1,56,2063,2119,0.0062406,0.0016368,
1,57,2063,2120,0.0068502,0.0018159,
1,58,2063,2121,0.0075521,0.0020509,
1,59,2063,2122,0.0083035,0.0022958,
1,60,2063,2123,0.0090849,0.0025188,
1,61,2063,2124,0.0099105,0.0027239,
1,62,2063,2125,0.0107829,0.0029105,
1,63,2063,2126,0.0116995,0.0030929,
1,64,2063,2127,0.0126957,0.0033102,
1,65,2063,2128,0.0138071,0.0035693,
1,66,2063,2129,0.0150054,0.0038502,
1,67,2063,2130,0.0162315,0.0040755,
1,68,2063,2131,0.0174919,0.0042434,
1,69,2063,2132,0.0188954,0.0044440,
1,70,2063,2133,0.0205786,0.0047559,
1,71,2063,2134,0.0226142,0.0052577,
1,72,2063,2135,0.0250119,0.0059799,
1,73,2063,2136,0.0277519,0.0069208,
1,74,2063,2137,0.0307579,0.0080541,
1,75,2063,2138,0.0339099,0.0092444,
1,76,2063,2139,0.0371478,0.0103763,
1,77,2063,2140,0.0405123,0.0114167,
1,78,2063,2141,0.0440886,0.0124134,
1,79,2063,2142,0.0480027,0.0134819,
1,80,2063,2143,0.0536037,0.0162141,
1,81,2063,2144,0.0586892,0.0179489,
1,82,2063,2145,0.0642414,0.0198457,
1,83,2063,2146,0.0702997,0.0219830,
1,84,2063,2147,0.0769067,0.0244604,
1,85,2063,2148,0.0841076,0.0273062,
1,86,2063,2149,0.0919504,0.0305548,
1,87,2063,2150,0.1004863,0.0342464,
1,0,2064,2064,0.0091933,0.0010322,
1,1,2064,2065,0.0006668,0.0000292,
1,2,2064,2066,0.0003367,0.0000170,
1,3,2064,2067,0.0002291,0.0000120,
1,4,2064,2068,0.0001930,0.0000111,
1,5,2064,2069,0.0001870,0.0000130,
1,6,2064,2070,0.0001837,0.0000146,
1,7,2064,2071,0.0001828,0.0000165,
1,8,2064,2072,0.0001845,0.0000188,
1,9,2064,2073,0.0001904,0.0000221,
1,10,2064,2074,0.0002017,0.0000271,
1,11,2064,2075,0.0002200,0.0000342,
1,12,2064,2076,0.0002484,0.0000446,
1,13,2064,2077,0.0002934,0.0000623,
1,14,2064,2078,0.0003624,0.0000944,
1,15,2064,2079,0.0004596,0.0001475,
1,16,2064,2080,0.0005802,0.0002203,
1,17,2064,2081,0.0007098,0.0002996,
1,18,2064,2082,0.0008321,0.0003746,
1,19,2064,2083,0.0009391,0.0004382,
1,20,2064,2084,0.0010297,0.0004881,
1,21,2064,2085,0.0011033,0.0005223,
1,22,2064,2086,0.0011584,0.0005437,
1,23,2064,2087,0.0011978,0.0005624,
1,24,2064,2088,0.0012275,0.0005788,
1,25,2064,2089,0.0012521,0.0005812,
1,26,2064,2090,0.0012759,0.0005786,
1,27,2064,2091,0.0013058,0.0005829,
1,28,2064,2092,0.0013446,0.0006075,
1,29,2064,2093,0.0013859,0.0006266,
1,30,2064,2094,0.0014216,0.0006265,
1,31,2064,2095,0.0014530,0.0006211,
1,32,2064,2096,0.0014859,0.0006166,
1,33,2064,2097,0.0015203,0.0006056,
1,34,2064,2098,0.0015540,0.0005840,
1,35,2064,2099,0.0015941,0.0005554,
1,36,2064,2100,0.0016525,0.0005410,
1,37,2064,2101,0.0017318,0.0005389,
1,38,2064,2102,0.0018255,0.0005571,
1,39,2064,2103,0.0019305,0.0005926,
1,40,2064,2104,0.0020513,0.0006412,
1,41,2064,2105,0.0021897,0.0007006,
1,42,2064,2106,0.0023342,0.0007611,
1,43,2064,2107,0.0024669,0.0008084,
1,44,2064,2108,0.0025867,0.0008355,
1,45,2064,2109,0.0027191,0.0008424,
1,46,2064,2110,0.0028925,0.0008735,
1,47,2064,2111,0.0031101,0.0009288,
1,48,2064,2112,0.0033571,0.0010077,
1,49,2064,2113,0.0036304,0.0010936,
1,50,2064,2114,0.0039379,0.0011723,
1,51,2064,2115,0.0042708,0.0012483,
1,52,2064,2116,0.0046082,0.0013172,
1,53,2064,2117,0.0049489,0.0013660,
1,54,2064,2118,0.0053157,0.0014233,
1,55,2064,2119,0.0057365,0.0014949,
1,56,2064,2120,0.0062406,0.0016153,
1,57,2064,2121,0.0068502,0.0017919,
1,58,2064,2122,0.0075521,0.0020261,
1,59,2064,2123,0.0083035,0.0022706,
1,60,2064,2124,0.0090849,0.0024907,
1,61,2064,2125,0.0099105,0.0026909,
1,62,2064,2126,0.0107829,0.0028742,
1,63,2064,2127,0.0116995,0.0030563,
1,64,2064,2128,0.0126957,0.0032739,
1,65,2064,2129,0.0138071,0.0035293,
1,66,2064,2130,0.0150054,0.0038035,
1,67,2064,2131,0.0162315,0.0040245,
1,68,2064,2132,0.0174919,0.0041925,
1,69,2064,2133,0.0188954,0.0043937,
1,70,2064,2134,0.0205786,0.0047001,
1,71,2064,2135,0.0226142,0.0051912,
1,72,2064,2136,0.0250119,0.0059045,
1,73,2064,2137,0.0277519,0.0068417,
1,74,2064,2138,0.0307579,0.0079726,
1,75,2064,2139,0.0339099,0.0091525,
1,76,2064,2140,0.0371478,0.0102670,
1,77,2064,2141,0.0405123,0.0112954,
1,78,2064,2142,0.0440886,0.0122900,
1,79,2064,2143,0.0480027,0.0133586,
1,80,2064,2144,0.0536037,0.0160722,
1,81,2064,2145,0.0586892,0.0177807,
1,82,2064,2146,0.0642414,0.0196582,
1,83,2064,2147,0.0702997,0.0217907,
1,84,2064,2148,0.0769067,0.0242658,
1,85,2064,2149,0.0841076,0.0270883,
1,86,2064,2150,0.0919504,0.0302960,
1,0,2065,2065,0.0091933,0.0009871,
1,1,2065,2066,0.0006668,0.0000274,
1,2,2065,2067,0.0003367,0.0000161,
1,3,2065,2068,0.0002291,0.0000115,
1,4,2065,2069,0.0001930,0.0000106,
1,5,2065,2070,0.0001870,0.0000123,
1,6,2065,2071,0.0001837,0.0000139,
1,7,2065,2072,0.0001828,0.0000158,
1,8,2065,2073,0.0001845,0.0000181,
1,9,2065,2074,0.0001904,0.0000213,
1,10,2065,2075,0.0002017,0.0000262,
1,11,2065,2076,0.0002200,0.0000332,
1,12,2065,2077,0.0002484,0.0000434,
1,13,2065,2078,0.0002934,0.0000609,
1,14,2065,2079,0.0003624,0.0000926,
1,15,2065,2080,0.0004596,0.0001449,
1,16,2065,2081,0.0005802,0.0002169,
1,17,2065,2082,0.0007098,0.0002958,
1,18,2065,2083,0.0008321,0.0003706,
1,19,2065,2084,0.0009391,0.0004337,
1,20,2065,2085,0.0010297,0.0004828,
1,21,2065,2086,0.0011033,0.0005166,
1,22,2065,2087,0.0011584,0.0005381,
1,23,2065,2088,0.0011978,0.0005571,
1,24,2065,2089,0.0012275,0.0005733,
1,25,2065,2090,0.0012521,0.0005751,
1,26,2065,2091,0.0012759,0.0005723,
1,27,2065,2092,0.0013058,0.0005769,
1,28,2065,2093,0.0013446,0.0006018,
1,29,2065,2094,0.0013859,0.0006207,
1,30,2065,2095,0.0014216,0.0006199,
1,31,2065,2096,0.0014530,0.0006142,
1,32,2065,2097,0.0014859,0.0006101,
1,33,2065,2098,0.0015203,0.0005995,
1,34,2065,2099,0.0015540,0.0005777,
1,35,2065,2100,0.0015941,0.0005484,
1,36,2065,2101,0.0016525,0.0005337,
1,37,2065,2102,0.0017318,0.0005319,
1,38,2065,2103,0.0018255,0.0005503,
1,39,2065,2104,0.0019305,0.0005853,
1,40,2065,2105,0.0020513,0.0006327,
1,41,2065,2106,0.0021897,0.0006915,
1,42,2065,2107,0.0023342,0.0007520,
1,43,2065,2108,0.0024669,0.0007995,
1,44,2065,2109,0.0025867,0.0008260,
1,45,2065,2110,0.0027191,0.0008317,
1,46,2065,2111,0.0028925,0.0008620,
1,47,2065,2112,0.0031101,0.0009174,
1,48,2065,2113,0.0033571,0.0009964,
1,49,2065,2114,0.0036304,0.0010812,
1,50,2065,2115,0.0039379,0.0011578,
1,51,2065,2116,0.0042708,0.0012325,
1,52,2065,2117,0.0046082,0.0013014,
1,53,2065,2118,0.0049489,0.0013504,
1,54,2065,2119,0.0053157,0.0014063,
1,55,2065,2120,0.0057365,0.0014752,
1,56,2065,2121,0.0062406,0.0015936,
1,57,2065,2122,0.0068502,0.0017696,
1,58,2065,2123,0.0075521,0.0020033,
1,59,2065,2124,0.0083035,0.0022450,
1,60,2065,2125,0.0090849,0.0024604,
1,61,2065,2126,0.0099105,0.0026575,
1,62,2065,2127,0.0107829,0.0028404,
1,63,2065,2128,0.0116995,0.0030229,
1,64,2065,2129,0.0126957,0.0032372,
1,65,2065,2130,0.0138071,0.0034864,
1,66,2065,2131,0.0150054,0.0037562,
1,67,2065,2132,0.0162315,0.0039770,
1,68,2065,2133,0.0174919,0.0041457,
1,69,2065,2134,0.0188954,0.0043424,
1,70,2065,2135,0.0205786,0.0046400,
1,71,2065,2136,0.0226142,0.0051240,
1,72,2065,2137,0.0250119,0.0058344,
1,73,2065,2138,0.0277519,0.0067694,
1,74,2065,2139,0.0307579,0.0078903,
1,75,2065,2140,0.0339099,0.0090535,
1,76,2065,2141,0.0371478,0.0101563,
1,77,2065,2142,0.0405123,0.0111823,
1,78,2065,2143,0.0440886,0.0121770,
1,79,2065,2144,0.0480027,0.0132336,
1,80,2065,2145,0.0536037,0.0159191,
1,81,2065,2146,0.0586892,0.0176101,
1,82,2065,2147,0.0642414,0.0194831,
1,83,2065,2148,0.0702997,0.0216136,
1,84,2065,2149,0.0769067,0.0240674,
1,85,2065,2150,0.0841076,0.0268526,
1,0,2066,2066,0.0091933,0.0009430,
1,1,2066,2067,0.0006668,0.0000258,
1,2,2066,2068,0.0003367,0.0000153,
1,3,2066,2069,0.0002291,0.0000109,
1,4,2066,2070,0.0001930,0.0000100,
1,5,2066,2071,0.0001870,0.0000117,
1,6,2066,2072,0.0001837,0.0000133,
1,7,2066,2073,0.0001828,0.0000152,
1,8,2066,2074,0.0001845,0.0000174,
1,9,2066,2075,0.0001904,0.0000205,
1,10,2066,2076,0.0002017,0.0000253,
1,11,2066,2077,0.0002200,0.0000322,
1,12,2066,2078,0.0002484,0.0000423,
1,13,2066,2079,0.0002934,0.0000595,
1,14,2066,2080,0.0003624,0.0000906,
1,15,2066,2081,0.0004596,0.0001423,
1,16,2066,2082,0.0005802,0.0002138,
1,17,2066,2083,0.0007098,0.0002924,
1,18,2066,2084,0.0008321,0.0003666,
1,19,2066,2085,0.0009391,0.0004288,
1,20,2066,2086,0.0010297,0.0004775,
1,21,2066,2087,0.0011033,0.0005113,
1,22,2066,2088,0.0011584,0.0005329,
1,23,2066,2089,0.0011978,0.0005517,
1,24,2066,2090,0.0012275,0.0005674,
1,25,2066,2091,0.0012521,0.0005689,
1,26,2066,2092,0.0012759,0.0005664,
1,27,2066,2093,0.0013058,0.0005714,
1,28,2066,2094,0.0013446,0.0005961,
1,29,2066,2095,0.0013859,0.0006143,
1,30,2066,2096,0.0014216,0.0006133,
1,31,2066,2097,0.0014530,0.0006079,
1,32,2066,2098,0.0014859,0.0006041,
1,33,2066,2099,0.0015203,0.0005933,
1,34,2066,2100,0.0015540,0.0005709,
1,35,2066,2101,0.0015941,0.0005413,
1,36,2066,2102,0.0016525,0.0005270,
1,37,2066,2103,0.0017318,0.0005254,
1,38,2066,2104,0.0018255,0.0005433,
1,39,2066,2105,0.0019305,0.0005773,
1,40,2066,2106,0.0020513,0.0006241,
1,41,2066,2107,0.0021897,0.0006829,
1,42,2066,2108,0.0023342,0.0007436,
1,43,2066,2109,0.0024669,0.0007905,
1,44,2066,2110,0.0025867,0.0008158,
1,45,2066,2111,0.0027191,0.0008209,
1,46,2066,2112,0.0028925,0.0008513,
1,47,2066,2113,0.0031101,0.0009069,
1,48,2066,2114,0.0033571,0.0009849,
1,49,2066,2115,0.0036304,0.0010679,
1,50,2066,2116,0.0039379,0.0011432,
1,51,2066,2117,0.0042708,0.0012177,
1,52,2066,2118,0.0046082,0.0012868,
1,53,2066,2119,0.0049489,0.0013345,
1,54,2066,2120,0.0053157,0.0013880,
1,55,2066,2121,0.0057365,0.0014552,
1,56,2066,2122,0.0062406,0.0015734,
1,57,2066,2123,0.0068502,0.0017492,
1,58,2066,2124,0.0075521,0.0019802,
1,59,2066,2125,0.0083035,0.0022174,
1,60,2066,2126,0.0090849,0.0024298,
1,61,2066,2127,0.0099105,0.0026264,
1,62,2066,2128,0.0107829,0.0028095,
1,63,2066,2129,0.0116995,0.0029890,
1,64,2066,2130,0.0126957,0.0031977,
1,65,2066,2131,0.0138071,0.0034429,
1,66,2066,2132,0.0150054,0.0037122,
1,67,2066,2133,0.0162315,0.0039333,
1,68,2066,2134,0.0174919,0.0040979,
1,69,2066,2135,0.0188954,0.0042870,
1,70,2066,2136,0.0205786,0.0045791,
1,71,2066,2137,0.0226142,0.0050615,
1,72,2066,2138,0.0250119,0.0057704,
1,73,2066,2139,0.0277519,0.0066965,
1,74,2066,2140,0.0307579,0.0078018,
1,75,2066,2141,0.0339099,0.0089533,
1,76,2066,2142,0.0371478,0.0100531,
1,77,2066,2143,0.0405123,0.0110787,
1,78,2066,2144,0.0440886,0.0120625,
1,79,2066,2145,0.0480027,0.0130989,
1,80,2066,2146,0.0536037,0.0157639,
1,81,2066,2147,0.0586892,0.0174507,
1,82,2066,2148,0.0642414,0.0193220,
1,83,2066,2149,0.0702997,0.0214331,
1,84,2066,2150,0.0769067,0.0238529,
1,0,2067,2067,0.0091933,0.0009032,
1,1,2067,2068,0.0006668,0.0000244,
1,2,2067,2069,0.0003367,0.0000145,
1,3,2067,2070,0.0002291,0.0000103,
1,4,2067,2071,0.0001930,0.0000095,
1,5,2067,2072,0.0001870,0.0000111,
1,6,2067,2073,0.0001837,0.0000127,
1,7,2067,2074,0.0001828,0.0000147,
1,8,2067,2075,0.0001845,0.0000168,
1,9,2067,2076,0.0001904,0.0000198,
1,10,2067,2077,0.0002017,0.0000245,
1,11,2067,2078,0.0002200,0.0000313,
1,12,2067,2079,0.0002484,0.0000412,
1,13,2067,2080,0.0002934,0.0000580,
1,14,2067,2081,0.0003624,0.0000886,
1,15,2067,2082,0.0004596,0.0001398,
1,16,2067,2083,0.0005802,0.0002109,
1,17,2067,2084,0.0007098,0.0002889,
1,18,2067,2085,0.0008321,0.0003622,
1,19,2067,2086,0.0009391,0.0004239,
1,20,2067,2087,0.0010297,0.0004725,
1,21,2067,2088,0.0011033,0.0005064,
1,22,2067,2089,0.0011584,0.0005277,
1,23,2067,2090,0.0011978,0.0005459,
1,24,2067,2091,0.0012275,0.0005613,
1,25,2067,2092,0.0012521,0.0005632,
1,26,2067,2093,0.0012759,0.0005611,
1,27,2067,2094,0.0013058,0.0005658,
1,28,2067,2095,0.0013446,0.0005899,
1,29,2067,2096,0.0013859,0.0006078,
1,30,2067,2097,0.0014216,0.0006071,
1,31,2067,2098,0.0014530,0.0006021,
1,32,2067,2099,0.0014859,0.0005981,
1,33,2067,2100,0.0015203,0.0005866,
1,34,2067,2101,0.0015540,0.0005640,
1,35,2067,2102,0.0015941,0.0005348,
1,36,2067,2103,0.0016525,0.0005207,
1,37,2067,2104,0.0017318,0.0005188,
1,38,2067,2105,0.0018255,0.0005358,
1,39,2067,2106,0.0019305,0.0005693,
1,40,2067,2107,0.0020513,0.0006162,
1,41,2067,2108,0.0021897,0.0006751,
1,42,2067,2109,0.0023342,0.0007350,
1,43,2067,2110,0.0024669,0.0007807,
1,44,2067,2111,0.0025867,0.0008054,
1,45,2067,2112,0.0027191,0.0008108,
1,46,2067,2113,0.0028925,0.0008416,
1,47,2067,2114,0.0031101,0.0008963,
1,48,2067,2115,0.0033571,0.0009727,
1,49,2067,2116,0.0036304,0.0010545,
1,50,2067,2117,0.0039379,0.0011296,
1,51,2067,2118,0.0042708,0.0012042,
1,52,2067,2119,0.0046082,0.0012719,
1,53,2067,2120,0.0049489,0.0013174,
1,54,2067,2121,0.0053157,0.0013694,
1,55,2067,2122,0.0057365,0.0014367,
1,56,2067,2123,0.0062406,0.0015549,
1,57,2067,2124,0.0068502,0.0017284,
1,58,2067,2125,0.0075521,0.0019554,
1,59,2067,2126,0.0083035,0.0021896,
1,60,2067,2127,0.0090849,0.0024013,
1,61,2067,2128,0.0099105,0.0025979,
1,62,2067,2129,0.0107829,0.0027783,
1,63,2067,2130,0.0116995,0.0029526,
1,64,2067,2131,0.0126957,0.0031578,
1,65,2067,2132,0.0138071,0.0034025,
1,66,2067,2133,0.0150054,0.0036716,
1,67,2067,2134,0.0162315,0.0038887,
1,68,2067,2135,0.0174919,0.0040464,
1,69,2067,2136,0.0188954,0.0042311,
1,70,2067,2137,0.0205786,0.0045226,
1,71,2067,2138,0.0226142,0.0050044,
1,72,2067,2139,0.0250119,0.0057058,
1,73,2067,2140,0.0277519,0.0066180,
1,74,2067,2141,0.0307579,0.0077122,
1,75,2067,2142,0.0339099,0.0088600,
1,76,2067,2143,0.0371478,0.0099586,
1,77,2067,2144,0.0405123,0.0109738,
1,78,2067,2145,0.0440886,0.0119391,
1,79,2067,2146,0.0480027,0.0129625,
1,80,2067,2147,0.0536037,0.0156190,
1,81,2067,2148,0.0586892,0.0173042,
1,82,2067,2149,0.0642414,0.0191578,
1,83,2067,2150,0.0702997,0.0212380,
1,0,2068,2068,0.0091933,0.0008677,
1,1,2068,2069,0.0006668,0.0000230,
1,2,2068,2070,0.0003367,0.0000136,
1,3,2068,2071,0.0002291,0.0000097,
1,4,2068,2072,0.0001930,0.0000090,
1,5,2068,2073,0.0001870,0.0000107,
1,6,2068,2074,0.0001837,0.0000122,
1,7,2068,2075,0.0001828,0.0000141,
1,8,2068,2076,0.0001845,0.0000161,
1,9,2068,2077,0.0001904,0.0000191,
1,10,2068,2078,0.0002017,0.0000238,
1,11,2068,2079,0.0002200,0.0000304,
1,12,2068,2080,0.0002484,0.0000401,
1,13,2068,2081,0.0002934,0.0000566,
1,14,2068,2082,0.0003624,0.0000868,
1,15,2068,2083,0.0004596,0.0001376,
1,16,2068,2084,0.0005802,0.0002080,
1,17,2068,2085,0.0007098,0.0002851,
1,18,2068,2086,0.0008321,0.0003578,
1,19,2068,2087,0.0009391,0.0004193,
1,20,2068,2088,0.0010297,0.0004679,
1,21,2068,2089,0.0011033,0.0005014,
1,22,2068,2090,0.0011584,0.0005221,
1,23,2068,2091,0.0011978,0.0005399,
1,24,2068,2092,0.0012275,0.0005557,
1,25,2068,2093,0.0012521,0.0005579,
1,26,2068,2094,0.0012759,0.0005556,
1,27,2068,2095,0.0013058,0.0005597,
1,28,2068,2096,0.0013446,0.0005836,
1,29,2068,2097,0.0013859,0.0006018,
1,30,2068,2098,0.0014216,0.0006014,
1,31,2068,2099,0.0014530,0.0005962,
1,32,2068,2100,0.0014859,0.0005916,
1,33,2068,2101,0.0015203,0.0005799,
1,34,2068,2102,0.0015540,0.0005576,
1,35,2068,2103,0.0015941,0.0005287,
1,36,2068,2104,0.0016525,0.0005144,
1,37,2068,2105,0.0017318,0.0005117,
1,38,2068,2106,0.0018255,0.0005283,
1,39,2068,2107,0.0019305,0.0005619,
1,40,2068,2108,0.0020513,0.0006089,
1,41,2068,2109,0.0021897,0.0006671,
1,42,2068,2110,0.0023342,0.0007258,
1,43,2068,2111,0.0024669,0.0007709,
1,44,2068,2112,0.0025867,0.0007958,
1,45,2068,2113,0.0027191,0.0008017,
1,46,2068,2114,0.0028925,0.0008318,
1,47,2068,2115,0.0031101,0.0008850,
1,48,2068,2116,0.0033571,0.0009603,
1,49,2068,2117,0.0036304,0.0010419,
1,50,2068,2118,0.0039379,0.0011171,
1,51,2068,2119,0.0042708,0.0011904,
1,52,2068,2120,0.0046082,0.0012558,
1,53,2068,2121,0.0049489,0.0013000,
1,54,2068,2122,0.0053157,0.0013522,
1,55,2068,2123,0.0057365,0.0014197,
1,56,2068,2124,0.0062406,0.0015361,
1,57,2068,2125,0.0068502,0.0017061,
1,58,2068,2126,0.0075521,0.0019302,
1,59,2068,2127,0.0083035,0.0021636,
1,60,2068,2128,0.0090849,0.0023752,
1,61,2068,2129,0.0099105,0.0025692,
1,62,2068,2130,0.0107829,0.0027447,
1,63,2068,2131,0.0116995,0.0029158,
1,64,2068,2132,0.0126957,0.0031206,
1,65,2068,2133,0.0138071,0.0033652,
1,66,2068,2134,0.0150054,0.0036303,
1,67,2068,2135,0.0162315,0.0038405,
1,68,2068,2136,0.0174919,0.0039943,
1,69,2068,2137,0.0188954,0.0041791,
1,70,2068,2138,0.0205786,0.0044710,
1,71,2068,2139,0.0226142,0.0049468,
1,72,2068,2140,0.0250119,0.0056363,
1,73,2068,2141,0.0277519,0.0065386,
1,74,2068,2142,0.0307579,0.0076287,
1,75,2068,2143,0.0339099,0.0087745,
1,76,2068,2144,0.0371478,0.0098629,
1,77,2068,2145,0.0405123,0.0108607,
1,78,2068,2146,0.0440886,0.0118140,
1,79,2068,2147,0.0480027,0.0128352,
1,80,2068,2148,0.0536037,0.0154858,
1,81,2068,2149,0.0586892,0.0171548,
1,82,2068,2150,0.0642414,0.0189803,
1,0,2069,2069,0.0091933,0.0008324,
1,1,2069,2070,0.0006668,0.0000216,
1,2,2069,2071,0.0003367,0.0000128,
1,3,2069,2072,0.0002291,0.0000092,
1,4,2069,2073,0.0001930,0.0000086,
1,5,2069,2074,0.0001870,0.0000102,
1,6,2069,2075,0.0001837,0.0000117,
1,7,2069,2076,0.0001828,0.0000135,
1,8,2069,2077,0.0001845,0.0000155,
1,9,2069,2078,0.0001904,0.0000185,
1,10,2069,2079,0.0002017,0.0000231,
1,11,2069,2080,0.0002200,0.0000295,
1,12,2069,2081,0.0002484,0.0000389,
1,13,2069,2082,0.0002934,0.0000552,
1,14,2069,2083,0.0003624,0.0000851,
1,15,2069,2084,0.0004596,0.0001354,
1,16,2069,2085,0.0005802,0.0002049,
1,17,2069,2086,0.0007098,0.0002813,
1,18,2069,2087,0.0008321,0.0003537,
1,19,2069,2088,0.0009391,0.0004151,
1,20,2069,2089,0.0010297,0.0004633,
1,21,2069,2090,0.0011033,0.0004960,
1,22,2069,2091,0.0011584,0.0005163,
1,23,2069,2092,0.0011978,0.0005344,
1,24,2069,2093,0.0012275,0.0005506,
1,25,2069,2094,0.0012521,0.0005526,
1,26,2069,2095,0.0012759,0.0005497,
1,27,2069,2096,0.0013058,0.0005536,
1,28,2069,2097,0.0013446,0.0005777,
1,29,2069,2098,0.0013859,0.0005963,
1,30,2069,2099,0.0014216,0.0005957,
1,31,2069,2100,0.0014530,0.0005899,
1,32,2069,2101,0.0014859,0.0005850,
1,33,2069,2102,0.0015203,0.0005736,
1,34,2069,2103,0.0015540,0.0005516,
1,35,2069,2104,0.0015941,0.0005226,
1,36,2069,2105,0.0016525,0.0005076,
1,37,2069,2106,0.0017318,0.0005045,
1,38,2069,2107,0.0018255,0.0005213,
1,39,2069,2108,0.0019305,0.0005550,
1,40,2069,2109,0.0020513,0.0006015,
1,41,2069,2110,0.0021897,0.0006585,
1,42,2069,2111,0.0023342,0.0007165,
1,43,2069,2112,0.0024669,0.0007617,
1,44,2069,2113,0.0025867,0.0007871,
1,45,2069,2114,0.0027191,0.0007924,
1,46,2069,2115,0.0028925,0.0008213,
1,47,2069,2116,0.0031101,0.0008735,
1,48,2069,2117,0.0033571,0.0009487,
1,49,2069,2118,0.0036304,0.0010304,
1,50,2069,2119,0.0039379,0.0011043,
1,51,2069,2120,0.0042708,0.0011754,
1,52,2069,2121,0.0046082,0.0012396,
1,53,2069,2122,0.0049489,0.0012839,
1,54,2069,2123,0.0053157,0.0013364,
1,55,2069,2124,0.0057365,0.0014025,
1,56,2069,2125,0.0062406,0.0015159,
1,57,2069,2126,0.0068502,0.0016835,
1,58,2069,2127,0.0075521,0.0019068,
1,59,2069,2128,0.0083035,0.0021399,
1,60,2069,2129,0.0090849,0.0023489,
1,61,2069,2130,0.0099105,0.0025382,
1,62,2069,2131,0.0107829,0.0027107,
1,63,2069,2132,0.0116995,0.0028816,
1,64,2069,2133,0.0126957,0.0030864,
1,65,2069,2134,0.0138071,0.0033272,
1,66,2069,2135,0.0150054,0.0035856,
1,67,2069,2136,0.0162315,0.0037918,
1,68,2069,2137,0.0174919,0.0039458,
1,69,2069,2138,0.0188954,0.0041316,
1,70,2069,2139,0.0205786,0.0044189,
1,71,2069,2140,0.0226142,0.0048849,
1,72,2069,2141,0.0250119,0.0055661,
1,73,2069,2142,0.0277519,0.0064647,
1,74,2069,2143,0.0307579,0.0075523,
1,75,2069,2144,0.0339099,0.0086880,
1,76,2069,2145,0.0371478,0.0097598,
1,77,2069,2146,0.0405123,0.0107462,
1,78,2069,2147,0.0440886,0.0116974,
1,79,2069,2148,0.0480027,0.0127181,
1,80,2069,2149,0.0536037,0.0153499,
1,81,2069,2150,0.0586892,0.0169934,
1,0,2070,2070,0.0091933,0.0007955,
1,1,2070,2071,0.0006668,0.0000202,
1,2,2070,2072,0.0003367,0.0000121,
1,3,2070,2073,0.0002291,0.0000087,
1,4,2070,2074,0.0001930,0.0000082,
1,5,2070,2075,0.0001870,0.0000097,
1,6,2070,2076,0.0001837,0.0000111,
1,7,2070,2077,0.0001828,0.0000129,
1,8,2070,2078,0.0001845,0.0000150,
1,9,2070,2079,0.0001904,0.0000179,
1,10,2070,2080,0.0002017,0.0000223,
1,11,2070,2081,0.0002200,0.0000286,
1,12,2070,2082,0.0002484,0.0000379,
1,13,2070,2083,0.0002934,0.0000540,
1,14,2070,2084,0.0003624,0.0000835,
1,15,2070,2085,0.0004596,0.0001330,
1,16,2070,2086,0.0005802,0.0002018,
1,17,2070,2087,0.0007098,0.0002778,
1,18,2070,2088,0.0008321,0.0003499,
1,19,2070,2089,0.0009391,0.0004108,
1,20,2070,2090,0.0010297,0.0004582,
1,21,2070,2091,0.0011033,0.0004906,
1,22,2070,2092,0.0011584,0.0005110,
1,23,2070,2093,0.0011978,0.0005294,
1,24,2070,2094,0.0012275,0.0005453,
1,25,2070,2095,0.0012521,0.0005468,
1,26,2070,2096,0.0012759,0.0005437,
1,27,2070,2097,0.0013058,0.0005479,
1,28,2070,2098,0.0013446,0.0005724,
1,29,2070,2099,0.0013859,0.0005907,
1,30,2070,2100,0.0014216,0.0005895,
1,31,2070,2101,0.0014530,0.0005834,
1,32,2070,2102,0.0014859,0.0005789,
1,33,2070,2103,0.0015203,0.0005678,
1,34,2070,2104,0.0015540,0.0005456,
1,35,2070,2105,0.0015941,0.0005160,
1,36,2070,2106,0.0016525,0.0005007,
1,37,2070,2107,0.0017318,0.0004978,
1,38,2070,2108,0.0018255,0.0005148,
1,39,2070,2109,0.0019305,0.0005481,
1,40,2070,2110,0.0020513,0.0005935,
1,41,2070,2111,0.0021897,0.0006498,
1,42,2070,2112,0.0023342,0.0007079,
1,43,2070,2113,0.0024669,0.0007534,
1,44,2070,2114,0.0025867,0.0007782,
1,45,2070,2115,0.0027191,0.0007825,
1,46,2070,2116,0.0028925,0.0008106,
1,47,2070,2117,0.0031101,0.0008629,
1,48,2070,2118,0.0033571,0.0009381,
1,49,2070,2119,0.0036304,0.0010186,
1,50,2070,2120,0.0039379,0.0010906,
1,51,2070,2121,0.0042708,0.0011604,
1,52,2070,2122,0.0046082,0.0012245,
1,53,2070,2123,0.0049489,0.0012691,
1,54,2070,2124,0.0053157,0.0013204,
1,55,2070,2125,0.0057365,0.0013840,
1,56,2070,2126,0.0062406,0.0014955,
1,57,2070,2127,0.0068502,0.0016625,
1,58,2070,2128,0.0075521,0.0018854,
1,59,2070,2129,0.0083035,0.0021159,
1,60,2070,2130,0.0090849,0.0023206,
1,61,2070,2131,0.0099105,0.0025070,
1,62,2070,2132,0.0107829,0.0026790,
1,63,2070,2133,0.0116995,0.0028500,
1,64,2070,2134,0.0126957,0.0030515,
1,65,2070,2135,0.0138071,0.0032862,
1,66,2070,2136,0.0150054,0.0035405,
1,67,2070,2137,0.0162315,0.0037465,
1,68,2070,2138,0.0174919,0.0039016,
1,69,2070,2139,0.0188954,0.0040837,
1,70,2070,2140,0.0205786,0.0043630,
1,71,2070,2141,0.0226142,0.0048223,
1,72,2070,2142,0.0250119,0.0055007,
1,73,2070,2143,0.0277519,0.0063971,
1,74,2070,2144,0.0307579,0.0074750,
1,75,2070,2145,0.0339099,0.0085948,
1,76,2070,2146,0.0371478,0.0096553,
1,77,2070,2147,0.0405123,0.0106393,
1,78,2070,2148,0.0440886,0.0115902,
1,79,2070,2149,0.0480027,0.0125989,
1,80,2070,2150,0.0536037,0.0152032,
1,0,2071,2071,0.0091933,0.0007593,
1,1,2071,2072,0.0006668,0.0000190,
1,2,2071,2073,0.0003367,0.0000115,
1,3,2071,2074,0.0002291,0.0000083,
1,4,2071,2075,0.0001930,0.0000077,
1,5,2071,2076,0.0001870,0.0000092,
1,6,2071,2077,0.0001837,0.0000107,
1,7,2071,2078,0.0001828,0.0000124,
1,8,2071,2079,0.0001845,0.0000144,
1,9,2071,2080,0.0001904,0.0000172,
1,10,2071,2081,0.0002017,0.0000215,
1,11,2071,2082,0.0002200,0.0000277,
1,12,2071,2083,0.0002484,0.0000369,
1,13,2071,2084,0.0002934,0.0000527,
1,14,2071,2085,0.0003624,0.0000817,
1,15,2071,2086,0.0004596,0.0001306,
1,16,2071,2087,0.0005802,0.0001989,
1,17,2071,2088,0.0007098,0.0002745,
1,18,2071,2089,0.0008321,0.0003461,
1,19,2071,2090,0.0009391,0.0004062,
1,20,2071,2091,0.0010297,0.0004531,
1,21,2071,2092,0.0011033,0.0004855,
1,22,2071,2093,0.0011584,0.0005061,
1,23,2071,2094,0.0011978,0.0005243,
1,24,2071,2095,0.0012275,0.0005397,
1,25,2071,2096,0.0012521,0.0005410,
1,26,2071,2097,0.0012759,0.0005381,
1,27,2071,2098,0.0013058,0.0005427,
1,28,2071,2099,0.0013446,0.0005669,
1,29,2071,2100,0.0013859,0.0005847,
1,30,2071,2101,0.0014216,0.0005832,
1,31,2071,2102,0.0014530,0.0005774,
1,32,2071,2103,0.0014859,0.0005733,
1,33,2071,2104,0.0015203,0.0005619,
1,34,2071,2105,0.0015540,0.0005391,
1,35,2071,2106,0.0015941,0.0005093,
1,36,2071,2107,0.0016525,0.0004943,
1,37,2071,2108,0.0017318,0.0004917,
1,38,2071,2109,0.0018255,0.0005083,
1,39,2071,2110,0.0019305,0.0005406,
1,40,2071,2111,0.0020513,0.0005854,
1,41,2071,2112,0.0021897,0.0006418,
1,42,2071,2113,0.0023342,0.0007000,
1,43,2071,2114,0.0024669,0.0007449,
1,44,2071,2115,0.0025867,0.0007687,
1,45,2071,2116,0.0027191,0.0007725,
1,46,2071,2117,0.0028925,0.0008007,
1,47,2071,2118,0.0031101,0.0008531,
1,48,2071,2119,0.0033571,0.0009272,
1,49,2071,2120,0.0036304,0.0010059,
1,50,2071,2121,0.0039379,0.0010766,
1,51,2071,2122,0.0042708,0.0011463,
1,52,2071,2123,0.0046082,0.0012106,
1,53,2071,2124,0.0049489,0.0012541,
1,54,2071,2125,0.0053157,0.0013031,
1,55,2071,2126,0.0057365,0.0013653,
1,56,2071,2127,0.0062406,0.0014765,
1,57,2071,2128,0.0068502,0.0016433,
1,58,2071,2129,0.0075521,0.0018638,
1,59,2071,2130,0.0083035,0.0020901,
1,60,2071,2131,0.0090849,0.0022919,
1,61,2071,2132,0.0099105,0.0024778,
1,62,2071,2133,0.0107829,0.0026499,
1,63,2071,2134,0.0116995,0.0028178,
1,64,2071,2135,0.0126957,0.0030138,
1,65,2071,2136,0.0138071,0.0032447,
1,66,2071,2137,0.0150054,0.0034985,
1,67,2071,2138,0.0162315,0.0037052,
1,68,2071,2139,0.0174919,0.0038570,
1,69,2071,2140,0.0188954,0.0040322,
1,70,2071,2141,0.0205786,0.0043064,
1,71,2071,2142,0.0226142,0.0047641,
1,72,2071,2143,0.0250119,0.0054409,
1,73,2071,2144,0.0277519,0.0063286,
1,74,2071,2145,0.0307579,0.0073917,
1,75,2071,2146,0.0339099,0.0085003,
1,76,2071,2147,0.0371478,0.0095579,
1,77,2071,2148,0.0405123,0.0105411,
1,78,2071,2149,0.0440886,0.0114810,
1,79,2071,2150,0.0480027,0.0124702,
1,0,2072,2072,0.0091933,0.0007269,
1,1,2072,2073,0.0006668,0.0000180,
1,2,2072,2074,0.0003367,0.0000109,
1,3,2072,2075,0.0002291,0.0000078,
1,4,2072,2076,0.0001930,0.0000073,
1,5,2072,2077,0.0001870,0.0000088,
1,6,2072,2078,0.0001837,0.0000102,
1,7,2072,2079,0.0001828,0.0000120,
1,8,2072,2080,0.0001845,0.0000138,
1,9,2072,2081,0.0001904,0.0000166,
1,10,2072,2082,0.0002017,0.0000208,
1,11,2072,2083,0.0002200,0.0000270,
1,12,2072,2084,0.0002484,0.0000360,
1,13,2072,2085,0.0002934,0.0000514,
1,14,2072,2086,0.0003624,0.0000799,
1,15,2072,2087,0.0004596,0.0001284,
1,16,2072,2088,0.0005802,0.0001963,
1,17,2072,2089,0.0007098,0.0002712,
1,18,2072,2090,0.0008321,0.0003420,
1,19,2072,2091,0.0009391,0.0004015,
1,20,2072,2092,0.0010297,0.0004484,
1,21,2072,2093,0.0011033,0.0004808,
1,22,2072,2094,0.0011584,0.0005011,
1,23,2072,2095,0.0011978,0.0005187,
1,24,2072,2096,0.0012275,0.0005339,
1,25,2072,2097,0.0012521,0.0005355,
1,26,2072,2098,0.0012759,0.0005330,
1,27,2072,2099,0.0013058,0.0005374,
1,28,2072,2100,0.0013446,0.0005611,
1,29,2072,2101,0.0013859,0.0005786,
1,30,2072,2102,0.0014216,0.0005774,
1,31,2072,2103,0.0014530,0.0005719,
1,32,2072,2104,0.0014859,0.0005675,
1,33,2072,2105,0.0015203,0.0005556,
1,34,2072,2106,0.0015540,0.0005326,
1,35,2072,2107,0.0015941,0.0005030,
1,36,2072,2108,0.0016525,0.0004884,
1,37,2072,2109,0.0017318,0.0004855,
1,38,2072,2110,0.0018255,0.0005012,
1,39,2072,2111,0.0019305,0.0005331,
1,40,2072,2112,0.0020513,0.0005779,
1,41,2072,2113,0.0021897,0.0006344,
1,42,2072,2114,0.0023342,0.0006920,
1,43,2072,2115,0.0024669,0.0007358,
1,44,2072,2116,0.0025867,0.0007591,
1,45,2072,2117,0.0027191,0.0007631,
1,46,2072,2118,0.0028925,0.0007916,
1,47,2072,2119,0.0031101,0.0008431,
1,48,2072,2120,0.0033571,0.0009155,
1,49,2072,2121,0.0036304,0.0009931,
1,50,2072,2122,0.0039379,0.0010637,
1,51,2072,2123,0.0042708,0.0011334,
1,52,2072,2124,0.0046082,0.0011966,
1,53,2072,2125,0.0049489,0.0012380,
1,54,2072,2126,0.0053157,0.0012857,
1,55,2072,2127,0.0057365,0.0013479,
1,56,2072,2128,0.0062406,0.0014592,
1,57,2072,2129,0.0068502,0.0016239,
1,58,2072,2130,0.0075521,0.0018406,
1,59,2072,2131,0.0083035,0.0020640,
1,60,2072,2132,0.0090849,0.0022652,
1,61,2072,2133,0.0099105,0.0024510,
1,62,2072,2134,0.0107829,0.0026201,
1,63,2072,2135,0.0116995,0.0027831,
1,64,2072,2136,0.0126957,0.0029757,
1,65,2072,2137,0.0138071,0.0032062,
1,66,2072,2138,0.0150054,0.0034602,
1,67,2072,2139,0.0162315,0.0036635,
1,68,2072,2140,0.0174919,0.0038090,
1,69,2072,2141,0.0188954,0.0039802,
1,70,2072,2142,0.0205786,0.0042538,
1,71,2072,2143,0.0226142,0.0047109,
1,72,2072,2144,0.0250119,0.0053805,
1,73,2072,2145,0.0277519,0.0062550,
1,74,2072,2146,0.0307579,0.0073074,
1,75,2072,2147,0.0339099,0.0084123,
1,76,2072,2148,0.0371478,0.0094683,
1,77,2072,2149,0.0405123,0.0104410,
1,78,2072,2150,0.0440886,0.0113631,
1,0,2073,2073,0.0091933,0.0006983,
1,1,2073,2074,0.0006668,0.0000170,
1,2,2073,2075,0.0003367,0.0000103,
1,3,2073,2076,0.0002291,0.0000074,
1,4,2073,2077,0.0001930,0.0000070,
1,5,2073,2078,0.0001870,0.0000084,
1,6,2073,2079,0.0001837,0.0000098,
1,7,2073,2080,0.0001828,0.0000114,
1,8,2073,2081,0.0001845,0.0000133,
1,9,2073,2082,0.0001904,0.0000160,
1,10,2073,2083,0.0002017,0.0000202,
1,11,2073,2084,0.0002200,0.0000262,
1,12,2073,2085,0.0002484,0.0000350,
1,13,2073,2086,0.0002934,0.0000501,
1,14,2073,2087,0.0003624,0.0000783,
1,15,2073,2088,0.0004596,0.0001263,
1,16,2073,2089,0.0005802,0.0001936,
1,17,2073,2090,0.0007098,0.0002677,
1,18,2073,2091,0.0008321,0.0003378,
1,19,2073,2092,0.0009391,0.0003971,
1,20,2073,2093,0.0010297,0.0004440,
1,21,2073,2094,0.0011033,0.0004761,
1,22,2073,2095,0.0011584,0.0004958,
1,23,2073,2096,0.0011978,0.0005131,
1,24,2073,2097,0.0012275,0.0005286,
1,25,2073,2098,0.0012521,0.0005305,
1,26,2073,2099,0.0012759,0.0005279,
1,27,2073,2100,0.0013058,0.0005317,
1,28,2073,2101,0.0013446,0.0005552,
1,29,2073,2102,0.0013859,0.0005729,
1,30,2073,2103,0.0014216,0.0005720,
1,31,2073,2104,0.0014530,0.0005663,
1,32,2073,2105,0.0014859,0.0005613,
1,33,2073,2106,0.0015203,0.0005491,
1,34,2073,2107,0.0015540,0.0005265,
1,35,2073,2108,0.0015941,0.0004973,
1,36,2073,2109,0.0016525,0.0004824,
1,37,2073,2110,0.0017318,0.0004788,
1,38,2073,2111,0.0018255,0.0004941,
1,39,2073,2112,0.0019305,0.0005261,
1,40,2073,2113,0.0020513,0.0005710,
1,41,2073,2114,0.0021897,0.0006270,
1,42,2073,2115,0.0023342,0.0006835,
1,43,2073,2116,0.0024669,0.0007267,
1,44,2073,2117,0.0025867,0.0007502,
1,45,2073,2118,0.0027191,0.0007545,
1,46,2073,2119,0.0028925,0.0007823,
1,47,2073,2120,0.0031101,0.0008323,
1,48,2073,2121,0.0033571,0.0009037,
1,49,2073,2122,0.0036304,0.0009811,
1,50,2073,2123,0.0039379,0.0010518,
1,51,2073,2124,0.0042708,0.0011204,
1,52,2073,2125,0.0046082,0.0011814,
1,53,2073,2126,0.0049489,0.0012216,
1,54,2073,2127,0.0053157,0.0012695,
1,55,2073,2128,0.0057365,0.0013320,
1,56,2073,2129,0.0062406,0.0014417,
1,57,2073,2130,0.0068502,0.0016031,
1,58,2073,2131,0.0075521,0.0018171,
1,59,2073,2132,0.0083035,0.0020398,
1,60,2073,2133,0.0090849,0.0022407,
1,61,2073,2134,0.0099105,0.0024236,
1,62,2073,2135,0.0107829,0.0025880,
1,63,2073,2136,0.0116995,0.0027480,
1,64,2073,2137,0.0126957,0.0029403,
1,65,2073,2138,0.0138071,0.0031709,
1,66,2073,2139,0.0150054,0.0034215,
1,67,2073,2140,0.0162315,0.0036186,
1,68,2073,2141,0.0174919,0.0037605,
1,69,2073,2142,0.0188954,0.0039318,
1,70,2073,2143,0.0205786,0.0042058,
1,71,2073,2144,0.0226142,0.0046571,
1,72,2073,2145,0.0250119,0.0053155,
1,73,2073,2146,0.0277519,0.0061805,
1,74,2073,2147,0.0307579,0.0072288,
1,75,2073,2148,0.0339099,0.0083314,
1,76,2073,2149,0.0371478,0.0093772,
1,77,2073,2150,0.0405123,0.0103331,
1,0,2074,2074,0.0091933,0.0006705,
1,1,2074,2075,0.0006668,0.0000160,
1,2,2074,2076,0.0003367,0.0000097,
1,3,2074,2077,0.0002291,0.0000070,
1,4,2074,2078,0.0001930,0.0000066,
1,5,2074,2079,0.0001870,0.0000081,
1,6,2074,2080,0.0001837,0.0000094,
1,7,2074,2081,0.0001828,0.0000110,
1,8,2074,2082,0.0001845,0.0000128,
1,9,2074,2083,0.0001904,0.0000154,
1,10,2074,2084,0.0002017,0.0000196,
1,11,2074,2085,0.0002200,0.0000254,
1,12,2074,2086,0.0002484,0.0000340,
1,13,2074,2087,0.0002934,0.0000489,
1,14,2074,2088,0.0003624,0.0000768,
1,15,2074,2089,0.0004596,0.0001243,
1,16,2074,2090,0.0005802,0.0001907,
1,17,2074,2091,0.0007098,0.0002641,
1,18,2074,2092,0.0008321,0.0003339,
1,19,2074,2093,0.0009391,0.0003931,
1,20,2074,2094,0.0010297,0.0004396,
1,21,2074,2095,0.0011033,0.0004710,
1,22,2074,2096,0.0011584,0.0004903,
1,23,2074,2097,0.0011978,0.0005079,
1,24,2074,2098,0.0012275,0.0005237,
1,25,2074,2099,0.0012521,0.0005255,
1,26,2074,2100,0.0012759,0.0005223,
1,27,2074,2101,0.0013058,0.0005259,
1,28,2074,2102,0.0013446,0.0005497,
1,29,2074,2103,0.0013859,0.0005677,
1,30,2074,2104,0.0014216,0.0005665,
1,31,2074,2105,0.0014530,0.0005602,
1,32,2074,2106,0.0014859,0.0005550,
1,33,2074,2107,0.0015203,0.0005431,
1,34,2074,2108,0.0015540,0.0005208,
1,35,2074,2109,0.0015941,0.0004915,
1,36,2074,2110,0.0016525,0.0004760,
1,37,2074,2111,0.0017318,0.0004721,
1,38,2074,2112,0.0018255,0.0004875,
1,39,2074,2113,0.0019305,0.0005197,
1,40,2074,2114,0.0020513,0.0005642,
1,41,2074,2115,0.0021897,0.0006190,
1,42,2074,2116,0.0023342,0.0006748,
1,43,2074,2117,0.0024669,0.0007181,
1,44,2074,2118,0.0025867,0.0007419,
1,45,2074,2119,0.0027191,0.0007457,
1,46,2074,2120,0.0028925,0.0007723,
1,47,2074,2121,0.0031101,0.0008214,
1,48,2074,2122,0.0033571,0.0008927,
1,49,2074,2123,0.0036304,0.0009702,
1,50,2074,2124,0.0039379,0.0010397,
1,51,2074,2125,0.0042708,0.0011063,
1,52,2074,2126,0.0046082,0.0011661,
1,53,2074,2127,0.0049489,0.0012065,
1,54,2074,2128,0.0053157,0.0012547,
1,55,2074,2129,0.0057365,0.0013159,
1,56,2074,2130,0.0062406,0.0014229,
1,57,2074,2131,0.0068502,0.0015821,
1,58,2074,2132,0.0075521,0.0017952,
1,59,2074,2133,0.0083035,0.0020174,
1,60,2074,2134,0.0090849,0.0022156,
1,61,2074,2135,0.0099105,0.0023941,
1,62,2074,2136,0.0107829,0.0025556,
1,63,2074,2137,0.0116995,0.0027153,
1,64,2074,2138,0.0126957,0.0029079,
1,65,2074,2139,0.0138071,0.0031354,
1,66,2074,2140,0.0150054,0.0033799,
1,67,2074,2141,0.0162315,0.0035732,
1,68,2074,2142,0.0174919,0.0037154,
1,69,2074,2143,0.0188954,0.0038875,
1,70,2074,2144,0.0205786,0.0041572,
1,71,2074,2145,0.0226142,0.0045992,
1,72,2074,2146,0.0250119,0.0052497,
1,73,2074,2147,0.0277519,0.0061112,
1,74,2074,2148,0.0307579,0.0071567,
1,75,2074,2149,0.0339099,0.0082491,
1,76,2074,2150,0.0371478,0.0092788,
1,0,2075,2075,0.0091933,0.0006416,
1,1,2075,2076,0.0006668,0.0000150,
1,2,2075,2077,0.0003367,0.0000092,
1,3,2075,2078,0.0002291,0.0000066,
1,4,2075,2079,0.0001930,0.0000063,
1,5,2075,2080,0.0001870,0.0000077,
1,6,2075,2081,0.0001837,0.0000089,
1,7,2075,2082,0.0001828,0.0000105,
1,8,2075,2083,0.0001845,0.0000123,
1,9,2075,2084,0.0001904,0.0000149,
1,10,2075,2085,0.0002017,0.0000189,
1,11,2075,2086,0.0002200,0.0000246,
1,12,2075,2087,0.0002484,0.0000331,
1,13,2075,2088,0.0002934,0.0000479,
1,14,2075,2089,0.0003624,0.0000753,
1,15,2075,2090,0.0004596,0.0001221,
1,16,2075,2091,0.0005802,0.0001878,
1,17,2075,2092,0.0007098,0.0002608,
1,18,2075,2093,0.0008321,0.0003303,
1,19,2075,2094,0.0009391,0.0003891,
1,20,2075,2095,0.0010297,0.0004348,
1,21,2075,2096,0.0011033,0.0004658,
1,22,2075,2097,0.0011584,0.0004853,
1,23,2075,2098,0.0011978,0.0005031,
1,24,2075,2099,0.0012275,0.0005187,
1,25,2075,2100,0.0012521,0.0005200,
1,26,2075,2101,0.0012759,0.0005167,
1,27,2075,2102,0.0013058,0.0005205,
1,28,2075,2103,0.0013446,0.0005446,
1,29,2075,2104,0.0013859,0.0005623,
1,30,2075,2105,0.0014216,0.0005606,
1,31,2075,2106,0.0014530,0.0005541,
1,32,2075,2107,0.0014859,0.0005491,
1,33,2075,2108,0.0015203,0.0005376,
1,34,2075,2109,0.0015540,0.0005151,
1,35,2075,2110,0.0015941,0.0004853,
1,36,2075,2111,0.0016525,0.0004695,
1,37,2075,2112,0.0017318,0.0004658,
1,38,2075,2113,0.0018255,0.0004815,
1,39,2075,2114,0.0019305,0.0005133,
1,40,2075,2115,0.0020513,0.0005568,
1,41,2075,2116,0.0021897,0.0006110,
1,42,2075,2117,0.0023342,0.0006668,
1,43,2075,2118,0.0024669,0.0007103,
1,44,2075,2119,0.0025867,0.0007335,
1,45,2075,2120,0.0027191,0.0007363,
1,46,2075,2121,0.0028925,0.0007621,
1,47,2075,2122,0.0031101,0.0008112,
1,48,2075,2123,0.0033571,0.0008826,
1,49,2075,2124,0.0036304,0.0009590,
1,50,2075,2125,0.0039379,0.0010267,
1,51,2075,2126,0.0042708,0.0010921,
1,52,2075,2127,0.0046082,0.0011519,
1,53,2075,2128,0.0049489,0.0011926,
1,54,2075,2129,0.0053157,0.0012397,
1,55,2075,2130,0.0057365,0.0012986,
1,56,2075,2131,0.0062406,0.0014039,
1,57,2075,2132,0.0068502,0.0015625,
1,58,2075,2133,0.0075521,0.0017750,
1,59,2075,2134,0.0083035,0.0019946,
1,60,2075,2135,0.0090849,0.0021885,
1,61,2075,2136,0.0099105,0.0023642,
1,62,2075,2137,0.0107829,0.0025254,
1,63,2075,2138,0.0116995,0.0026855,
1,64,2075,2139,0.0126957,0.0028753,
1,65,2075,2140,0.0138071,0.0030971,
1,66,2075,2141,0.0150054,0.0033378,
1,67,2075,2142,0.0162315,0.0035310,
1,68,2075,2143,0.0174919,0.0036741,
1,69,2075,2144,0.0188954,0.0038428,
1,70,2075,2145,0.0205786,0.0041049,
1,71,2075,2146,0.0226142,0.0045407,
1,72,2075,2147,0.0250119,0.0051885,
1,73,2075,2148,0.0277519,0.0060475,
1,74,2075,2149,0.0307579,0.0070833,
1,75,2075,2150,0.0339099,0.0081603,
1,0,2076,2076,0.0091933,0.0006133,
1,1,2076,2077,0.0006668,0.0000141,
1,2,2076,2078,0.0003367,0.0000087,
1,3,2076,2079,0.0002291,0.0000063,
1,4,2076,2080,0.0001930,0.0000060,
1,5,2076,2081,0.0001870,0.0000073,
1,6,2076,2082,0.0001837,0.0000085,
1,7,2076,2083,0.0001828,0.0000101,
1,8,2076,2084,0.0001845,0.0000119,
1,9,2076,2085,0.0001904,0.0000144,
1,10,2076,2086,0.0002017,0.0000183,
1,11,2076,2087,0.0002200,0.0000239,
1,12,2076,2088,0.0002484,0.0000322,
1,13,2076,2089,0.0002934,0.0000468,
1,14,2076,2090,0.0003624,0.0000737,
1,15,2076,2091,0.0004596,0.0001198,
1,16,2076,2092,0.0005802,0.0001851,
1,17,2076,2093,0.0007098,0.0002577,
1,18,2076,2094,0.0008321,0.0003267,
1,19,2076,2095,0.0009391,0.0003847,
1,20,2076,2096,0.0010297,0.0004299,
1,21,2076,2097,0.0011033,0.0004610,
1,22,2076,2098,0.0011584,0.0004806,
1,23,2076,2099,0.0011978,0.0004983,
1,24,2076,2100,0.0012275,0.0005134,
1,25,2076,2101,0.0012521,0.0005145,
1,26,2076,2102,0.0012759,0.0005114,
1,27,2076,2103,0.0013058,0.0005156,
1,28,2076,2104,0.0013446,0.0005394,
1,29,2076,2105,0.0013859,0.0005566,
1,30,2076,2106,0.0014216,0.0005546,
1,31,2076,2107,0.0014530,0.0005484,
1,32,2076,2108,0.0014859,0.0005438,
1,33,2076,2109,0.0015203,0.0005320,
1,34,2076,2110,0.0015540,0.0005090,
1,35,2076,2111,0.0015941,0.0004789,
1,36,2076,2112,0.0016525,0.0004635,
1,37,2076,2113,0.0017318,0.0004601,
1,38,2076,2114,0.0018255,0.0004755,
1,39,2076,2115,0.0019305,0.0005063,
1,40,2076,2116,0.0020513,0.0005493,
1,41,2076,2117,0.0021897,0.0006035,
1,42,2076,2118,0.0023342,0.0006594,
1,43,2076,2119,0.0024669,0.0007023,
1,44,2076,2120,0.0025867,0.0007245,
1,45,2076,2121,0.0027191,0.0007267,
1,46,2076,2122,0.0028925,0.0007527,
1,47,2076,2123,0.0031101,0.0008019,
1,48,2076,2124,0.0033571,0.0008724,
1,49,2076,2125,0.0036304,0.0009471,
1,50,2076,2126,0.0039379,0.0010136,
1,51,2076,2127,0.0042708,0.0010789,
1,52,2076,2128,0.0046082,0.0011389,
1,53,2076,2129,0.0049489,0.0011786,
1,54,2076,2130,0.0053157,0.0012236,
1,55,2076,2131,0.0057365,0.0012812,
1,56,2076,2132,0.0062406,0.0013862,
1,57,2076,2133,0.0068502,0.0015445,
1,58,2076,2134,0.0075521,0.0017545,
1,59,2076,2135,0.0083035,0.0019700,
1,60,2076,2136,0.0090849,0.0021611,
1,61,2076,2137,0.0099105,0.0023364,
1,62,2076,2138,0.0107829,0.0024978,
1,63,2076,2139,0.0116995,0.0026554,
1,64,2076,2140,0.0126957,0.0028402,
1,65,2076,2141,0.0138071,0.0030585,
1,66,2076,2142,0.0150054,0.0032986,
1,67,2076,2143,0.0162315,0.0034924,
1,68,2076,2144,0.0174919,0.0036324,
1,69,2076,2145,0.0188954,0.0037947,
1,70,2076,2146,0.0205786,0.0040521,
1,71,2076,2147,0.0226142,0.0044863,
1,72,2076,2148,0.0250119,0.0051323,
1,73,2076,2149,0.0277519,0.0059827,
1,74,2076,2150,0.0307579,0.0070041,
1,0,2077,2077,0.0091933,0.0005877,
1,1,2077,2078,0.0006668,0.0000134,
1,2,2077,2079,0.0003367,0.0000083,
1,3,2077,2080,0.0002291,0.0000060,
1,4,2077,2081,0.0001930,0.0000057,
1,5,2077,2082,0.0001870,0.0000069,
1,6,2077,2083,0.0001837,0.0000082,
1,7,2077,2084,0.0001828,0.0000097,
1,8,2077,2085,0.0001845,0.0000114,
1,9,2077,2086,0.0001904,0.0000138,
1,10,2077,2087,0.0002017,0.0000177,
1,11,2077,2088,0.0002200,0.0000232,
1,12,2077,2089,0.0002484,0.0000314,
1,13,2077,2090,0.0002934,0.0000456,
1,14,2077,2091,0.0003624,0.0000721,
1,15,2077,2092,0.0004596,0.0001178,
1,16,2077,2093,0.0005802,0.0001826,
1,17,2077,2094,0.0007098,0.0002546,
1,18,2077,2095,0.0008321,0.0003228,
1,19,2077,2096,0.0009391,0.0003803,
1,20,2077,2097,0.0010297,0.0004254,
1,21,2077,2098,0.0011033,0.0004566,
1,22,2077,2099,0.0011584,0.0004759,
1,23,2077,2100,0.0011978,0.0004931,
1,24,2077,2101,0.0012275,0.0005080,
1,25,2077,2102,0.0012521,0.0005093,
1,26,2077,2103,0.0012759,0.0005066,
1,27,2077,2104,0.0013058,0.0005105,
1,28,2077,2105,0.0013446,0.0005338,
1,29,2077,2106,0.0013859,0.0005507,
1,30,2077,2107,0.0014216,0.0005490,
1,31,2077,2108,0.0014530,0.0005431,
1,32,2077,2109,0.0014859,0.0005383,
1,33,2077,2110,0.0015203,0.0005260,
1,34,2077,2111,0.0015540,0.0005027,
1,35,2077,2112,0.0015941,0.0004730,
1,36,2077,2113,0.0016525,0.0004580,
1,37,2077,2114,0.0017318,0.0004544,
1,38,2077,2115,0.0018255,0.0004690,
1,39,2077,2116,0.0019305,0.0004994,
1,40,2077,2117,0.0020513,0.0005423,
1,41,2077,2118,0.0021897,0.0005966,
1,42,2077,2119,0.0023342,0.0006518,
1,43,2077,2120,0.0024669,0.0006936,
1,44,2077,2121,0.0025867,0.0007153,
1,45,2077,2122,0.0027191,0.0007178,
1,46,2077,2123,0.0028925,0.0007440,
1,47,2077,2124,0.0031101,0.0007925,
1,48,2077,2125,0.0033571,0.0008613,
1,49,2077,2126,0.0036304,0.0009350,
1,50,2077,2127,0.0039379,0.0010014,
1,51,2077,2128,0.0042708,0.0010668,
1,52,2077,2129,0.0046082,0.0011257,
1,53,2077,2130,0.0049489,0.0011635,
1,54,2077,2131,0.0053157,0.0012074,
1,55,2077,2132,0.0057365,0.0012650,
1,56,2077,2133,0.0062406,0.0013699,
1,57,2077,2134,0.0068502,0.0015261,
1,58,2077,2135,0.0075521,0.0017323,
1,59,2077,2136,0.0083035,0.0019451,
1,60,2077,2137,0.0090849,0.0021357,
1,61,2077,2138,0.0099105,0.0023110,
1,62,2077,2139,0.0107829,0.0024700,
1,63,2077,2140,0.0116995,0.0026230,
1,64,2077,2141,0.0126957,0.0028047,
1,65,2077,2142,0.0138071,0.0030225,
1,66,2077,2143,0.0150054,0.0032628,
1,67,2077,2144,0.0162315,0.0034534,
1,68,2077,2145,0.0174919,0.0035876,
1,69,2077,2146,0.0188954,0.0037461,
1,70,2077,2147,0.0205786,0.0040030,
1,71,2077,2148,0.0226142,0.0044364,
1,72,2077,2149,0.0250119,0.0050752,
1,73,2077,2150,0.0277519,0.0059128,
1,0,2078,2078,0.0091933,0.0005649,
1,1,2078,2079,0.0006668,0.0000126,
1,2,2078,2080,0.0003367,0.0000078,
1,3,2078,2081,0.0002291,0.0000056,
1,4,2078,2082,0.0001930,0.0000054,
1,5,2078,2083,0.0001870,0.0000066,
1,6,2078,2084,0.0001837,0.0000079,
1,7,2078,2085,0.0001828,0.0000093,
1,8,2078,2086,0.0001845,0.0000110,
1,9,2078,2087,0.0001904,0.0000134,
1,10,2078,2088,0.0002017,0.0000171,
1,11,2078,2089,0.0002200,0.0000226,
1,12,2078,2090,0.0002484,0.0000305,
1,13,2078,2091,0.0002934,0.0000444,
1,14,2078,2092,0.0003624,0.0000706,
1,15,2078,2093,0.0004596,0.0001159,
1,16,2078,2094,0.0005802,0.0001801,
1,17,2078,2095,0.0007098,0.0002513,
1,18,2078,2096,0.0008321,0.0003189,
1,19,2078,2097,0.0009391,0.0003761,
1,20,2078,2098,0.0010297,0.0004213,
1,21,2078,2099,0.0011033,0.0004521,
1,22,2078,2100,0.0011584,0.0004709,
1,23,2078,2101,0.0011978,0.0004878,
1,24,2078,2102,0.0012275,0.0005030,
1,25,2078,2103,0.0012521,0.0005046,
1,26,2078,2104,0.0012759,0.0005017,
1,27,2078,2105,0.0013058,0.0005051,
1,28,2078,2106,0.0013446,0.0005281,
1,29,2078,2107,0.0013859,0.0005453,
1,30,2078,2108,0.0014216,0.0005438,
1,31,2078,2109,0.0014530,0.0005377,
1,32,2078,2110,0.0014859,0.0005323,
1,33,2078,2111,0.0015203,0.0005198,
1,34,2078,2112,0.0015540,0.0004969,
1,35,2078,2113,0.0015941,0.0004677,
1,36,2078,2114,0.0016525,0.0004524,
1,37,2078,2115,0.0017318,0.0004482,
1,38,2078,2116,0.0018255,0.0004624,
1,39,2078,2117,0.0019305,0.0004929,
1,40,2078,2118,0.0020513,0.0005359,
1,41,2078,2119,0.0021897,0.0005895,
1,42,2078,2120,0.0023342,0.0006437,
1,43,2078,2121,0.0024669,0.0006849,
1,44,2078,2122,0.0025867,0.0007067,
1,45,2078,2123,0.0027191,0.0007097,
1,46,2078,2124,0.0028925,0.0007353,
1,47,2078,2125,0.0031101,0.0007823,
1,48,2078,2126,0.0033571,0.0008502,
1,49,2078,2127,0.0036304,0.0009237,
1,50,2078,2128,0.0039379,0.0009902,
1,51,2078,2129,0.0042708,0.0010546,
1,52,2078,2130,0.0046082,0.0011116,
1,53,2078,2131,0.0049489,0.0011483,
1,54,2078,2132,0.0053157,0.0011923,
1,55,2078,2133,0.0057365,0.0012501,
1,56,2078,2134,0.0062406,0.0013533,
1,57,2078,2135,0.0068502,0.0015062,
1,58,2078,2136,0.0075521,0.0017099,
1,59,2078,2137,0.0083035,0.0019219,
1,60,2078,2138,0.0090849,0.0021124,
1,61,2078,2139,0.0099105,0.0022853,
1,62,2078,2140,0.0107829,0.0024400,
1,63,2078,2141,0.0116995,0.0025902,
1,64,2078,2142,0.0126957,0.0027716,
1,65,2078,2143,0.0138071,0.0029896,
1,66,2078,2144,0.0150054,0.0032266,
1,67,2078,2145,0.0162315,0.0034114,
1,68,2078,2146,0.0174919,0.0035422,
1,69,2078,2147,0.0188954,0.0037009,
1,70,2078,2148,0.0205786,0.0039579,
1,71,2078,2149,0.0226142,0.0043856,
1,72,2078,2150,0.0250119,0.0050137,
1,0,2079,2079,0.0091933,0.0005421,
1,1,2079,2080,0.0006668,0.0000118,
1,2,2079,2081,0.0003367,0.0000073,
1,3,2079,2082,0.0002291,0.0000053,
1,4,2079,2083,0.0001930,0.0000051,
1,5,2079,2084,0.0001870,0.0000063,
1,6,2079,2085,0.0001837,0.0000075,
1,7,2079,2086,0.0001828,0.0000089,
1,8,2079,2087,0.0001845,0.0000105,
1,9,2079,2088,0.0001904,0.0000129,
1,10,2079,2089,0.0002017,0.0000166,
1,11,2079,2090,0.0002200,0.0000219,
1,12,2079,2091,0.0002484,0.0000297,
1,13,2079,2092,0.0002934,0.0000434,
1,14,2079,2093,0.0003624,0.0000693,
1,15,2079,2094,0.0004596,0.0001140,
1,16,2079,2095,0.0005802,0.0001774,
1,17,2079,2096,0.0007098,0.0002479,
1,18,2079,2097,0.0008321,0.0003152,
1,19,2079,2098,0.0009391,0.0003724,
1,20,2079,2099,0.0010297,0.0004171,
1,21,2079,2100,0.0011033,0.0004473,
1,22,2079,2101,0.0011584,0.0004658,
1,23,2079,2102,0.0011978,0.0004828,
1,24,2079,2103,0.0012275,0.0004983,
1,25,2079,2104,0.0012521,0.0004998,
1,26,2079,2105,0.0012759,0.0004963,
1,27,2079,2106,0.0013058,0.0004996,
1,28,2079,2107,0.0013446,0.0005228,
1,29,2079,2108,0.0013859,0.0005403,
1,30,2079,2109,0.0014216,0.0005386,
1,31,2079,2110,0.0014530,0.0005319,
1,32,2079,2111,0.0014859,0.0005263,
1,33,2079,2112,0.0015203,0.0005141,
1,34,2079,2113,0.0015540,0.0004916,
1,35,2079,2114,0.0015941,0.0004623,
1,36,2079,2115,0.0016525,0.0004465,
1,37,2079,2116,0.0017318,0.0004419,
1,38,2079,2117,0.0018255,0.0004563,
1,39,2079,2118,0.0019305,0.0004869,
1,40,2079,2119,0.0020513,0.0005294,
1,41,2079,2120,0.0021897,0.0005819,
1,42,2079,2121,0.0023342,0.0006354,
1,43,2079,2122,0.0024669,0.0006767,
1,44,2079,2123,0.0025867,0.0006989,
1,45,2079,2124,0.0027191,0.0007014,
1,46,2079,2125,0.0028925,0.0007258,
1,47,2079,2126,0.0031101,0.0007720,
1,48,2079,2127,0.0033571,0.0008398,
1,49,2079,2128,0.0036304,0.0009134,
1,50,2079,2129,0.0039379,0.0009789,
1,51,2079,2130,0.0042708,0.0010414,
1,52,2079,2131,0.0046082,0.0010973,
1,53,2079,2132,0.0049489,0.0011341,
1,54,2079,2133,0.0053157,0.0011784,
1,55,2079,2134,0.0057365,0.0012348,
1,56,2079,2135,0.0062406,0.0013354,
1,57,2079,2136,0.0068502,0.0014862,
1,58,2079,2137,0.0075521,0.0016891,
1,59,2079,2138,0.0083035,0.0019008,
1,60,2079,2139,0.0090849,0.0020889,
1,61,2079,2140,0.0099105,0.0022578,
1,62,2079,2141,0.0107829,0.0024098,
1,63,2079,2142,0.0116995,0.0025598,
1,64,2079,2143,0.0126957,0.0027414,
1,65,2079,2144,0.0138071,0.0029564,
1,66,2079,2145,0.0150054,0.0031877,
1,67,2079,2146,0.0162315,0.0033690,
1,68,2079,2147,0.0174919,0.0035000,
1,69,2079,2148,0.0188954,0.0036594,
1,70,2079,2149,0.0205786,0.0039121,
1,71,2079,2150,0.0226142,0.0043310,
1,0,2080,2080,0.0091933,0.0005184,
1,1,2080,2081,0.0006668,0.0000111,
1,2,2080,2082,0.0003367,0.0000069,
1,3,2080,2083,0.0002291,0.0000051,
1,4,2080,2084,0.0001930,0.0000049,
1,5,2080,2085,0.0001870,0.0000060,
1,6,2080,2086,0.0001837,0.0000072,
1,7,2080,2087,0.0001828,0.0000086,
1,8,2080,2088,0.0001845,0.0000102,
1,9,2080,2089,0.0001904,0.0000125,
1,10,2080,2090,0.0002017,0.0000161,
1,11,2080,2091,0.0002200,0.0000212,
1,12,2080,2092,0.0002484,0.0000289,
1,13,2080,2093,0.0002934,0.0000424,
1,14,2080,2094,0.0003624,0.0000679,
1,15,2080,2095,0.0004596,0.0001120,
1,16,2080,2096,0.0005802,0.0001747,
1,17,2080,2097,0.0007098,0.0002448,
1,18,2080,2098,0.0008321,0.0003118,
1,19,2080,2099,0.0009391,0.0003685,
1,20,2080,2100,0.0010297,0.0004126,
1,21,2080,2101,0.0011033,0.0004424,
1,22,2080,2102,0.0011584,0.0004610,
1,23,2080,2103,0.0011978,0.0004783,
1,24,2080,2104,0.0012275,0.0004936,
1,25,2080,2105,0.0012521,0.0004945,
1,26,2080,2106,0.0012759,0.0004909,
1,27,2080,2107,0.0013058,0.0004944,
1,28,2080,2108,0.0013446,0.0005179,
1,29,2080,2109,0.0013859,0.0005351,
1,30,2080,2110,0.0014216,0.0005329,
1,31,2080,2111,0.0014530,0.0005261,
1,32,2080,2112,0.0014859,0.0005207,
1,33,2080,2113,0.0015203,0.0005089,
1,34,2080,2114,0.0015540,0.0004863,
1,35,2080,2115,0.0015941,0.0004564,
1,36,2080,2116,0.0016525,0.0004405,
1,37,2080,2117,0.0017318,0.0004361,
1,38,2080,2118,0.0018255,0.0004507,
1,39,2080,2119,0.0019305,0.0004808,
1,40,2080,2120,0.0020513,0.0005224,
1,41,2080,2121,0.0021897,0.0005743,
1,42,2080,2122,0.0023342,0.0006277,
1,43,2080,2123,0.0024669,0.0006692,
1,44,2080,2124,0.0025867,0.0006910,
1,45,2080,2125,0.0027191,0.0006925,
1,46,2080,2126,0.0028925,0.0007163,
1,47,2080,2127,0.0031101,0.0007625,
1,48,2080,2128,0.0033571,0.0008303,
1,49,2080,2129,0.0036304,0.0009030,
1,50,2080,2130,0.0039379,0.0009668,
1,51,2080,2131,0.0042708,0.0010281,
1,52,2080,2132,0.0046082,0.0010840,
1,53,2080,2133,0.0049489,0.0011211,
1,54,2080,2134,0.0053157,0.0011642,
1,55,2080,2135,0.0057365,0.0012184,
1,56,2080,2136,0.0062406,0.0013173,
1,57,2080,2137,0.0068502,0.0014676,
1,58,2080,2138,0.0075521,0.0016701,
1,59,2080,2139,0.0083035,0.0018794,
1,60,2080,2140,0.0090849,0.0020637,
1,61,2080,2141,0.0099105,0.0022299,
1,62,2080,2142,0.0107829,0.0023816,
1,63,2080,2143,0.0116995,0.0025319,
1,64,2080,2144,0.0126957,0.0027109,
1,65,2080,2145,0.0138071,0.0029206,
1,66,2080,2146,0.0150054,0.0031483,
1,67,2080,2147,0.0162315,0.0033295,
1,68,2080,2148,0.0174919,0.0034613,
1,69,2080,2149,0.0188954,0.0036173,
1,70,2080,2150,0.0205786,0.0038628,
1,0,2081,2081,0.0091933,0.0004951,
1,1,2081,2082,0.0006668,0.0000105,
1,2,2081,2083,0.0003367,0.0000066,
1,3,2081,2084,0.0002291,0.0000048,
1,4,2081,2085,0.0001930,0.0000046,
1,5,2081,2086,0.0001870,0.0000057,
1,6,2081,2087,0.0001837,0.0000069,
1,7,2081,2088,0.0001828,0.0000082,
1,8,2081,2089,0.0001845,0.0000098,
1,9,2081,2090,0.0001904,0.0000120,
1,10,2081,2091,0.0002017,0.0000155,
1,11,2081,2092,0.0002200,0.0000206,
1,12,2081,2093,0.0002484,0.0000282,
1,13,2081,2094,0.0002934,0.0000415,
1,14,2081,2095,0.0003624,0.0000665,
1,15,2081,2096,0.0004596,0.0001100,
1,16,2081,2097,0.0005802,0.0001722,
1,17,2081,2098,0.0007098,0.0002419,
1,18,2081,2099,0.0008321,0.0003084,
1,19,2081,2100,0.0009391,0.0003644,
1,20,2081,2101,0.0010297,0.0004081,
1,21,2081,2102,0.0011033,0.0004379,
1,22,2081,2103,0.0011584,0.0004566,
1,23,2081,2104,0.0011978,0.0004737,
1,24,2081,2105,0.0012275,0.0004885,
1,25,2081,2106,0.0012521,0.0004893,
1,26,2081,2107,0.0012759,0.0004859,
1,27,2081,2108,0.0013058,0.0004897,
1,28,2081,2109,0.0013446,0.0005130,
1,29,2081,2110,0.0013859,0.0005296,
1,30,2081,2111,0.0014216,0.0005272,
1,31,2081,2112,0.0014530,0.0005206,
1,32,2081,2113,0.0014859,0.0005156,
1,33,2081,2114,0.0015203,0.0005037,
1,34,2081,2115,0.0015540,0.0004805,
1,35,2081,2116,0.0015941,0.0004506,
1,36,2081,2117,0.0016525,0.0004349,
1,37,2081,2118,0.0017318,0.0004308,
1,38,2081,2119,0.0018255,0.0004450,
1,39,2081,2120,0.0019305,0.0004743,
1,40,2081,2121,0.0020513,0.0005153,
1,41,2081,2122,0.0021897,0.0005672,
1,42,2081,2123,0.0023342,0.0006207,
1,43,2081,2124,0.0024669,0.0006617,
1,44,2081,2125,0.0025867,0.0006824,
1,45,2081,2126,0.0027191,0.0006834,
1,46,2081,2127,0.0028925,0.0007074,
1,47,2081,2128,0.0031101,0.0007538,
1,48,2081,2129,0.0033571,0.0008208,
1,49,2081,2130,0.0036304,0.0008918,
1,50,2081,2131,0.0039379,0.0009545,
1,51,2081,2132,0.0042708,0.0010158,
1,52,2081,2133,0.0046082,0.0010718,
1,53,2081,2134,0.0049489,0.0011078,
1,54,2081,2135,0.0053157,0.0011489,
1,55,2081,2136,0.0057365,0.0012019,
1,56,2081,2137,0.0062406,0.0013005,
1,57,2081,2138,0.0068502,0.0014506,
1,58,2081,2139,0.0075521,0.0016509,
1,59,2081,2140,0.0083035,0.0018565,
1,60,2081,2141,0.0090849,0.0020382,
1,61,2081,2142,0.0099105,0.0022040,
1,62,2081,2143,0.0107829,0.0023559,
1,63,2081,2144,0.0116995,0.0025038,
1,64,2081,2145,0.0126957,0.0026780,
1,65,2081,2146,0.0138071,0.0028844,
1,66,2081,2147,0.0150054,0.0031116,
1,67,2081,2148,0.0162315,0.0032932,
1,68,2081,2149,0.0174919,0.0034219,
1,69,2081,2150,0.0188954,0.0035718,
1,0,2082,2082,0.0091933,0.0004741,
1,1,2082,2083,0.0006668,0.0000099,
1,2,2082,2084,0.0003367,0.0000062,
1,3,2082,2085,0.0002291,0.0000045,
1,4,2082,2086,0.0001930,0.0000044,
1,5,2082,2087,0.0001870,0.0000055,
1,6,2082,2088,0.0001837,0.0000066,
1,7,2082,2089,0.0001828,0.0000079,
1,8,2082,2090,0.0001845,0.0000094,
1,9,2082,2091,0.0001904,0.0000116,
1,10,2082,2092,0.0002017,0.0000150,
1,11,2082,2093,0.0002200,0.0000200,
1,12,2082,2094,0.0002484,0.0000274,
1,13,2082,2095,0.0002934,0.0000404,
1,14,2082,2096,0.0003624,0.0000650,
1,15,2082,2097,0.0004596,0.0001081,
1,16,2082,2098,0.0005802,0.0001699,
1,17,2082,2099,0.0007098,0.0002391,
1,18,2082,2100,0.0008321,0.0003048,
1,19,2082,2101,0.0009391,0.0003603,
1,20,2082,2102,0.0010297,0.0004038,
1,21,2082,2103,0.0011033,0.0004337,
1,22,2082,2104,0.0011584,0.0004521,
1,23,2082,2105,0.0011978,0.0004687,
1,24,2082,2106,0.0012275,0.0004833,
1,25,2082,2107,0.0012521,0.0004843,
1,26,2082,2108,0.0012759,0.0004813,
1,27,2082,2109,0.0013058,0.0004849,
1,28,2082,2110,0.0013446,0.0005076,
1,29,2082,2111,0.0013859,0.0005240,
1,30,2082,2112,0.0014216,0.0005218,
1,31,2082,2113,0.0014530,0.0005156,
1,32,2082,2114,0.0014859,0.0005105,
1,33,2082,2115,0.0015203,0.0004980,
1,34,2082,2116,0.0015540,0.0004747,
1,35,2082,2117,0.0015941,0.0004451,
1,36,2082,2118,0.0016525,0.0004297,
1,37,2082,2119,0.0017318,0.0004254,
1,38,2082,2120,0.0018255,0.0004388,
1,39,2082,2121,0.0019305,0.0004677,
1,40,2082,2122,0.0020513,0.0005087,
1,41,2082,2123,0.0021897,0.0005606,
1,42,2082,2124,0.0023342,0.0006136,
1,43,2082,2125,0.0024669,0.0006535,
1,44,2082,2126,0.0025867,0.0006738,
1,45,2082,2127,0.0027191,0.0006751,
1,46,2082,2128,0.0028925,0.0006993,
1,47,2082,2129,0.0031101,0.0007449,
1,48,2082,2130,0.0033571,0.0008105,
1,49,2082,2131,0.0036304,0.0008805,
1,50,2082,2132,0.0039379,0.0009431,
1,51,2082,2133,0.0042708,0.0010044,
1,52,2082,2134,0.0046082,0.0010593,
1,53,2082,2135,0.0049489,0.0010934,
1,54,2082,2136,0.0053157,0.0011334,
1,55,2082,2137,0.0057365,0.0011865,
1,56,2082,2138,0.0062406,0.0012852,
1,57,2082,2139,0.0068502,0.0014335,
1,58,2082,2140,0.0075521,0.0016303,
1,59,2082,2141,0.0083035,0.0018333,
1,60,2082,2142,0.0090849,0.0020144,
1,61,2082,2143,0.0099105,0.0021803,
1,62,2082,2144,0.0107829,0.0023298,
1,63,2082,2145,0.0116995,0.0024735,
1,64,2082,2146,0.0126957,0.0026448,
1,65,2082,2147,0.0138071,0.0028507,
1,66,2082,2148,0.0150054,0.0030780,
1,67,2082,2149,0.0162315,0.0032563,
1,68,2082,2150,0.0174919,0.0033796,
1,0,2083,2083,0.0091933,0.0004555,
1,1,2083,2084,0.0006668,0.0000093,
1,2,2083,2085,0.0003367,0.0000059,
1,3,2083,2086,0.0002291,0.0000043,
1,4,2083,2087,0.0001930,0.0000041,
1,5,2083,2088,0.0001870,0.0000052,
1,6,2083,2089,0.0001837,0.0000063,
1,7,2083,2090,0.0001828,0.0000076,
1,8,2083,2091,0.0001845,0.0000090,
1,9,2083,2092,0.0001904,0.0000112,
1,10,2083,2093,0.0002017,0.0000145,
1,11,2083,2094,0.0002200,0.0000194,
1,12,2083,2095,0.0002484,0.0000267,
1,13,2083,2096,0.0002934,0.0000394,
1,14,2083,2097,0.0003624,0.0000637,
1,15,2083,2098,0.0004596,0.0001064,
1,16,2083,2099,0.0005802,0.0001676,
1,17,2083,2100,0.0007098,0.0002360,
1,18,2083,2101,0.0008321,0.0003011,
1,19,2083,2102,0.0009391,0.0003564,
1,20,2083,2103,0.0010297,0.0003999,
1,21,2083,2104,0.0011033,0.0004294,
1,22,2083,2105,0.0011584,0.0004473,
1,23,2083,2106,0.0011978,0.0004636,
1,24,2083,2107,0.0012275,0.0004785,
1,25,2083,2108,0.0012521,0.0004798,
1,26,2083,2109,0.0012759,0.0004766,
1,27,2083,2110,0.0013058,0.0004796,
1,28,2083,2111,0.0013446,0.0005022,
1,29,2083,2112,0.0013859,0.0005188,
1,30,2083,2113,0.0014216,0.0005169,
1,31,2083,2114,0.0014530,0.0005106,
1,32,2083,2115,0.0014859,0.0005049,
1,33,2083,2116,0.0015203,0.0004923,
1,34,2083,2117,0.0015540,0.0004693,
1,35,2083,2118,0.0015941,0.0004401,
1,36,2083,2119,0.0016525,0.0004245,
1,37,2083,2120,0.0017318,0.0004195,
1,38,2083,2121,0.0018255,0.0004326,
1,39,2083,2122,0.0019305,0.0004615,
1,40,2083,2123,0.0020513,0.0005026,
1,41,2083,2124,0.0021897,0.0005540,
1,42,2083,2125,0.0023342,0.0006059,
1,43,2083,2126,0.0024669,0.0006452,
1,44,2083,2127,0.0025867,0.0006657,
1,45,2083,2128,0.0027191,0.0006674,
1,46,2083,2129,0.0028925,0.0006911,
1,47,2083,2130,0.0031101,0.0007355,
1,48,2083,2131,0.0033571,0.0008000,
1,49,2083,2132,0.0036304,0.0008699,
1,50,2083,2133,0.0039379,0.0009326,
1,51,2083,2134,0.0042708,0.0009928,
1,52,2083,2135,0.0046082,0.0010458,
1,53,2083,2136,0.0049489,0.0010789,
1,54,2083,2137,0.0053157,0.0011191,
1,55,2083,2138,0.0057365,0.0011724,
1,56,2083,2139,0.0062406,0.0012698,
1,57,2083,2140,0.0068502,0.0014150,
1,58,2083,2141,0.0075521,0.0016094,
1,59,2083,2142,0.0083035,0.0018117,
1,60,2083,2143,0.0090849,0.0019927,
1,61,2083,2144,0.0099105,0.0021563,
1,62,2083,2145,0.0107829,0.0023018,
1,63,2083,2146,0.0116995,0.0024428,
1,64,2083,2147,0.0126957,0.0026139,
1,65,2083,2148,0.0138071,0.0028198,
1,66,2083,2149,0.0150054,0.0030438,
1,67,2083,2150,0.0162315,0.0032166,
1,0,2084,2084,0.0091933,0.0004373,
1,1,2084,2085,0.0006668,0.0000088,
1,2,2084,2086,0.0003367,0.0000055,
1,3,2084,2087,0.0002291,0.0000041,
1,4,2084,2088,0.0001930,0.0000040,
1,5,2084,2089,0.0001870,0.0000050,
1,6,2084,2090,0.0001837,0.0000060,
1,7,2084,2091,0.0001828,0.0000073,
1,8,2084,2092,0.0001845,0.0000087,
1,9,2084,2093,0.0001904,0.0000108,
1,10,2084,2094,0.0002017,0.0000141,
1,11,2084,2095,0.0002200,0.0000188,
1,12,2084,2096,0.0002484,0.0000259,
1,13,2084,2097,0.0002934,0.0000385,
1,14,2084,2098,0.0003624,0.0000625,
1,15,2084,2099,0.0004596,0.0001047,
1,16,2084,2100,0.0005802,0.0001651,
1,17,2084,2101,0.0007098,0.0002328,
1,18,2084,2102,0.0008321,0.0002976,
1,19,2084,2103,0.0009391,0.0003528,
1,20,2084,2104,0.0010297,0.0003959,
1,21,2084,2105,0.0011033,0.0004248,
1,22,2084,2106,0.0011584,0.0004424,
1,23,2084,2107,0.0011978,0.0004589,
1,24,2084,2108,0.0012275,0.0004740,
1,25,2084,2109,0.0012521,0.0004752,
1,26,2084,2110,0.0012759,0.0004715,
1,27,2084,2111,0.0013058,0.0004744,
1,28,2084,2112,0.0013446,0.0004971,
1,29,2084,2113,0.0013859,0.0005140,
1,30,2084,2114,0.0014216,0.0005120,
1,31,2084,2115,0.0014530,0.0005051,
1,32,2084,2116,0.0014859,0.0004993,
1,33,2084,2117,0.0015203,0.0004869,
1,34,2084,2118,0.0015540,0.0004643,
1,35,2084,2119,0.0015941,0.0004349,
1,36,2084,2120,0.0016525,0.0004188,
1,37,2084,2121,0.0017318,0.0004136,
1,38,2084,2122,0.0018255,0.0004269,
1,39,2084,2123,0.0019305,0.0004559,
1,40,2084,2124,0.0020513,0.0004965,
1,41,2084,2125,0.0021897,0.0005468,
1,42,2084,2126,0.0023342,0.0005981,
1,43,2084,2127,0.0024669,0.0006375,
1,44,2084,2128,0.0025867,0.0006584,
1,45,2084,2129,0.0027191,0.0006597,
1,46,2084,2130,0.0028925,0.0006823,
1,47,2084,2131,0.0031101,0.0007259,
1,48,2084,2132,0.0033571,0.0007904,
1,49,2084,2133,0.0036304,0.0008602,
1,50,2084,2134,0.0039379,0.0009218,
1,51,2084,2135,0.0042708,0.0009802,
1,52,2084,2136,0.0046082,0.0010322,
1,53,2084,2137,0.0049489,0.0010655,
1,54,2084,2138,0.0053157,0.0011060,
1,55,2084,2139,0.0057365,0.0011583,
1,56,2084,2140,0.0062406,0.0012532,
1,57,2084,2141,0.0068502,0.0013964,
1,58,2084,2142,0.0075521,0.0015900,
1,59,2084,2143,0.0083035,0.0017919,
1,60,2084,2144,0.0090849,0.0019708,
1,61,2084,2145,0.0099105,0.0021305,
1,62,2084,2146,0.0107829,0.0022735,
1,63,2084,2147,0.0116995,0.0024143,
1,64,2084,2148,0.0126957,0.0025855,
1,65,2084,2149,0.0138071,0.0027884,
1,66,2084,2150,0.0150054,0.0030069,
1,0,2085,2085,0.0091933,0.0004183,
1,1,2085,2086,0.0006668,0.0000082,
1,2,2085,2087,0.0003367,0.0000052,
1,3,2085,2088,0.0002291,0.0000039,
1,4,2085,2089,0.0001930,0.0000038,
1,5,2085,2090,0.0001870,0.0000048,
1,6,2085,2091,0.0001837,0.0000057,
1,7,2085,2092,0.0001828,0.0000070,
1,8,2085,2093,0.0001845,0.0000084,
1,9,2085,2094,0.0001904,0.0000104,
1,10,2085,2095,0.0002017,0.0000136,
1,11,2085,2096,0.0002200,0.0000182,
1,12,2085,2097,0.0002484,0.0000252,
1,13,2085,2098,0.0002934,0.0000376,
1,14,2085,2099,0.0003624,0.0000613,
1,15,2085,2100,0.0004596,0.0001028,
1,16,2085,2101,0.0005802,0.0001626,
1,17,2085,2102,0.0007098,0.0002299,
1,18,2085,2103,0.0008321,0.0002945,
1,19,2085,2104,0.0009391,0.0003492,
1,20,2085,2105,0.0010297,0.0003916,
1,21,2085,2106,0.0011033,0.0004201,
1,22,2085,2107,0.0011584,0.0004378,
1,23,2085,2108,0.0011978,0.0004545,
1,24,2085,2109,0.0012275,0.0004695,
1,25,2085,2110,0.0012521,0.0004702,
1,26,2085,2111,0.0012759,0.0004663,
1,27,2085,2112,0.0013058,0.0004695,
1,28,2085,2113,0.0013446,0.0004925,
1,29,2085,2114,0.0013859,0.0005092,
1,30,2085,2115,0.0014216,0.0005067,
1,31,2085,2116,0.0014530,0.0004996,
1,32,2085,2117,0.0014859,0.0004941,
1,33,2085,2118,0.0015203,0.0004820,
1,34,2085,2119,0.0015540,0.0004592,
1,35,2085,2120,0.0015941,0.0004294,
1,36,2085,2121,0.0016525,0.0004131,
1,37,2085,2122,0.0017318,0.0004081,
1,38,2085,2123,0.0018255,0.0004216,
1,39,2085,2124,0.0019305,0.0004502,
1,40,2085,2125,0.0020513,0.0004899,
1,41,2085,2126,0.0021897,0.0005396,
1,42,2085,2127,0.0023342,0.0005909,
1,43,2085,2128,0.0024669,0.0006305,
1,44,2085,2129,0.0025867,0.0006509,
1,45,2085,2130,0.0027191,0.0006513,
1,46,2085,2131,0.0028925,0.0006734,
1,47,2085,2132,0.0031101,0.0007170,
1,48,2085,2133,0.0033571,0.0007814,
1,49,2085,2134,0.0036304,0.0008504,
1,50,2085,2135,0.0039379,0.0009103,
1,51,2085,2136,0.0042708,0.0009676,
1,52,2085,2137,0.0046082,0.0010195,
1,53,2085,2138,0.0049489,0.0010532,
1,54,2085,2139,0.0053157,0.0010928,
1,55,2085,2140,0.0057365,0.0011430,
1,56,2085,2141,0.0062406,0.0012364,
1,57,2085,2142,0.0068502,0.0013791,
1,58,2085,2143,0.0075521,0.0015723,
1,59,2085,2144,0.0083035,0.0017720,
1,60,2085,2145,0.0090849,0.0019471,
1,61,2085,2146,0.0099105,0.0021044,
1,62,2085,2147,0.0107829,0.0022471,
1,63,2085,2148,0.0116995,0.0023881,
1,64,2085,2149,0.0126957,0.0025566,
1,65,2085,2150,0.0138071,0.0027545,
1,0,2086,2086,0.0091932,0.0003996,
1,1,2086,2087,0.0006668,0.0000078,
1,2,2086,2088,0.0003367,0.0000050,
1,3,2086,2089,0.0002291,0.0000037,
1,4,2086,2090,0.0001930,0.0000036,
1,5,2086,2091,0.0001870,0.0000045,
1,6,2086,2092,0.0001837,0.0000055,
1,7,2086,2093,0.0001828,0.0000067,
1,8,2086,2094,0.0001845,0.0000081,
1,9,2086,2095,0.0001904,0.0000101,
1,10,2086,2096,0.0002017,0.0000132,
1,11,2086,2097,0.0002200,0.0000177,
1,12,2086,2098,0.0002484,0.0000246,
1,13,2086,2099,0.0002934,0.0000367,
1,14,2086,2100,0.0003624,0.0000600,
1,15,2086,2101,0.0004596,0.0001010,
1,16,2086,2102,0.0005802,0.0001603,
1,17,2086,2103,0.0007098,0.0002272,
1,18,2086,2104,0.0008321,0.0002913,
1,19,2086,2105,0.0009391,0.0003452,
1,20,2086,2106,0.0010297,0.0003873,
1,21,2086,2107,0.0011033,0.0004158,
1,22,2086,2108,0.0011584,0.0004336,
1,23,2086,2109,0.0011978,0.0004501,
1,24,2086,2110,0.0012275,0.0004646,
1,25,2086,2111,0.0012521,0.0004651,
1,26,2086,2112,0.0012759,0.0004615,
1,27,2086,2113,0.0013058,0.0004650,
1,28,2086,2114,0.0013446,0.0004878,
1,29,2086,2115,0.0013859,0.0005040,
1,30,2086,2116,0.0014216,0.0005013,
1,31,2086,2117,0.0014530,0.0004945,
1,32,2086,2118,0.0014859,0.0004893,
1,33,2086,2119,0.0015203,0.0004770,
1,34,2086,2120,0.0015540,0.0004538,
1,35,2086,2121,0.0015941,0.0004238,
1,36,2086,2122,0.0016525,0.0004078,
1,37,2086,2123,0.0017318,0.0004031,
1,38,2086,2124,0.0018255,0.0004162,
1,39,2086,2125,0.0019305,0.0004440,
1,40,2086,2126,0.0020513,0.0004832,
1,41,2086,2127,0.0021897,0.0005329,
1,42,2086,2128,0.0023342,0.0005843,
1,43,2086,2129,0.0024669,0.0006234,
1,44,2086,2130,0.0025867,0.0006429,
1,45,2086,2131,0.0027191,0.0006429,
1,46,2086,2132,0.0028925,0.0006651,
1,47,2086,2133,0.0031101,0.0007087,
1,48,2086,2134,0.0033571,0.0007723,
1,49,2086,2135,0.0036304,0.0008397,
1,50,2086,2136,0.0039379,0.0008986,
1,51,2086,2137,0.0042708,0.0009558,
1,52,2086,2138,0.0046082,0.0010080,
1,53,2086,2139,0.0049489,0.0010408,
1,54,2086,2140,0.0053157,0.0010786,
1,55,2086,2141,0.0057365,0.0011277,
1,56,2086,2142,0.0062406,0.0012208,
1,57,2086,2143,0.0068502,0.0013633,
1,58,2086,2144,0.0075521,0.0015544,
1,59,2086,2145,0.0083035,0.0017505,
1,60,2086,2146,0.0090849,0.0019232,
1,61,2086,2147,0.0099105,0.0020800,
1,62,2086,2148,0.0107829,0.0022229,
1,63,2086,2149,0.0116995,0.0023615,
1,64,2086,2150,0.0126957,0.0025255,
1,0,2087,2087,0.0091932,0.0003829,
1,1,2087,2088,0.0006668,0.0000073,
1,2,2087,2089,0.0003367,0.0000047,
1,3,2087,2090,0.0002291,0.0000035,
1,4,2087,2091,0.0001930,0.0000034,
1,5,2087,2092,0.0001870,0.0000043,
1,6,2087,2093,0.0001837,0.0000053,
1,7,2087,2094,0.0001828,0.0000064,
1,8,2087,2095,0.0001845,0.0000078,
1,9,2087,2096,0.0001904,0.0000097,
1,10,2087,2097,0.0002017,0.0000127,
1,11,2087,2098,0.0002200,0.0000172,
1,12,2087,2099,0.0002484,0.0000240,
1,13,2087,2100,0.0002934,0.0000358,
1,14,2087,2101,0.0003624,0.0000587,
1,15,2087,2102,0.0004596,0.0000992,
1,16,2087,2103,0.0005802,0.0001582,
1,17,2087,2104,0.0007098,0.0002245,
1,18,2087,2105,0.0008321,0.0002878,
1,19,2087,2106,0.0009391,0.0003413,
1,20,2087,2107,0.0010297,0.0003832,
1,21,2087,2108,0.0011033,0.0004118,
1,22,2087,2109,0.0011584,0.0004293,
1,23,2087,2110,0.0011978,0.0004453,
1,24,2087,2111,0.0012275,0.0004596,
1,25,2087,2112,0.0012521,0.0004604,
1,26,2087,2113,0.0012759,0.0004571,
1,27,2087,2114,0.0013058,0.0004604,
1,28,2087,2115,0.0013446,0.0004828,
1,29,2087,2116,0.0013859,0.0004988,
1,30,2087,2117,0.0014216,0.0004962,
1,31,2087,2118,0.0014530,0.0004898,
1,32,2087,2119,0.0014859,0.0004843,
1,33,2087,2120,0.0015203,0.0004716,
1,34,2087,2121,0.0015540,0.0004482,
1,35,2087,2122,0.0015941,0.0004186,
1,36,2087,2123,0.0016525,0.0004029,
1,37,2087,2124,0.0017318,0.0003980,
1,38,2087,2125,0.0018255,0.0004104,
1,39,2087,2126,0.0019305,0.0004378,
1,40,2087,2127,0.0020513,0.0004770,
1,41,2087,2128,0.0021897,0.0005268,
1,42,2087,2129,0.0023342,0.0005776,
1,43,2087,2130,0.0024669,0.0006158,
1,44,2087,2131,0.0025867,0.0006348,
1,45,2087,2132,0.0027191,0.0006351,
1,46,2087,2133,0.0028925,0.0006575,
1,47,2087,2134,0.0031101,0.0007004,
1,48,2087,2135,0.0033571,0.0007625,
1,49,2087,2136,0.0036304,0.0008289,
1,50,2087,2137,0.0039379,0.0008877,
1,51,2087,2138,0.0042708,0.0009450,
1,52,2087,2139,0.0046082,0.0009963,
1,53,2087,2140,0.0049489,0.0010275,
1,54,2087,2141,0.0053157,0.0010642,
1,55,2087,2142,0.0057365,0.0011134,
1,56,2087,2143,0.0062406,0.0012065,
1,57,2087,2144,0.0068502,0.0013473,
1,58,2087,2145,0.0075521,0.0015351,
1,59,2087,2146,0.0083035,0.0017288,
1,60,2087,2147,0.0090849,0.0019010,
1,61,2087,2148,0.0099105,0.0020577,
1,62,2087,2149,0.0107829,0.0021983,
1,63,2087,2150,0.0116995,0.0023328,
1,0,2088,2088,0.0091932,0.0003679,
1,1,2088,2089,0.0006668,0.0000069,
1,2,2088,2090,0.0003367,0.0000044,
1,3,2088,2091,0.0002291,0.0000033,
1,4,2088,2092,0.0001930,0.0000032,
1,5,2088,2093,0.0001870,0.0000041,
1,6,2088,2094,0.0001837,0.0000050,
1,7,2088,2095,0.0001828,0.0000062,
1,8,2088,2096,0.0001845,0.0000075,
1,9,2088,2097,0.0001904,0.0000093,
1,10,2088,2098,0.0002017,0.0000123,
1,11,2088,2099,0.0002200,0.0000167,
1,12,2088,2100,0.0002484,0.0000233,
1,13,2088,2101,0.0002934,0.0000349,
1,14,2088,2102,0.0003624,0.0000575,
1,15,2088,2103,0.0004596,0.0000977,
1,16,2088,2104,0.0005802,0.0001560,
1,17,2088,2105,0.0007098,0.0002216,
1,18,2088,2106,0.0008321,0.0002843,
1,19,2088,2107,0.0009391,0.0003376,
1,20,2088,2108,0.0010297,0.0003795,
1,21,2088,2109,0.0011033,0.0004077,
1,22,2088,2110,0.0011584,0.0004247,
1,23,2088,2111,0.0011978,0.0004405,
1,24,2088,2112,0.0012275,0.0004550,
1,25,2088,2113,0.0012521,0.0004561,
1,26,2088,2114,0.0012759,0.0004527,
1,27,2088,2115,0.0013058,0.0004555,
1,28,2088,2116,0.0013446,0.0004777,
1,29,2088,2117,0.0013859,0.0004939,
1,30,2088,2118,0.0014216,0.0004916,
1,31,2088,2119,0.0014530,0.0004849,
1,32,2088,2120,0.0014859,0.0004790,
1,33,2088,2121,0.0015203,0.0004661,
1,34,2088,2122,0.0015540,0.0004430,
1,35,2088,2123,0.0015941,0.0004138,
1,36,2088,2124,0.0016525,0.0003980,
1,37,2088,2125,0.0017318,0.0003925,
1,38,2088,2126,0.0018255,0.0004046,
1,39,2088,2127,0.0019305,0.0004321,
1,40,2088,2128,0.0020513,0.0004713,
1,41,2088,2129,0.0021897,0.0005206,
1,42,2088,2130,0.0023342,0.0005704,
1,43,2088,2131,0.0024669,0.0006081,
1,44,2088,2132,0.0025867,0.0006273,
1,45,2088,2133,0.0027191,0.0006279,
1,46,2088,2134,0.0028925,0.0006497,
1,47,2088,2135,0.0031101,0.0006913,
1,48,2088,2136,0.0033571,0.0007526,
1,49,2088,2137,0.0036304,0.0008189,
1,50,2088,2138,0.0039379,0.0008777,
1,51,2088,2139,0.0042708,0.0009342,
1,52,2088,2140,0.0046082,0.0009838,
1,53,2088,2141,0.0049489,0.0010140,
1,54,2088,2142,0.0053157,0.0010509,
1,55,2088,2143,0.0057365,0.0011003,
1,56,2088,2144,0.0062406,0.0011921,
1,57,2088,2145,0.0068502,0.0013302,
1,58,2088,2146,0.0075521,0.0015156,
1,59,2088,2147,0.0083035,0.0017086,
1,60,2088,2148,0.0090849,0.0018805,
1,61,2088,2149,0.0099105,0.0020351,
1,62,2088,2150,0.0107829,0.0021718,
1,0,2089,2089,0.0091932,0.0003531,
1,1,2089,2090,0.0006668,0.0000065,
1,2,2089,2091,0.0003367,0.0000042,
1,3,2089,2092,0.0002291,0.0000031,
1,4,2089,2093,0.0001930,0.0000031,
1,5,2089,2094,0.0001870,0.0000039,
1,6,2089,2095,0.0001837,0.0000048,
1,7,2089,2096,0.0001828,0.0000059,
1,8,2089,2097,0.0001845,0.0000072,
1,9,2089,2098,0.0001904,0.0000090,
1,10,2089,2099,0.0002017,0.0000120,
1,11,2089,2100,0.0002200,0.0000162,
1,12,2089,2101,0.0002484,0.0000226,
1,13,2089,2102,0.0002934,0.0000341,
1,14,2089,2103,0.0003624,0.0000564,
1,15,2089,2104,0.0004596,0.0000961,
1,16,2089,2105,0.0005802,0.0001537,
1,17,2089,2106,0.0007098,0.0002186,
1,18,2089,2107,0.0008321,0.0002810,
1,19,2089,2108,0.0009391,0.0003342,
1,20,2089,2109,0.0010297,0.0003757,
1,21,2089,2110,0.0011033,0.0004033,
1,22,2089,2111,0.0011584,0.0004200,
1,23,2089,2112,0.0011978,0.0004360,
1,24,2089,2113,0.0012275,0.0004508,
1,25,2089,2114,0.0012521,0.0004517,
1,26,2089,2115,0.0012759,0.0004479,
1,27,2089,2116,0.0013058,0.0004506,
1,28,2089,2117,0.0013446,0.0004729,
1,29,2089,2118,0.0013859,0.0004894,
1,30,2089,2119,0.0014216,0.0004869,
1,31,2089,2120,0.0014530,0.0004797,
1,32,2089,2121,0.0014859,0.0004736,
1,33,2089,2122,0.0015203,0.0004610,
1,34,2089,2123,0.0015540,0.0004383,
1,35,2089,2124,0.0015941,0.0004089,
1,36,2089,2125,0.0016525,0.0003927,
1,37,2089,2126,0.0017318,0.0003870,
1,38,2089,2127,0.0018255,0.0003992,
1,39,2089,2128,0.0019305,0.0004268,
1,40,2089,2129,0.0020513,0.0004656,
1,41,2089,2130,0.0021897,0.0005139,
1,42,2089,2131,0.0023342,0.0005631,
1,43,2089,2132,0.0024669,0.0006009,
1,44,2089,2133,0.0025867,0.0006204,
1,45,2089,2134,0.0027191,0.0006206,
1,46,2089,2135,0.0028925,0.0006413,
1,47,2089,2136,0.0031101,0.0006822,
1,48,2089,2137,0.0033571,0.0007434,
1,49,2089,2138,0.0036304,0.0008097,
1,50,2089,2139,0.0039379,0.0008677,
1,51,2089,2140,0.0042708,0.0009225,
1,52,2089,2141,0.0046082,0.0009711,
1,53,2089,2142,0.0049489,0.0010015,
1,54,2089,2143,0.0053157,0.0010387,
1,55,2089,2144,0.0057365,0.0010871,
1,56,2089,2145,0.0062406,0.0011767,
1,57,2089,2146,0.0068502,0.0013128,
1,58,2089,2147,0.0075521,0.0014975,
1,59,2089,2148,0.0083035,0.0016900,
1,60,2089,2149,0.0090849,0.0018598,
1,61,2089,2150,0.0099105,0.0020106,
1,0,2090,2090,0.0091932,0.0003377,
1,1,2090,2091,0.0006668,0.0000061,
1,2,2090,2092,0.0003367,0.0000040,
1,3,2090,2093,0.0002291,0.0000029,
1,4,2090,2094,0.0001930,0.0000029,
1,5,2090,2095,0.0001870,0.0000038,
1,6,2090,2096,0.0001837,0.0000046,
1,7,2090,2097,0.0001828,0.0000057,
1,8,2090,2098,0.0001845,0.0000069,
1,9,2090,2099,0.0001904,0.0000087,
1,10,2090,2100,0.0002017,0.0000116,
1,11,2090,2101,0.0002200,0.0000157,
1,12,2090,2102,0.0002484,0.0000220,
1,13,2090,2103,0.0002934,0.0000334,
1,14,2090,2104,0.0003624,0.0000553,
1,15,2090,2105,0.0004596,0.0000944,
1,16,2090,2106,0.0005802,0.0001514,
1,17,2090,2107,0.0007098,0.0002158,
1,18,2090,2108,0.0008321,0.0002780,
1,19,2090,2109,0.0009391,0.0003307,
1,20,2090,2110,0.0010297,0.0003716,
1,21,2090,2111,0.0011033,0.0003988,
1,22,2090,2112,0.0011584,0.0004157,
1,23,2090,2113,0.0011978,0.0004319,
1,24,2090,2114,0.0012275,0.0004465,
1,25,2090,2115,0.0012521,0.0004471,
1,26,2090,2116,0.0012759,0.0004431,
1,27,2090,2117,0.0013058,0.0004460,
1,28,2090,2118,0.0013446,0.0004685,
1,29,2090,2119,0.0013859,0.0004847,
1,30,2090,2120,0.0014216,0.0004817,
1,31,2090,2121,0.0014530,0.0004744,
1,32,2090,2122,0.0014859,0.0004686,
1,33,2090,2123,0.0015203,0.0004563,
1,34,2090,2124,0.0015540,0.0004335,
1,35,2090,2125,0.0015941,0.0004037,
1,36,2090,2126,0.0016525,0.0003873,
1,37,2090,2127,0.0017318,0.0003818,
1,38,2090,2128,0.0018255,0.0003943,
1,39,2090,2129,0.0019305,0.0004215,
1,40,2090,2130,0.0020513,0.0004595,
1,41,2090,2131,0.0021897,0.0005072,
1,42,2090,2132,0.0023342,0.0005564,
1,43,2090,2133,0.0024669,0.0005942,
1,44,2090,2134,0.0025867,0.0006133,
1,45,2090,2135,0.0027191,0.0006126,
1,46,2090,2136,0.0028925,0.0006328,
1,47,2090,2137,0.0031101,0.0006737,
1,48,2090,2138,0.0033571,0.0007350,
1,49,2090,2139,0.0036304,0.0008004,
1,50,2090,2140,0.0039379,0.0008569,
1,51,2090,2141,0.0042708,0.0009108,
1,52,2090,2142,0.0046082,0.0009593,
1,53,2090,2143,0.0049489,0.0009900,
1,54,2090,2144,0.0053157,0.0010264,
1,55,2090,2145,0.0057365,0.0010730,
1,56,2090,2146,0.0062406,0.0011610,
1,57,2090,2147,0.0068502,0.0012967,
1,58,2090,2148,0.0075521,0.0014809,
1,59,2090,2149,0.0083035,0.0016712,
1,60,2090,2150,0.0090849,0.0018374,
1,0,2091,2091,0.0091932,0.0003226,
1,1,2091,2092,0.0006668,0.0000057,
1,2,2091,2093,0.0003367,0.0000038,
1,3,2091,2094,0.0002291,0.0000028,
1,4,2091,2095,0.0001930,0.0000028,
1,5,2091,2096,0.0001870,0.0000036,
1,6,2091,2097,0.0001837,0.0000044,
1,7,2091,2098,0.0001828,0.0000055,
1,8,2091,2099,0.0001845,0.0000067,
1,9,2091,2100,0.0001904,0.0000084,
1,10,2091,2101,0.0002017,0.0000112,
1,11,2091,2102,0.0002200,0.0000153,
1,12,2091,2103,0.0002484,0.0000215,
1,13,2091,2104,0.0002934,0.0000326,
1,14,2091,2105,0.0003624,0.0000541,
1,15,2091,2106,0.0004596,0.0000927,
1,16,2091,2107,0.0005802,0.0001492,
1,17,2091,2108,0.0007098,0.0002133,
1,18,2091,2109,0.0008321,0.0002749,
1,19,2091,2110,0.0009391,0.0003270,
1,20,2091,2111,0.0010297,0.0003674,
1,21,2091,2112,0.0011033,0.0003947,
1,22,2091,2113,0.0011584,0.0004117,
1,23,2091,2114,0.0011978,0.0004277,
1,24,2091,2115,0.0012275,0.0004419,
1,25,2091,2116,0.0012521,0.0004423,
1,26,2091,2117,0.0012759,0.0004386,
1,27,2091,2118,0.0013058,0.0004417,
1,28,2091,2119,0.0013446,0.0004641,
1,29,2091,2120,0.0013859,0.0004797,
1,30,2091,2121,0.0014216,0.0004766,
1,31,2091,2122,0.0014530,0.0004695,
1,32,2091,2123,0.0014859,0.0004640,
1,33,2091,2124,0.0015203,0.0004515,
1,34,2091,2125,0.0015540,0.0004283,
1,35,2091,2126,0.0015941,0.0003985,
1,36,2091,2127,0.0016525,0.0003823,
1,37,2091,2128,0.0017318,0.0003771,
1,38,2091,2129,0.0018255,0.0003893,
1,39,2091,2130,0.0019305,0.0004158,
1,40,2091,2131,0.0020513,0.0004533,
1,41,2091,2132,0.0021897,0.0005009,
1,42,2091,2133,0.0023342,0.0005501,
1,43,2091,2134,0.0024669,0.0005875,
1,44,2091,2135,0.0025867,0.0006057,
1,45,2091,2136,0.0027191,0.0006046,
1,46,2091,2137,0.0028925,0.0006249,
1,47,2091,2138,0.0031101,0.0006660,
1,48,2091,2139,0.0033571,0.0007265,
1,49,2091,2140,0.0036304,0.0007905,
1,50,2091,2141,0.0039379,0.0008460,
1,51,2091,2142,0.0042708,0.0008998,
1,52,2091,2143,0.0046082,0.0009486,
1,53,2091,2144,0.0049489,0.0009785,
1,54,2091,2145,0.0053157,0.0010132,
1,55,2091,2146,0.0057365,0.0010587,
1,56,2091,2147,0.0062406,0.0011465,
1,57,2091,2148,0.0068502,0.0012818,
1,58,2091,2149,0.0075521,0.0014640,
1,59,2091,2150,0.0083035,0.0016509,
1,0,2092,2092,0.0091932,0.0003089,
1,1,2092,2093,0.0006668,0.0000054,
1,2,2092,2094,0.0003367,0.0000036,
1,3,2092,2095,0.0002291,0.0000026,
1,4,2092,2096,0.0001930,0.0000026,
1,5,2092,2097,0.0001870,0.0000034,
1,6,2092,2098,0.0001837,0.0000042,
1,7,2092,2099,0.0001828,0.0000052,
1,8,2092,2100,0.0001845,0.0000064,
1,9,2092,2101,0.0001904,0.0000081,
1,10,2092,2102,0.0002017,0.0000108,
1,11,2092,2103,0.0002200,0.0000148,
1,12,2092,2104,0.0002484,0.0000209,
1,13,2092,2105,0.0002934,0.0000318,
1,14,2092,2106,0.0003624,0.0000530,
1,15,2092,2107,0.0004596,0.0000911,
1,16,2092,2108,0.0005802,0.0001472,
1,17,2092,2109,0.0007098,0.0002107,
1,18,2092,2110,0.0008321,0.0002716,
1,19,2092,2111,0.0009391,0.0003232,
1,20,2092,2112,0.0010297,0.0003635,
1,21,2092,2113,0.0011033,0.0003909,
1,22,2092,2114,0.0011584,0.0004077,
1,23,2092,2115,0.0011978,0.0004232,
1,24,2092,2116,0.0012275,0.0004373,
1,25,2092,2117,0.0012521,0.0004379,
1,26,2092,2118,0.0012759,0.0004344,
1,27,2092,2119,0.0013058,0.0004374,
1,28,2092,2120,0.0013446,0.0004592,
1,29,2092,2121,0.0013859,0.0004747,
1,30,2092,2122,0.0014216,0.0004717,
1,31,2092,2123,0.0014530,0.0004650,
1,32,2092,2124,0.0014859,0.0004593,
1,33,2092,2125,0.0015203,0.0004463,
1,34,2092,2126,0.0015540,0.0004230,
1,35,2092,2127,0.0015941,0.0003936,
1,36,2092,2128,0.0016525,0.0003778,
1,37,2092,2129,0.0017318,0.0003724,
1,38,2092,2130,0.0018255,0.0003839,
1,39,2092,2131,0.0019305,0.0004100,
1,40,2092,2132,0.0020513,0.0004475,
1,41,2092,2133,0.0021897,0.0004952,
1,42,2092,2134,0.0023342,0.0005438,
1,43,2092,2135,0.0024669,0.0005802,
1,44,2092,2136,0.0025867,0.0005979,
1,45,2092,2137,0.0027191,0.0005972,
1,46,2092,2138,0.0028925,0.0006177,
1,47,2092,2139,0.0031101,0.0006582,
1,48,2092,2140,0.0033571,0.0007173,
1,49,2092,2141,0.0036304,0.0007805,
1,50,2092,2142,0.0039379,0.0008359,
1,51,2092,2143,0.0042708,0.0008898,
1,52,2092,2144,0.0046082,0.0009377,
1,53,2092,2145,0.0049489,0.0009660,
1,54,2092,2146,0.0053157,0.0009998,
1,55,2092,2147,0.0057365,0.0010453,
1,56,2092,2148,0.0062406,0.0011332,
1,57,2092,2149,0.0068502,0.0012668,
1,58,2092,2150,0.0075521,0.0014458,
1,0,2093,2093,0.0091932,0.0002968,
1,1,2093,2094,0.0006668,0.0000051,
1,2,2093,2095,0.0003367,0.0000034,
1,3,2093,2096,0.0002291,0.0000025,
1,4,2093,2097,0.0001930,0.0000025,
1,5,2093,2098,0.0001870,0.0000033,
1,6,2093,2099,0.0001837,0.0000040,
1,7,2093,2100,0.0001828,0.0000050,
1,8,2093,2101,0.0001845,0.0000062,
1,9,2093,2102,0.0001904,0.0000078,
1,10,2093,2103,0.0002017,0.0000105,
1,11,2093,2104,0.0002200,0.0000144,
1,12,2093,2105,0.0002484,0.0000203,
1,13,2093,2106,0.0002934,0.0000310,
1,14,2093,2107,0.0003624,0.0000519,
1,15,2093,2108,0.0004596,0.0000896,
1,16,2093,2109,0.0005802,0.0001452,
1,17,2093,2110,0.0007098,0.0002080,
1,18,2093,2111,0.0008321,0.0002683,
1,19,2093,2112,0.0009391,0.0003196,
1,20,2093,2113,0.0010297,0.0003600,
1,21,2093,2114,0.0011033,0.0003871,
1,22,2093,2115,0.0011584,0.0004033,
1,23,2093,2116,0.0011978,0.0004187,
1,24,2093,2117,0.0012275,0.0004329,
1,25,2093,2118,0.0012521,0.0004338,
1,26,2093,2119,0.0012759,0.0004302,
1,27,2093,2120,0.0013058,0.0004327,
1,28,2093,2121,0.0013446,0.0004543,
1,29,2093,2122,0.0013859,0.0004699,
1,30,2093,2123,0.0014216,0.0004673,
1,31,2093,2124,0.0014530,0.0004603,
1,32,2093,2125,0.0014859,0.0004542,
1,33,2093,2126,0.0015203,0.0004411,
1,34,2093,2127,0.0015540,0.0004181,
1,35,2093,2128,0.0015941,0.0003891,
1,36,2093,2129,0.0016525,0.0003732,
1,37,2093,2130,0.0017318,0.0003673,
1,38,2093,2131,0.0018255,0.0003785,
1,39,2093,2132,0.0019305,0.0004047,
1,40,2093,2133,0.0020513,0.0004422,
1,41,2093,2134,0.0021897,0.0004893,
1,42,2093,2135,0.0023342,0.0005369,
1,43,2093,2136,0.0024669,0.0005728,
1,44,2093,2137,0.0025867,0.0005908,
1,45,2093,2138,0.0027191,0.0005904,
1,46,2093,2139,0.0028925,0.0006105,
1,47,2093,2140,0.0031101,0.0006498,
1,48,2093,2141,0.0033571,0.0007081,
1,49,2093,2142,0.0036304,0.0007711,
1,50,2093,2143,0.0039379,0.0008266,
1,51,2093,2144,0.0042708,0.0008796,
1,52,2093,2145,0.0046082,0.0009260,
1,53,2093,2146,0.0049489,0.0009535,
1,54,2093,2147,0.0053157,0.0009874,
1,55,2093,2148,0.0057365,0.0010331,
1,56,2093,2149,0.0062406,0.0011196,
1,57,2093,2150,0.0068502,0.0012506,
1,0,2094,2094,0.0091932,0.0002849,
1,1,2094,2095,0.0006668,0.0000048,
1,2,2094,2096,0.0003367,0.0000032,
1,3,2094,2097,0.0002291,0.0000024,
1,4,2094,2098,0.0001930,0.0000024,
1,5,2094,2099,0.0001870,0.0000031,
1,6,2094,2100,0.0001837,0.0000039,
1,7,2094,2101,0.0001828,0.0000048,
1,8,2094,2102,0.0001845,0.0000059,
1,9,2094,2103,0.0001904,0.0000076,
1,10,2094,2104,0.0002017,0.0000102,
1,11,2094,2105,0.0002200,0.0000140,
1,12,2094,2106,0.0002484,0.0000198,
1,13,2094,2107,0.0002934,0.0000302,
1,14,2094,2108,0.0003624,0.0000509,
1,15,2094,2109,0.0004596,0.0000882,
1,16,2094,2110,0.0005802,0.0001430,
1,17,2094,2111,0.0007098,0.0002052,
1,18,2094,2112,0.0008321,0.0002652,
1,19,2094,2113,0.0009391,0.0003164,
1,20,2094,2114,0.0010297,0.0003564,
1,21,2094,2115,0.0011033,0.0003829,
1,22,2094,2116,0.0011584,0.0003989,
1,23,2094,2117,0.0011978,0.0004145,
1,24,2094,2118,0.0012275,0.0004289,
1,25,2094,2119,0.0012521,0.0004296,
1,26,2094,2120,0.0012759,0.0004256,
1,27,2094,2121,0.0013058,0.0004279,
1,28,2094,2122,0.0013446,0.0004497,
1,29,2094,2123,0.0013859,0.0004656,
1,30,2094,2124,0.0014216,0.0004628,
1,31,2094,2125,0.0014530,0.0004554,
1,32,2094,2126,0.0014859,0.0004491,
1,33,2094,2127,0.0015203,0.0004363,
1,34,2094,2128,0.0015540,0.0004137,
1,35,2094,2129,0.0015941,0.0003845,
1,36,2094,2130,0.0016525,0.0003682,
1,37,2094,2131,0.0017318,0.0003621,
1,38,2094,2132,0.0018255,0.0003735,
1,39,2094,2133,0.0019305,0.0003997,
1,40,2094,2134,0.0020513,0.0004368,
1,41,2094,2135,0.0021897,0.0004830,
1,42,2094,2136,0.0023342,0.0005300,
1,43,2094,2137,0.0024669,0.0005660,
1,44,2094,2138,0.0025867,0.0005842,
1,45,2094,2139,0.0027191,0.0005835,
1,46,2094,2140,0.0028925,0.0006027,
1,47,2094,2141,0.0031101,0.0006413,
1,48,2094,2142,0.0033571,0.0006995,
1,49,2094,2143,0.0036304,0.0007626,
1,50,2094,2144,0.0039379,0.0008173,
1,51,2094,2145,0.0042708,0.0008687,
1,52,2094,2146,0.0046082,0.0009142,
1,53,2094,2147,0.0049489,0.0009418,
1,54,2094,2148,0.0053157,0.0009760,
1,55,2094,2149,0.0057365,0.0010207,
1,56,2094,2150,0.0062406,0.0011051,
1,0,2095,2095,0.0091932,0.0002724,
1,1,2095,2096,0.0006668,0.0000045,
1,2,2095,2097,0.0003367,0.0000030,
1,3,2095,2098,0.0002291,0.0000022,
1,4,2095,2099,0.0001930,0.0000022,
1,5,2095,2100,0.0001870,0.0000030,
1,6,2095,2101,0.0001837,0.0000037,
1,7,2095,2102,0.0001828,0.0000046,
1,8,2095,2103,0.0001845,0.0000057,
1,9,2095,2104,0.0001904,0.0000073,
1,10,2095,2105,0.0002017,0.0000098,
1,11,2095,2106,0.0002200,0.0000135,
1,12,2095,2107,0.0002484,0.0000192,
1,13,2095,2108,0.0002934,0.0000296,
1,14,2095,2109,0.0003624,0.0000499,
1,15,2095,2110,0.0004596,0.0000866,
1,16,2095,2111,0.0005802,0.0001408,
1,17,2095,2112,0.0007098,0.0002026,
1,18,2095,2113,0.0008321,0.0002624,
1,19,2095,2114,0.0009391,0.0003132,
1,20,2095,2115,0.0010297,0.0003526,
1,21,2095,2116,0.0011033,0.0003788,
1,22,2095,2117,0.0011584,0.0003949,
1,23,2095,2118,0.0011978,0.0004106,
1,24,2095,2119,0.0012275,0.0004248,
1,25,2095,2120,0.0012521,0.0004251,
1,26,2095,2121,0.0012759,0.0004209,
1,27,2095,2122,0.0013058,0.0004235,
1,28,2095,2123,0.0013446,0.0004455,
1,29,2095,2124,0.0013859,0.0004612,
1,30,2095,2125,0.0014216,0.0004579,
1,31,2095,2126,0.0014530,0.0004504,
1,32,2095,2127,0.0014859,0.0004443,
1,33,2095,2128,0.0015203,0.0004319,
1,34,2095,2129,0.0015540,0.0004091,
1,35,2095,2130,0.0015941,0.0003797,
1,36,2095,2131,0.0016525,0.0003632,
1,37,2095,2132,0.0017318,0.0003574,
1,38,2095,2133,0.0018255,0.0003689,
1,39,2095,2134,0.0019305,0.0003947,
1,40,2095,2135,0.0020513,0.0004309,
1,41,2095,2136,0.0021897,0.0004765,
1,42,2095,2137,0.0023342,0.0005236,
1,43,2095,2138,0.0024669,0.0005597,
1,44,2095,2139,0.0025867,0.0005776,
1,45,2095,2140,0.0027191,0.0005761,
1,46,2095,2141,0.0028925,0.0005948,
1,47,2095,2142,0.0031101,0.0006334,
1,48,2095,2143,0.0033571,0.0006917,
1,49,2095,2144,0.0036304,0.0007539,
1,50,2095,2145,0.0039379,0.0008072,
1,51,2095,2146,0.0042708,0.0008577,
1,52,2095,2147,0.0046082,0.0009031,
1,53,2095,2148,0.0049489,0.0009311,
1,54,2095,2149,0.0053157,0.0009644,
1,55,2095,2150,0.0057365,0.0010074,
1,0,2096,2096,0.0091932,0.0002602,
1,1,2096,2097,0.0006668,0.0000043,
1,2,2096,2098,0.0003367,0.0000028,
1,3,2096,2099,0.0002291,0.0000021,
1,4,2096,2100,0.0001930,0.0000021,
1,5,2096,2101,0.0001870,0.0000028,
1,6,2096,2102,0.0001837,0.0000035,
1,7,2096,2103,0.0001828,0.0000044,
1,8,2096,2104,0.0001845,0.0000055,
1,9,2096,2105,0.0001904,0.0000070,
1,10,2096,2106,0.0002017,0.0000095,
1,11,2096,2107,0.0002200,0.0000131,
1,12,2096,2108,0.0002484,0.0000187,
1,13,2096,2109,0.0002934,0.0000289,
1,14,2096,2110,0.0003624,0.0000488,
1,15,2096,2111,0.0004596,0.0000850,
1,16,2096,2112,0.0005802,0.0001388,
1,17,2096,2113,0.0007098,0.0002002,
1,18,2096,2114,0.0008321,0.0002595,
1,19,2096,2115,0.0009391,0.0003097,
1,20,2096,2116,0.0010297,0.0003487,
1,21,2096,2117,0.0011033,0.0003749,
1,22,2096,2118,0.0011584,0.0003911,
1,23,2096,2119,0.0011978,0.0004066,
1,24,2096,2120,0.0012275,0.0004204,
1,25,2096,2121,0.0012521,0.0004205,
1,26,2096,2122,0.0012759,0.0004166,
1,27,2096,2123,0.0013058,0.0004194,
1,28,2096,2124,0.0013446,0.0004412,
1,29,2096,2125,0.0013859,0.0004564,
1,30,2096,2126,0.0014216,0.0004529,
1,31,2096,2127,0.0014530,0.0004457,
1,32,2096,2128,0.0014859,0.0004399,
1,33,2096,2129,0.0015203,0.0004274,
1,34,2096,2130,0.0015540,0.0004043,
1,35,2096,2131,0.0015941,0.0003747,
1,36,2096,2132,0.0016525,0.0003586,
1,37,2096,2133,0.0017318,0.0003530,
1,38,2096,2134,0.0018255,0.0003642,
1,39,2096,2135,0.0019305,0.0003893,
1,40,2096,2136,0.0020513,0.0004250,
1,41,2096,2137,0.0021897,0.0004706,
1,42,2096,2138,0.0023342,0.0005177,
1,43,2096,2139,0.0024669,0.0005534,
1,44,2096,2140,0.0025867,0.0005705,
1,45,2096,2141,0.0027191,0.0005687,
1,46,2096,2142,0.0028925,0.0005875,
1,47,2096,2143,0.0031101,0.0006262,
1,48,2096,2144,0.0033571,0.0006838,
1,49,2096,2145,0.0036304,0.0007446,
1,50,2096,2146,0.0039379,0.0007970,
1,51,2096,2147,0.0042708,0.0008475,
1,52,2096,2148,0.0046082,0.0008930,
1,53,2096,2149,0.0049489,0.0009202,
1,54,2096,2150,0.0053157,0.0009519,
1,0,2097,2097,0.0091932,0.0002493,
1,1,2097,2098,0.0006668,0.0000040,
1,2,2097,2099,0.0003367,0.0000027,
1,3,2097,2100,0.0002291,0.0000020,
1,4,2097,2101,0.0001930,0.0000020,
1,5,2097,2102,0.0001870,0.0000027,
1,6,2097,2103,0.0001837,0.0000034,
1,7,2097,2104,0.0001828,0.0000043,
1,8,2097,2105,0.0001845,0.0000053,
1,9,2097,2106,0.0001904,0.0000068,
1,10,2097,2107,0.0002017,0.0000092,
1,11,2097,2108,0.0002200,0.0000128,
1,12,2097,2109,0.0002484,0.0000183,
1,13,2097,2110,0.0002934,0.0000282,
1,14,2097,2111,0.0003624,0.0000477,
1,15,2097,2112,0.0004596,0.0000835,
1,16,2097,2113,0.0005802,0.0001369,
1,17,2097,2114,0.0007098,0.0001978,
1,18,2097,2115,0.0008321,0.0002564,
1,19,2097,2116,0.0009391,0.0003061,
1,20,2097,2117,0.0010297,0.0003450,
1,21,2097,2118,0.0011033,0.0003713,
1,22,2097,2119,0.0011584,0.0003872,
1,23,2097,2120,0.0011978,0.0004023,
1,24,2097,2121,0.0012275,0.0004159,
1,25,2097,2122,0.0012521,0.0004163,
1,26,2097,2123,0.0012759,0.0004126,
1,27,2097,2124,0.0013058,0.0004153,
1,28,2097,2125,0.0013446,0.0004366,
1,29,2097,2126,0.0013859,0.0004516,
1,30,2097,2127,0.0014216,0.0004483,
1,31,2097,2128,0.0014530,0.0004414,
1,32,2097,2129,0.0014859,0.0004355,
1,33,2097,2130,0.0015203,0.0004225,
1,34,2097,2131,0.0015540,0.0003994,
1,35,2097,2132,0.0015941,0.0003702,
1,36,2097,2133,0.0016525,0.0003543,
1,37,2097,2134,0.0017318,0.0003485,
1,38,2097,2135,0.0018255,0.0003591,
1,39,2097,2136,0.0019305,0.0003838,
1,40,2097,2137,0.0020513,0.0004195,
1,41,2097,2138,0.0021897,0.0004652,
1,42,2097,2139,0.0023342,0.0005118,
1,43,2097,2140,0.0024669,0.0005466,
1,44,2097,2141,0.0025867,0.0005633,
1,45,2097,2142,0.0027191,0.0005618,
1,46,2097,2143,0.0028925,0.0005808,
1,47,2097,2144,0.0031101,0.0006189,
1,48,2097,2145,0.0033571,0.0006752,
1,49,2097,2146,0.0036304,0.0007353,
1,50,2097,2147,0.0039379,0.0007875,
1,51,2097,2148,0.0042708,0.0008381,
1,52,2097,2149,0.0046082,0.0008828,
1,53,2097,2150,0.0049489,0.0009084,
1,0,2098,2098,0.0091932,0.0002395,
1,1,2098,2099,0.0006668,0.0000038,
1,2,2098,2100,0.0003367,0.0000025,
1,3,2098,2101,0.0002291,0.0000019,
1,4,2098,2102,0.0001930,0.0000019,
1,5,2098,2103,0.0001870,0.0000026,
1,6,2098,2104,0.0001837,0.0000032,
1,7,2098,2105,0.0001828,0.0000041,
1,8,2098,2106,0.0001845,0.0000051,
1,9,2098,2107,0.0001904,0.0000065,
1,10,2098,2108,0.0002017,0.0000089,
1,11,2098,2109,0.0002200,0.0000124,
1,12,2098,2110,0.0002484,0.0000178,
1,13,2098,2111,0.0002934,0.0000274,
1,14,2098,2112,0.0003624,0.0000468,
1,15,2098,2113,0.0004596,0.0000822,
1,16,2098,2114,0.0005802,0.0001350,
1,17,2098,2115,0.0007098,0.0001952,
1,18,2098,2116,0.0008321,0.0002533,
1,19,2098,2117,0.0009391,0.0003028,
1,20,2098,2118,0.0010297,0.0003417,
1,21,2098,2119,0.0011033,0.0003676,
1,22,2098,2120,0.0011584,0.0003831,
1,23,2098,2121,0.0011978,0.0003979,
1,24,2098,2122,0.0012275,0.0004117,
1,25,2098,2123,0.0012521,0.0004124,
1,26,2098,2124,0.0012759,0.0004086,
1,27,2098,2125,0.0013058,0.0004108,
1,28,2098,2126,0.0013446,0.0004320,
1,29,2098,2127,0.0013859,0.0004471,
1,30,2098,2128,0.0014216,0.0004441,
1,31,2098,2129,0.0014530,0.0004370,
1,32,2098,2130,0.0014859,0.0004307,
1,33,2098,2131,0.0015203,0.0004176,
1,34,2098,2132,0.0015540,0.0003948,
1,35,2098,2133,0.0015941,0.0003660,
1,36,2098,2134,0.0016525,0.0003500,
1,37,2098,2135,0.0017318,0.0003437,
1,38,2098,2136,0.0018255,0.0003540,
1,39,2098,2137,0.0019305,0.0003787,
1,40,2098,2138,0.0020513,0.0004145,
1,41,2098,2139,0.0021897,0.0004597,
1,42,2098,2140,0.0023342,0.0005054,
1,43,2098,2141,0.0024669,0.0005397,
1,44,2098,2142,0.0025867,0.0005566,
1,45,2098,2143,0.0027191,0.0005554,
1,46,2098,2144,0.0028925,0.0005740,
1,47,2098,2145,0.0031101,0.0006111,
1,48,2098,2146,0.0033571,0.0006666,
1,49,2098,2147,0.0036304,0.0007265,
1,50,2098,2148,0.0039379,0.0007788,
1,51,2098,2149,0.0042708,0.0008285,
1,52,2098,2150,0.0046082,0.0008717,
1,0,2099,2099,0.0091932,0.0002300,
1,1,2099,2100,0.0006668,0.0000036,
1,2,2099,2101,0.0003367,0.0000024,
1,3,2099,2102,0.0002291,0.0000018,
1,4,2099,2103,0.0001930,0.0000018,
1,5,2099,2104,0.0001870,0.0000025,
1,6,2099,2105,0.0001837,0.0000031,
1,7,2099,2106,0.0001828,0.0000039,
1,8,2099,2107,0.0001845,0.0000049,
1,9,2099,2108,0.0001904,0.0000063,
1,10,2099,2109,0.0002017,0.0000086,
1,11,2099,2110,0.0002200,0.0000120,
1,12,2099,2111,0.0002484,0.0000172,
1,13,2099,2112,0.0002934,0.0000268,
1,14,2099,2113,0.0003624,0.0000459,
1,15,2099,2114,0.0004596,0.0000809,
1,16,2099,2115,0.0005802,0.0001330,
1,17,2099,2116,0.0007098,0.0001926,
1,18,2099,2117,0.0008321,0.0002504,
1,19,2099,2118,0.0009391,0.0002998,
1,20,2099,2119,0.0010297,0.0003383,
1,21,2099,2120,0.0011033,0.0003636,
1,22,2099,2121,0.0011584,0.0003788,
1,23,2099,2122,0.0011978,0.0003938,
1,24,2099,2123,0.0012275,0.0004079,
1,25,2099,2124,0.0012521,0.0004084,
1,26,2099,2125,0.0012759,0.0004042,
1,27,2099,2126,0.0013058,0.0004063,
1,28,2099,2127,0.0013446,0.0004276,
1,29,2099,2128,0.0013859,0.0004430,
1,30,2099,2129,0.0014216,0.0004398,
1,31,2099,2130,0.0014530,0.0004323,
1,32,2099,2131,0.0014859,0.0004259,
1,33,2099,2132,0.0015203,0.0004131,
1,34,2099,2133,0.0015540,0.0003906,
1,35,2099,2134,0.0015941,0.0003617,
1,36,2099,2135,0.0016525,0.0003453,
1,37,2099,2136,0.0017318,0.0003388,
1,38,2099,2137,0.0018255,0.0003492,
1,39,2099,2138,0.0019305,0.0003741,
1,40,2099,2139,0.0020513,0.0004095,
1,41,2099,2140,0.0021897,0.0004538,
1,42,2099,2141,0.0023342,0.0004990,
1,43,2099,2142,0.0024669,0.0005333,
1,44,2099,2143,0.0025867,0.0005505,
1,45,2099,2144,0.0027191,0.0005490,
1,46,2099,2145,0.0028925,0.0005667,
1,47,2099,2146,0.0031101,0.0006032,
1,48,2099,2147,0.0033571,0.0006586,
1,49,2099,2148,0.0036304,0.0007185,
1,50,2099,2149,0.0039379,0.0007700,
1,51,2099,2150,0.0042708,0.0008182,
1,0,2100,2100,0.0091932,0.0002200,
1,1,2100,2101,0.0006668,0.0000034,
1,2,2100,2102,0.0003367,0.0000023,
1,3,2100,2103,0.0002291,0.0000017,
1,4,2100,2104,0.0001930,0.0000017,
1,5,2100,2105,0.0001870,0.0000023,
1,6,2100,2106,0.0001837,0.0000030,
1,7,2100,2107,0.0001828,0.0000038,
1,8,2100,2108,0.0001845,0.0000047,
1,9,2100,2109,0.0001904,0.0000061,
1,10,2100,2110,0.0002017,0.0000083,
1,11,2100,2111,0.0002200,0.0000117,
1,12,2100,2112,0.0002484,0.0000168,
1,13,2100,2113,0.0002934,0.0000262,
1,14,2100,2114,0.0003624,0.0000450,
1,15,2100,2115,0.0004596,0.0000795,
1,16,2100,2116,0.0005802,0.0001310,
1,17,2100,2117,0.0007098,0.0001902,
1,18,2100,2118,0.0008321,0.0002478,
1,19,2100,2119,0.0009391,0.0002967,
1,20,2100,2120,0.0010297,0.0003346,
1,21,2100,2121,0.0011033,0.0003596,
1,22,2100,2122,0.0011584,0.0003749,
1,23,2100,2123,0.0011978,0.0003901,
1,24,2100,2124,0.0012275,0.0004040,
1,25,2100,2125,0.0012521,0.0004041,
1,26,2100,2126,0.0012759,0.0003998,
1,27,2100,2127,0.0013058,0.0004021,
1,28,2100,2128,0.0013446,0.0004236,
1,29,2100,2129,0.0013859,0.0004388,
1,30,2100,2130,0.0014216,0.0004352,
1,31,2100,2131,0.0014530,0.0004276,
1,32,2100,2132,0.0014859,0.0004214,
1,33,2100,2133,0.0015203,0.0004089,
1,34,2100,2134,0.0015540,0.0003862,
1,35,2100,2135,0.0015941,0.0003570,
1,36,2100,2136,0.0016525,0.0003405,
1,37,2100,2137,0.0017318,0.0003343,
1,38,2100,2138,0.0018255,0.0003449,
1,39,2100,2139,0.0019305,0.0003694,
1,40,2100,2140,0.0020513,0.0004041,
1,41,2100,2141,0.0021897,0.0004478,
1,42,2100,2142,0.0023342,0.0004930,
1,43,2100,2143,0.0024669,0.0005275,
1,44,2100,2144,0.0025867,0.0005443,
1,45,2100,2145,0.0027191,0.0005421,
1,46,2100,2146,0.0028925,0.0005594,
1,47,2100,2147,0.0031101,0.0005958,
1,48,2100,2148,0.0033571,0.0006512,
1,49,2100,2149,0.0036304,0.0007103,
1,50,2100,2150,0.0039379,0.0007605,
1,0,2101,2101,0.0091932,0.0002102,
1,1,2101,2102,0.0006668,0.0000032,
1,2,2101,2103,0.0003367,0.0000021,
1,3,2101,2104,0.0002291,0.0000016,
1,4,2101,2105,0.0001930,0.0000016,
1,5,2101,2106,0.0001870,0.0000022,
1,6,2101,2107,0.0001837,0.0000028,
1,7,2101,2108,0.0001828,0.0000036,
1,8,2101,2109,0.0001845,0.0000045,
1,9,2101,2110,0.0001904,0.0000059,
1,10,2101,2111,0.0002017,0.0000081,
1,11,2101,2112,0.0002200,0.0000113,
1,12,2101,2113,0.0002484,0.0000164,
1,13,2101,2114,0.0002934,0.0000256,
1,14,2101,2115,0.0003624,0.0000440,
1,15,2101,2116,0.0004596,0.0000780,
1,16,2101,2117,0.0005802,0.0001292,
1,17,2101,2118,0.0007098,0.0001880,
1,18,2101,2119,0.0008321,0.0002450,
1,19,2101,2120,0.0009391,0.0002933,
1,20,2101,2121,0.0010297,0.0003308,
1,21,2101,2122,0.0011033,0.0003559,
1,22,2101,2123,0.0011584,0.0003713,
1,23,2101,2124,0.0011978,0.0003863,
1,24,2101,2125,0.0012275,0.0003998,
1,25,2101,2126,0.0012521,0.0003997,
1,26,2101,2127,0.0012759,0.0003957,
1,27,2101,2128,0.0013058,0.0003982,
1,28,2101,2129,0.0013446,0.0004196,
1,29,2101,2130,0.0013859,0.0004343,
1,30,2101,2131,0.0014216,0.0004306,
1,31,2101,2132,0.0014530,0.0004232,
1,32,2101,2133,0.0014859,0.0004173,
1,33,2101,2134,0.0015203,0.0004046,
1,34,2101,2135,0.0015540,0.0003816,
1,35,2101,2136,0.0015941,0.0003523,
1,36,2101,2137,0.0016525,0.0003361,
1,37,2101,2138,0.0017318,0.0003301,
1,38,2101,2139,0.0018255,0.0003405,
1,39,2101,2140,0.0019305,0.0003644,
1,40,2101,2141,0.0020513,0.0003986,
1,41,2101,2142,0.0021897,0.0004423,
1,42,2101,2143,0.0023342,0.0004875,
1,43,2101,2144,0.0024669,0.0005216,
1,44,2101,2145,0.0025867,0.0005377,
1,45,2101,2146,0.0027191,0.0005352,
1,46,2101,2147,0.0028925,0.0005526,
1,47,2101,2148,0.0031101,0.0005891,
1,48,2101,2149,0.0033571,0.0006437,
1,49,2101,2150,0.0036304,0.0007016,
1,0,2102,2102,0.0091932,0.0002014,
1,1,2102,2103,0.0006668,0.0000030,
1,2,2102,2104,0.0003367,0.0000020,
1,3,2102,2105,0.0002291,0.0000015,
1,4,2102,2106,0.0001930,0.0000016,
1,5,2102,2107,0.0001870,0.0000021,
1,6,2102,2108,0.0001837,0.0000027,
1,7,2102,2109,0.0001828,0.0000035,
1,8,2102,2110,0.0001845,0.0000044,
1,9,2102,2111,0.0001904,0.0000057,
1,10,2102,2112,0.0002017,0.0000078,
1,11,2102,2113,0.0002200,0.0000110,
1,12,2102,2114,0.0002484,0.0000159,
1,13,2102,2115,0.0002934,0.0000250,
1,14,2102,2116,0.0003624,0.0000431,
1,15,2102,2117,0.0004596,0.0000767,
1,16,2102,2118,0.0005802,0.0001274,
1,17,2102,2119,0.0007098,0.0001857,
1,18,2102,2120,0.0008321,0.0002421,
1,19,2102,2121,0.0009391,0.0002899,
1,20,2102,2122,0.0010297,0.0003274,
1,21,2102,2123,0.0011033,0.0003524,
1,22,2102,2124,0.0011584,0.0003676,
1,23,2102,2125,0.0011978,0.0003822,
1,24,2102,2126,0.0012275,0.0003955,
1,25,2102,2127,0.0012521,0.0003957,
1,26,2102,2128,0.0012759,0.0003919,
1,27,2102,2129,0.0013058,0.0003943,
1,28,2102,2130,0.0013446,0.0004152,
1,29,2102,2131,0.0013859,0.0004297,
1,30,2102,2132,0.0014216,0.0004262,
1,31,2102,2133,0.0014530,0.0004191,
1,32,2102,2134,0.0014859,0.0004130,
1,33,2102,2135,0.0015203,0.0004000,
1,34,2102,2136,0.0015540,0.0003769,
1,35,2102,2137,0.0015941,0.0003480,
1,36,2102,2138,0.0016525,0.0003321,
1,37,2102,2139,0.0017318,0.0003260,
1,38,2102,2140,0.0018255,0.0003358,
1,39,2102,2141,0.0019305,0.0003594,
1,40,2102,2142,0.0020513,0.0003935,
1,41,2102,2143,0.0021897,0.0004372,
1,42,2102,2144,0.0023342,0.0004819,
1,43,2102,2145,0.0024669,0.0005153,
1,44,2102,2146,0.0025867,0.0005309,
1,45,2102,2147,0.0027191,0.0005287,
1,46,2102,2148,0.0028925,0.0005463,
1,47,2102,2149,0.0031101,0.0005822,
1,48,2102,2150,0.0033571,0.0006357,
1,0,2103,2103,0.0091932,0.0001936,
1,1,2103,2104,0.0006668,0.0000028,
1,2,2103,2105,0.0003367,0.0000019,
1,3,2103,2106,0.0002291,0.0000015,
1,4,2103,2107,0.0001930,0.0000015,
1,5,2103,2108,0.0001870,0.0000020,
1,6,2103,2109,0.0001837,0.0000026,
1,7,2103,2110,0.0001828,0.0000033,
1,8,2103,2111,0.0001845,0.0000042,
1,9,2103,2112,0.0001904,0.0000055,
1,10,2103,2113,0.0002017,0.0000076,
1,11,2103,2114,0.0002200,0.0000107,
1,12,2103,2115,0.0002484,0.0000155,
1,13,2103,2116,0.0002934,0.0000243,
1,14,2103,2117,0.0003624,0.0000422,
1,15,2103,2118,0.0004596,0.0000755,
1,16,2103,2119,0.0005802,0.0001257,
1,17,2103,2120,0.0007098,0.0001833,
1,18,2103,2121,0.0008321,0.0002391,
1,19,2103,2122,0.0009391,0.0002868,
1,20,2103,2123,0.0010297,0.0003241,
1,21,2103,2124,0.0011033,0.0003489,
1,22,2103,2125,0.0011584,0.0003637,
1,23,2103,2126,0.0011978,0.0003780,
1,24,2103,2127,0.0012275,0.0003915,
1,25,2103,2128,0.0012521,0.0003920,
1,26,2103,2129,0.0012759,0.0003881,
1,27,2103,2130,0.0013058,0.0003901,
1,28,2103,2131,0.0013446,0.0004108,
1,29,2103,2132,0.0013859,0.0004255,
1,30,2103,2133,0.0014216,0.0004222,
1,31,2103,2134,0.0014530,0.0004149,
1,32,2103,2135,0.0014859,0.0004085,
1,33,2103,2136,0.0015203,0.0003953,
1,34,2103,2137,0.0015540,0.0003725,
1,35,2103,2138,0.0015941,0.0003440,
1,36,2103,2139,0.0016525,0.0003280,
1,37,2103,2140,0.0017318,0.0003215,
1,38,2103,2141,0.0018255,0.0003311,
1,39,2103,2142,0.0019305,0.0003547,
1,40,2103,2143,0.0020513,0.0003889,
1,41,2103,2144,0.0021897,0.0004321,
1,42,2103,2145,0.0023342,0.0004760,
1,43,2103,2146,0.0024669,0.0005088,
1,44,2103,2147,0.0025867,0.0005247,
1,45,2103,2148,0.0027191,0.0005228,
1,46,2103,2149,0.0028925,0.0005399,
1,47,2103,2150,0.0031101,0.0005748,
1,0,2104,2104,0.0091932,0.0001858,
1,1,2104,2105,0.0006668,0.0000027,
1,2,2104,2106,0.0003367,0.0000018,
1,3,2104,2107,0.0002291,0.0000014,
1,4,2104,2108,0.0001930,0.0000014,
1,5,2104,2109,0.0001870,0.0000019,
1,6,2104,2110,0.0001837,0.0000025,
1,7,2104,2111,0.0001828,0.0000032,
1,8,2104,2112,0.0001845,0.0000040,
1,9,2104,2113,0.0001904,0.0000053,
1,10,2104,2114,0.0002017,0.0000073,
1,11,2104,2115,0.0002200,0.0000104,
1,12,2104,2116,0.0002484,0.0000151,
1,13,2104,2117,0.0002934,0.0000238,
1,14,2104,2118,0.0003624,0.0000414,
1,15,2104,2119,0.0004596,0.0000743,
1,16,2104,2120,0.0005802,0.0001238,
1,17,2104,2121,0.0007098,0.0001808,
1,18,2104,2122,0.0008321,0.0002364,
1,19,2104,2123,0.0009391,0.0002839,
1,20,2104,2124,0.0010297,0.0003209,
1,21,2104,2125,0.0011033,0.0003452,
1,22,2104,2126,0.0011584,0.0003597,
1,23,2104,2127,0.0011978,0.0003741,
1,24,2104,2128,0.0012275,0.0003879,
1,25,2104,2129,0.0012521,0.0003882,
1,26,2104,2130,0.0012759,0.0003839,
1,27,2104,2131,0.0013058,0.0003859,
1,28,2104,2132,0.0013446,0.0004067,
1,29,2104,2133,0.0013859,0.0004216,
1,30,2104,2134,0.0014216,0.0004181,
1,31,2104,2135,0.0014530,0.0004104,
1,32,2104,2136,0.0014859,0.0004038,
1,33,2104,2137,0.0015203,0.0003909,
1,34,2104,2138,0.0015540,0.0003685,
1,35,2104,2139,0.0015941,0.0003400,
1,36,2104,2140,0.0016525,0.0003237,
1,37,2104,2141,0.0017318,0.0003170,
1,38,2104,2142,0.0018255,0.0003267,
1,39,2104,2143,0.0019305,0.0003504,
1,40,2104,2144,0.0020513,0.0003842,
1,41,2104,2145,0.0021897,0.0004266,
1,42,2104,2146,0.0023342,0.0004700,
1,43,2104,2147,0.0024669,0.0005028,
1,44,2104,2148,0.0025867,0.0005189,
1,45,2104,2149,0.0027191,0.0005167,
1,46,2104,2150,0.0028925,0.0005330,
1,0,2105,2105,0.0091932,0.0001777,
1,1,2105,2106,0.0006668,0.0000025,
1,2,2105,2107,0.0003367,0.0000017,
1,3,2105,2108,0.0002291,0.0000013,
1,4,2105,2109,0.0001930,0.0000013,
1,5,2105,2110,0.0001870,0.0000018,
1,6,2105,2111,0.0001837,0.0000024,
1,7,2105,2112,0.0001828,0.0000031,
1,8,2105,2113,0.0001845,0.0000039,
1,9,2105,2114,0.0001904,0.0000051,
1,10,2105,2115,0.0002017,0.0000071,
1,11,2105,2116,0.0002200,0.0000100,
1,12,2105,2117,0.0002484,0.0000147,
1,13,2105,2118,0.0002934,0.0000232,
1,14,2105,2119,0.0003624,0.0000406,
1,15,2105,2120,0.0004596,0.0000729,
1,16,2105,2121,0.0005802,0.0001219,
1,17,2105,2122,0.0007098,0.0001785,
1,18,2105,2123,0.0008321,0.0002338,
1,19,2105,2124,0.0009391,0.0002809,
1,20,2105,2125,0.0010297,0.0003174,
1,21,2105,2126,0.0011033,0.0003414,
1,22,2105,2127,0.0011584,0.0003559,
1,23,2105,2128,0.0011978,0.0003706,
1,24,2105,2129,0.0012275,0.0003842,
1,25,2105,2130,0.0012521,0.0003842,
1,26,2105,2131,0.0012759,0.0003798,
1,27,2105,2132,0.0013058,0.0003819,
1,28,2105,2133,0.0013446,0.0004029,
1,29,2105,2134,0.0013859,0.0004176,
1,30,2105,2135,0.0014216,0.0004137,
1,31,2105,2136,0.0014530,0.0004059,
1,32,2105,2137,0.0014859,0.0003995,
1,33,2105,2138,0.0015203,0.0003869,
1,34,2105,2139,0.0015540,0.0003645,
1,35,2105,2140,0.0015941,0.0003357,
1,36,2105,2141,0.0016525,0.0003193,
1,37,2105,2142,0.0017318,0.0003128,
1,38,2105,2143,0.0018255,0.0003227,
1,39,2105,2144,0.0019305,0.0003460,
1,40,2105,2145,0.0020513,0.0003792,
1,41,2105,2146,0.0021897,0.0004211,
1,42,2105,2147,0.0023342,0.0004643,
1,43,2105,2148,0.0024669,0.0004974,
1,44,2105,2149,0.0025867,0.0005131,
1,45,2105,2150,0.0027191,0.0005102,
1,0,2106,2106,0.0091932,0.0001697,
1,1,2106,2107,0.0006668,0.0000023,
1,2,2106,2108,0.0003367,0.0000016,
1,3,2106,2109,0.0002291,0.0000012,
1,4,2106,2110,0.0001930,0.0000013,
1,5,2106,2111,0.0001870,0.0000018,
1,6,2106,2112,0.0001837,0.0000023,
1,7,2106,2113,0.0001828,0.0000029,
1,8,2106,2114,0.0001845,0.0000037,
1,9,2106,2115,0.0001904,0.0000049,
1,10,2106,2116,0.0002017,0.0000068,
1,11,2106,2117,0.0002200,0.0000097,
1,12,2106,2118,0.0002484,0.0000143,
1,13,2106,2119,0.0002934,0.0000227,
1,14,2106,2120,0.0003624,0.0000397,
1,15,2106,2121,0.0004596,0.0000716,
1,16,2106,2122,0.0005802,0.0001201,
1,17,2106,2123,0.0007098,0.0001764,
1,18,2106,2124,0.0008321,0.0002312,
1,19,2106,2125,0.0009391,0.0002777,
1,20,2106,2126,0.0010297,0.0003138,
1,21,2106,2127,0.0011033,0.0003378,
1,22,2106,2128,0.0011584,0.0003525,
1,23,2106,2129,0.0011978,0.0003670,
1,24,2106,2130,0.0012275,0.0003802,
1,25,2106,2131,0.0012521,0.0003801,
1,26,2106,2132,0.0012759,0.0003759,
1,27,2106,2133,0.0013058,0.0003782,
1,28,2106,2134,0.0013446,0.0003990,
1,29,2106,2135,0.0013859,0.0004132,
1,30,2106,2136,0.0014216,0.0004092,
1,31,2106,2137,0.0014530,0.0004016,
1,32,2106,2138,0.0014859,0.0003956,
1,33,2106,2139,0.0015203,0.0003829,
1,34,2106,2140,0.0015540,0.0003601,
1,35,2106,2141,0.0015941,0.0003313,
1,36,2106,2142,0.0016525,0.0003152,
1,37,2106,2143,0.0017318,0.0003090,
1,38,2106,2144,0.0018255,0.0003186,
1,39,2106,2145,0.0019305,0.0003414,
1,40,2106,2146,0.0020513,0.0003741,
1,41,2106,2147,0.0021897,0.0004159,
1,42,2106,2148,0.0023342,0.0004592,
1,43,2106,2149,0.0024669,0.0004918,
1,44,2106,2150,0.0025867,0.0005068,
1,0,2107,2107,0.0091932,0.0001626,
1,1,2107,2108,0.0006668,0.0000022,
1,2,2107,2109,0.0003367,0.0000015,
1,3,2107,2110,0.0002291,0.0000012,
1,4,2107,2111,0.0001930,0.0000012,
1,5,2107,2112,0.0001870,0.0000017,
1,6,2107,2113,0.0001837,0.0000022,
1,7,2107,2114,0.0001828,0.0000028,
1,8,2107,2115,0.0001845,0.0000036,
1,9,2107,2116,0.0001904,0.0000047,
1,10,2107,2117,0.0002017,0.0000066,
1,11,2107,2118,0.0002200,0.0000095,
1,12,2107,2119,0.0002484,0.0000139,
1,13,2107,2120,0.0002934,0.0000221,
1,14,2107,2121,0.0003624,0.0000388,
1,15,2107,2122,0.0004596,0.0000704,
1,16,2107,2123,0.0005802,0.0001185,
1,17,2107,2124,0.0007098,0.0001743,
1,18,2107,2125,0.0008321,0.0002285,
1,19,2107,2126,0.0009391,0.0002745,
1,20,2107,2127,0.0010297,0.0003105,
1,21,2107,2128,0.0011033,0.0003345,
1,22,2107,2129,0.0011584,0.0003490,
1,23,2107,2130,0.0011978,0.0003631,
1,24,2107,2131,0.0012275,0.0003762,
1,25,2107,2132,0.0012521,0.0003762,
1,26,2107,2133,0.0012759,0.0003723,
1,27,2107,2134,0.0013058,0.0003745,
1,28,2107,2135,0.0013446,0.0003948,
1,29,2107,2136,0.0013859,0.0004088,
1,30,2107,2137,0.0014216,0.0004050,
1,31,2107,2138,0.0014530,0.0003978,
1,32,2107,2139,0.0014859,0.0003916,
1,33,2107,2140,0.0015203,0.0003785,
1,34,2107,2141,0.0015540,0.0003558,
1,35,2107,2142,0.0015941,0.0003273,
1,36,2107,2143,0.0016525,0.0003115,
1,37,2107,2144,0.0017318,0.0003051,
1,38,2107,2145,0.0018255,0.0003143,
1,39,2107,2146,0.0019305,0.0003367,
1,40,2107,2147,0.0020513,0.0003693,
1,41,2107,2148,0.0021897,0.0004112,
1,42,2107,2149,0.0023342,0.0004540,
1,43,2107,2150,0.0024669,0.0004858,
1,0,2108,2108,0.0091932,0.0001562,
1,1,2108,2109,0.0006668,0.0000021,
1,2,2108,2110,0.0003367,0.0000014,
1,3,2108,2111,0.0002291,0.0000011,
1,4,2108,2112,0.0001930,0.0000011,
1,5,2108,2113,0.0001870,0.0000016,
1,6,2108,2114,0.0001837,0.0000021,
1,7,2108,2115,0.0001828,0.0000027,
1,8,2108,2116,0.0001845,0.0000035,
1,9,2108,2117,0.0001904,0.0000046,
1,10,2108,2118,0.0002017,0.0000064,
1,11,2108,2119,0.0002200,0.0000092,
1,12,2108,2120,0.0002484,0.0000135,
1,13,2108,2121,0.0002934,0.0000216,
1,14,2108,2122,0.0003624,0.0000380,
1,15,2108,2123,0.0004596,0.0000692,
1,16,2108,2124,0.0005802,0.0001169,
1,17,2108,2125,0.0007098,0.0001720,
1,18,2108,2126,0.0008321,0.0002256,
1,19,2108,2127,0.0009391,0.0002715,
1,20,2108,2128,0.0010297,0.0003075,
1,21,2108,2129,0.0011033,0.0003312,
1,22,2108,2130,0.0011584,0.0003453,
1,23,2108,2131,0.0011978,0.0003592,
1,24,2108,2132,0.0012275,0.0003724,
1,25,2108,2133,0.0012521,0.0003727,
1,26,2108,2134,0.0012759,0.0003686,
1,27,2108,2135,0.0013058,0.0003704,
1,28,2108,2136,0.0013446,0.0003905,
1,29,2108,2137,0.0013859,0.0004047,
1,30,2108,2138,0.0014216,0.0004012,
1,31,2108,2139,0.0014530,0.0003938,
1,32,2108,2140,0.0014859,0.0003873,
1,33,2108,2141,0.0015203,0.0003742,
1,34,2108,2142,0.0015540,0.0003517,
1,35,2108,2143,0.0015941,0.0003236,
1,36,2108,2144,0.0016525,0.0003077,
1,37,2108,2145,0.0017318,0.0003010,
1,38,2108,2146,0.0018255,0.0003099,
1,39,2108,2147,0.0019305,0.0003323,
1,40,2108,2148,0.0020513,0.0003650,
1,41,2108,2149,0.0021897,0.0004064,
1,42,2108,2150,0.0023342,0.0004483,
1,0,2109,2109,0.0091932,0.0001499,
1,1,2109,2110,0.0006668,0.0000020,
1,2,2109,2111,0.0003367,0.0000014,
1,3,2109,2112,0.0002291,0.0000010,
1,4,2109,2113,0.0001930,0.0000011,
1,5,2109,2114,0.0001870,0.0000015,
1,6,2109,2115,0.0001837,0.0000020,
1,7,2109,2116,0.0001828,0.0000026,
1,8,2109,2117,0.0001845,0.0000033,
1,9,2109,2118,0.0001904,0.0000044,
1,10,2109,2119,0.0002017,0.0000062,
1,11,2109,2120,0.0002200,0.0000089,
1,12,2109,2121,0.0002484,0.0000131,
1,13,2109,2122,0.0002934,0.0000211,
1,14,2109,2123,0.0003624,0.0000373,
1,15,2109,2124,0.0004596,0.0000681,
1,16,2109,2125,0.0005802,0.0001151,
1,17,2109,2126,0.0007098,0.0001697,
1,18,2109,2127,0.0008321,0.0002230,
1,19,2109,2128,0.0009391,0.0002688,
1,20,2109,2129,0.0010297,0.0003044,
1,21,2109,2130,0.0011033,0.0003277,
1,22,2109,2131,0.0011584,0.0003415,
1,23,2109,2132,0.0011978,0.0003556,
1,24,2109,2133,0.0012275,0.0003690,
1,25,2109,2134,0.0012521,0.0003691,
1,26,2109,2135,0.0012759,0.0003647,
1,27,2109,2136,0.0013058,0.0003663,
1,28,2109,2137,0.0013446,0.0003866,
1,29,2109,2138,0.0013859,0.0004010,
1,30,2109,2139,0.0014216,0.0003974,
1,31,2109,2140,0.0014530,0.0003896,
1,32,2109,2141,0.0014859,0.0003830,
1,33,2109,2142,0.0015203,0.0003701,
1,34,2109,2143,0.0015540,0.0003479,
1,35,2109,2144,0.0015941,0.0003198,
1,36,2109,2145,0.0016525,0.0003037,
1,37,2109,2146,0.0017318,0.0002968,
1,38,2109,2147,0.0018255,0.0003058,
1,39,2109,2148,0.0019305,0.0003283,
1,40,2109,2149,0.0020513,0.0003606,
1,41,2109,2150,0.0021897,0.0004012,
1,0,2110,2110,0.0091932,0.0001433,
1,1,2110,2111,0.0006668,0.0000018,
1,2,2110,2112,0.0003367,0.0000013,
1,3,2110,2113,0.0002291,0.0000010,
1,4,2110,2114,0.0001930,0.0000010,
1,5,2110,2115,0.0001870,0.0000015,
1,6,2110,2116,0.0001837,0.0000019,
1,7,2110,2117,0.0001828,0.0000025,
1,8,2110,2118,0.0001845,0.0000032,
1,9,2110,2119,0.0001904,0.0000043,
1,10,2110,2120,0.0002017,0.0000060,
1,11,2110,2121,0.0002200,0.0000086,
1,12,2110,2122,0.0002484,0.0000128,
1,13,2110,2123,0.0002934,0.0000206,
1,14,2110,2124,0.0003624,0.0000366,
1,15,2110,2125,0.0004596,0.0000669,
1,16,2110,2126,0.0005802,0.0001134,
1,17,2110,2127,0.0007098,0.0001675,
1,18,2110,2128,0.0008321,0.0002206,
1,19,2110,2129,0.0009391,0.0002660,
1,20,2110,2130,0.0010297,0.0003011,
1,21,2110,2131,0.0011033,0.0003241,
1,22,2110,2132,0.0011584,0.0003380,
1,23,2110,2133,0.0011978,0.0003522,
1,24,2110,2134,0.0012275,0.0003654,
1,25,2110,2135,0.0012521,0.0003652,
1,26,2110,2136,0.0012759,0.0003607,
1,27,2110,2137,0.0013058,0.0003625,
1,28,2110,2138,0.0013446,0.0003830,
1,29,2110,2139,0.0013859,0.0003972,
1,30,2110,2140,0.0014216,0.0003932,
1,31,2110,2141,0.0014530,0.0003853,
1,32,2110,2142,0.0014859,0.0003789,
1,33,2110,2143,0.0015203,0.0003663,
1,34,2110,2144,0.0015540,0.0003442,
1,35,2110,2145,0.0015941,0.0003158,
1,36,2110,2146,0.0016525,0.0002996,
1,37,2110,2147,0.0017318,0.0002929,
1,38,2110,2148,0.0018255,0.0003020,
1,39,2110,2149,0.0019305,0.0003242,
1,40,2110,2150,0.0020513,0.0003558,
1,0,2111,2111,0.0091932,0.0001368,
1,1,2111,2112,0.0006668,0.0000017,
1,2,2111,2113,0.0003367,0.0000012,
1,3,2111,2114,0.0002291,0.0000009,
1,4,2111,2115,0.0001930,0.0000010,
1,5,2111,2116,0.0001870,0.0000014,
1,6,2111,2117,0.0001837,0.0000018,
1,7,2111,2118,0.0001828,0.0000024,
1,8,2111,2119,0.0001845,0.0000031,
1,9,2111,2120,0.0001904,0.0000041,
1,10,2111,2121,0.0002017,0.0000058,
1,11,2111,2122,0.0002200,0.0000084,
1,12,2111,2123,0.0002484,0.0000125,
1,13,2111,2124,0.0002934,0.0000201,
1,14,2111,2125,0.0003624,0.0000358,
1,15,2111,2126,0.0004596,0.0000657,
1,16,2111,2127,0.0005802,0.0001117,
1,17,2111,2128,0.0007098,0.0001656,
1,18,2111,2129,0.0008321,0.0002182,
1,19,2111,2130,0.0009391,0.0002630,
1,20,2111,2131,0.0010297,0.0002978,
1,21,2111,2132,0.0011033,0.0003207,
1,22,2111,2133,0.0011584,0.0003347,
1,23,2111,2134,0.0011978,0.0003487,
1,24,2111,2135,0.0012275,0.0003616,
1,25,2111,2136,0.0012521,0.0003612,
1,26,2111,2137,0.0012759,0.0003569,
1,27,2111,2138,0.0013058,0.0003590,
1,28,2111,2139,0.0013446,0.0003793,
1,29,2111,2140,0.0013859,0.0003931,
1,30,2111,2141,0.0014216,0.0003890,
1,31,2111,2142,0.0014530,0.0003814,
1,32,2111,2143,0.0014859,0.0003752,
1,33,2111,2144,0.0015203,0.0003625,
1,34,2111,2145,0.0015540,0.0003401,
1,35,2111,2146,0.0015941,0.0003117,
1,36,2111,2147,0.0016525,0.0002958,
1,37,2111,2148,0.0017318,0.0002893,
1,38,2111,2149,0.0018255,0.0002982,
1,39,2111,2150,0.0019305,0.0003198,
1,0,2112,2112,0.0091932,0.0001310,
1,1,2112,2113,0.0006668,0.0000016,
1,2,2112,2114,0.0003367,0.0000012,
1,3,2112,2115,0.0002291,0.0000009,
1,4,2112,2116,0.0001930,0.0000009,
1,5,2112,2117,0.0001870,0.0000013,
1,6,2112,2118,0.0001837,0.0000017,
1,7,2112,2119,0.0001828,0.0000023,
1,8,2112,2120,0.0001845,0.0000030,
1,9,2112,2121,0.0001904,0.0000040,
1,10,2112,2122,0.0002017,0.0000056,
1,11,2112,2123,0.0002200,0.0000082,
1,12,2112,2124,0.0002484,0.0000121,
1,13,2112,2125,0.0002934,0.0000196,
1,14,2112,2126,0.0003624,0.0000350,
1,15,2112,2127,0.0004596,0.0000645,
1,16,2112,2128,0.0005802,0.0001102,
1,17,2112,2129,0.0007098,0.0001636,
1,18,2112,2130,0.0008321,0.0002156,
1,19,2112,2131,0.0009391,0.0002600,
1,20,2112,2132,0.0010297,0.0002946,
1,21,2112,2133,0.0011033,0.0003176,
1,22,2112,2134,0.0011584,0.0003314,
1,23,2112,2135,0.0011978,0.0003450,
1,24,2112,2136,0.0012275,0.0003577,
1,25,2112,2137,0.0012521,0.0003575,
1,26,2112,2138,0.0012759,0.0003535,
1,27,2112,2139,0.0013058,0.0003555,
1,28,2112,2140,0.0013446,0.0003754,
1,29,2112,2141,0.0013859,0.0003890,
1,30,2112,2142,0.0014216,0.0003850,
1,31,2112,2143,0.0014530,0.0003777,
1,32,2112,2144,0.0014859,0.0003715,
1,33,2112,2145,0.0015203,0.0003585,
1,34,2112,2146,0.0015540,0.0003360,
1,35,2112,2147,0.0015941,0.0003079,
1,36,2112,2148,0.0016525,0.0002923,
1,37,2112,2149,0.0017318,0.0002857,
1,38,2112,2150,0.0018255,0.0002941,
1,0,2113,2113,0.0091932,0.0001259,
1,1,2113,2114,0.0006668,0.0000015,
1,2,2113,2115,0.0003367,0.0000011,
1,3,2113,2116,0.0002291,0.0000008,
1,4,2113,2117,0.0001930,0.0000009,
1,5,2113,2118,0.0001870,0.0000013,
1,6,2113,2119,0.0001837,0.0000017,
1,7,2113,2120,0.0001828,0.0000022,
1,8,2113,2121,0.0001845,0.0000028,
1,9,2113,2122,0.0001904,0.0000038,
1,10,2113,2123,0.0002017,0.0000054,
1,11,2113,2124,0.0002200,0.0000079,
1,12,2113,2125,0.0002484,0.0000118,
1,13,2113,2126,0.0002934,0.0000191,
1,14,2113,2127,0.0003624,0.0000343,
1,15,2113,2128,0.0004596,0.0000635,
1,16,2113,2129,0.0005802,0.0001087,
1,17,2113,2130,0.0007098,0.0001614,
1,18,2113,2131,0.0008321,0.0002130,
1,19,2113,2132,0.0009391,0.0002572,
1,20,2113,2133,0.0010297,0.0002918,
1,21,2113,2134,0.0011033,0.0003145,
1,22,2113,2135,0.0011584,0.0003278,
1,23,2113,2136,0.0011978,0.0003412,
1,24,2113,2137,0.0012275,0.0003541,
1,25,2113,2138,0.0012521,0.0003542,
1,26,2113,2139,0.0012759,0.0003501,
1,27,2113,2140,0.0013058,0.0003517,
1,28,2113,2141,0.0013446,0.0003714,
1,29,2113,2142,0.0013859,0.0003851,
1,30,2113,2143,0.0014216,0.0003815,
1,31,2113,2144,0.0014530,0.0003740,
1,32,2113,2145,0.0014859,0.0003674,
1,33,2113,2146,0.0015203,0.0003544,
1,34,2113,2147,0.0015540,0.0003321,
1,35,2113,2148,0.0015941,0.0003045,
1,36,2113,2149,0.0016525,0.0002887,
1,37,2113,2150,0.0017318,0.0002818,
1,0,2114,2114,0.0091932,0.0001209,
1,1,2114,2115,0.0006668,0.0000015,
1,2,2114,2116,0.0003367,0.0000010,
1,3,2114,2117,0.0002291,0.0000008,
1,4,2114,2118,0.0001930,0.0000008,
1,5,2114,2119,0.0001870,0.0000012,
1,6,2114,2120,0.0001837,0.0000016,
1,7,2114,2121,0.0001828,0.0000021,
1,8,2114,2122,0.0001845,0.0000027,
1,9,2114,2123,0.0001904,0.0000037,
1,10,2114,2124,0.0002017,0.0000053,
1,11,2114,2125,0.0002200,0.0000077,
1,12,2114,2126,0.0002484,0.0000115,
1,13,2114,2127,0.0002934,0.0000186,
1,14,2114,2128,0.0003624,0.0000336,
1,15,2114,2129,0.0004596,0.0000625,
1,16,2114,2130,0.0005802,0.0001071,
1,17,2114,2131,0.0007098,0.0001593,
1,18,2114,2132,0.0008321,0.0002105,
1,19,2114,2133,0.0009391,0.0002546,
1,20,2114,2134,0.0010297,0.0002888,
1,21,2114,2135,0.0011033,0.0003111,
1,22,2114,2136,0.0011584,0.0003242,
1,23,2114,2137,0.0011978,0.0003377,
1,24,2114,2138,0.0012275,0.0003508,
1,25,2114,2139,0.0012521,0.0003508,
1,26,2114,2140,0.0012759,0.0003463,
1,27,2114,2141,0.0013058,0.0003478,
1,28,2114,2142,0.0013446,0.0003676,
1,29,2114,2143,0.0013859,0.0003816,
1,30,2114,2144,0.0014216,0.0003778,
1,31,2114,2145,0.0014530,0.0003700,
1,32,2114,2146,0.0014859,0.0003633,
1,33,2114,2147,0.0015203,0.0003505,
1,34,2114,2148,0.0015540,0.0003286,
1,35,2114,2149,0.0015941,0.0003009,
1,36,2114,2150,0.0016525,0.0002849,
1,0,2115,2115,0.0091932,0.0001156,
1,1,2115,2116,0.0006668,0.0000014,
1,2,2115,2117,0.0003367,0.0000010,
1,3,2115,2118,0.0002291,0.0000008,
1,4,2115,2119,0.0001930,0.0000008,
1,5,2115,2120,0.0001870,0.0000011,
1,6,2115,2121,0.0001837,0.0000015,
1,7,2115,2122,0.0001828,0.0000020,
1,8,2115,2123,0.0001845,0.0000026,
1,9,2115,2124,0.0001904,0.0000036,
1,10,2115,2125,0.0002017,0.0000051,
1,11,2115,2126,0.0002200,0.0000074,
1,12,2115,2127,0.0002484,0.0000112,
1,13,2115,2128,0.0002934,0.0000182,
1,14,2115,2129,0.0003624,0.0000330,
1,15,2115,2130,0.0004596,0.0000614,
1,16,2115,2131,0.0005802,0.0001055,
1,17,2115,2132,0.0007098,0.0001573,
1,18,2115,2133,0.0008321,0.0002083,
1,19,2115,2134,0.0009391,0.0002519,
1,20,2115,2135,0.0010297,0.0002856,
1,21,2115,2136,0.0011033,0.0003076,
1,22,2115,2137,0.0011584,0.0003208,
1,23,2115,2138,0.0011978,0.0003345,
1,24,2115,2139,0.0012275,0.0003474,
1,25,2115,2140,0.0012521,0.0003471,
1,26,2115,2141,0.0012759,0.0003426,
1,27,2115,2142,0.0013058,0.0003443,
1,28,2115,2143,0.0013446,0.0003642,
1,29,2115,2144,0.0013859,0.0003780,
1,30,2115,2145,0.0014216,0.0003739,
1,31,2115,2146,0.0014530,0.0003660,
1,32,2115,2147,0.0014859,0.0003595,
1,33,2115,2148,0.0015203,0.0003470,
1,34,2115,2149,0.0015540,0.0003250,
1,35,2115,2150,0.0015941,0.0002971,
1,0,2116,2116,0.0091932,0.0001105,
1,1,2116,2117,0.0006668,0.0000013,
1,2,2116,2118,0.0003367,0.0000009,
1,3,2116,2119,0.0002291,0.0000007,
1,4,2116,2120,0.0001930,0.0000008,
1,5,2116,2121,0.0001870,0.0000011,
1,6,2116,2122,0.0001837,0.0000015,
1,7,2116,2123,0.0001828,0.0000019,
1,8,2116,2124,0.0001845,0.0000025,
1,9,2116,2125,0.0001904,0.0000034,
1,10,2116,2126,0.0002017,0.0000049,
1,11,2116,2127,0.0002200,0.0000072,
1,12,2116,2128,0.0002484,0.0000109,
1,13,2116,2129,0.0002934,0.0000178,
1,14,2116,2130,0.0003624,0.0000323,
1,15,2116,2131,0.0004596,0.0000603,
1,16,2116,2132,0.0005802,0.0001040,
1,17,2116,2133,0.0007098,0.0001554,
1,18,2116,2134,0.0008321,0.0002060,
1,19,2116,2135,0.0009391,0.0002490,
1,20,2116,2136,0.0010297,0.0002824,
1,21,2116,2137,0.0011033,0.0003044,
1,22,2116,2138,0.0011584,0.0003177,
1,23,2116,2139,0.0011978,0.0003313,
1,24,2116,2140,0.0012275,0.0003438,
1,25,2116,2141,0.0012521,0.0003434,
1,26,2116,2142,0.0012759,0.0003391,
1,27,2116,2143,0.0013058,0.0003410,
1,28,2116,2144,0.0013446,0.0003608,
1,29,2116,2145,0.0013859,0.0003742,
1,30,2116,2146,0.0014216,0.0003699,
1,31,2116,2147,0.0014530,0.0003622,
1,32,2116,2148,0.0014859,0.0003560,
1,33,2116,2149,0.0015203,0.0003434,
1,34,2116,2150,0.0015540,0.0003212,
1,0,2117,2117,0.0091932,0.0001059,
1,1,2117,2118,0.0006668,0.0000012,
1,2,2117,2119,0.0003367,0.0000009,
1,3,2117,2120,0.0002291,0.0000007,
1,4,2117,2121,0.0001930,0.0000007,
1,5,2117,2122,0.0001870,0.0000010,
1,6,2117,2123,0.0001837,0.0000014,
1,7,2117,2124,0.0001828,0.0000019,
1,8,2117,2125,0.0001845,0.0000024,
1,9,2117,2126,0.0001904,0.0000033,
1,10,2117,2127,0.0002017,0.0000048,
1,11,2117,2128,0.0002200,0.0000070,
1,12,2117,2129,0.0002484,0.0000106,
1,13,2117,2130,0.0002934,0.0000174,
1,14,2117,2131,0.0003624,0.0000316,
1,15,2117,2132,0.0004596,0.0000592,
1,16,2117,2133,0.0005802,0.0001026,
1,17,2117,2134,0.0007098,0.0001535,
1,18,2117,2135,0.0008321,0.0002035,
1,19,2117,2136,0.0009391,0.0002461,
1,20,2117,2137,0.0010297,0.0002794,
1,21,2117,2138,0.0011033,0.0003014,
1,22,2117,2139,0.0011584,0.0003146,
1,23,2117,2140,0.0011978,0.0003278,
1,24,2117,2141,0.0012275,0.0003402,
1,25,2117,2142,0.0012521,0.0003399,
1,26,2117,2143,0.0012759,0.0003358,
1,27,2117,2144,0.0013058,0.0003376,
1,28,2117,2145,0.0013446,0.0003571,
1,29,2117,2146,0.0013859,0.0003703,
1,30,2117,2147,0.0014216,0.0003662,
1,31,2117,2148,0.0014530,0.0003588,
1,32,2117,2149,0.0014859,0.0003525,
1,33,2117,2150,0.0015203,0.0003395,
1,0,2118,2118,0.0091932,0.0001017,
1,1,2118,2119,0.0006668,0.0000011,
1,2,2118,2120,0.0003367,0.0000008,
1,3,2118,2121,0.0002291,0.0000006,
1,4,2118,2122,0.0001930,0.0000007,
1,5,2118,2123,0.0001870,0.0000010,
1,6,2118,2124,0.0001837,0.0000013,
1,7,2118,2125,0.0001828,0.0000018,
1,8,2118,2126,0.0001845,0.0000023,
1,9,2118,2127,0.0001904,0.0000032,
1,10,2118,2128,0.0002017,0.0000046,
1,11,2118,2129,0.0002200,0.0000068,
1,12,2118,2130,0.0002484,0.0000103,
1,13,2118,2131,0.0002934,0.0000169,
1,14,2118,2132,0.0003624,0.0000309,
1,15,2118,2133,0.0004596,0.0000583,
1,16,2118,2134,0.0005802,0.0001011,
1,17,2118,2135,0.0007098,0.0001515,
1,18,2118,2136,0.0008321,0.0002010,
1,19,2118,2137,0.0009391,0.0002434,
1,20,2118,2138,0.0010297,0.0002767,
1,21,2118,2139,0.0011033,0.0002985,
1,22,2118,2140,0.0011584,0.0003112,
1,23,2118,2141,0.0011978,0.0003242,
1,24,2118,2142,0.0012275,0.0003368,
1,25,2118,2143,0.0012521,0.0003368,
1,26,2118,2144,0.0012759,0.0003326,
1,27,2118,2145,0.0013058,0.0003341,
1,28,2118,2146,0.0013446,0.0003533,
1,29,2118,2147,0.0013859,0.0003666,
1,30,2118,2148,0.0014216,0.0003628,
1,31,2118,2149,0.0014530,0.0003553,
1,32,2118,2150,0.0014859,0.0003486,
1,0,2119,2119,0.0091932,0.0000976,
1,1,2119,2120,0.0006668,0.0000011,
1,2,2119,2121,0.0003367,0.0000008,
1,3,2119,2122,0.0002291,0.0000006,
1,4,2119,2123,0.0001930,0.0000006,
1,5,2119,2124,0.0001870,0.0000009,
1,6,2119,2125,0.0001837,0.0000013,
1,7,2119,2126,0.0001828,0.0000017,
1,8,2119,2127,0.0001845,0.0000023,
1,9,2119,2128,0.0001904,0.0000031,
1,10,2119,2129,0.0002017,0.0000045,
1,11,2119,2130,0.0002200,0.0000066,
1,12,2119,2131,0.0002484,0.0000100,
1,13,2119,2132,0.0002934,0.0000165,
1,14,2119,2133,0.0003624,0.0000303,
1,15,2119,2134,0.0004596,0.0000573,
1,16,2119,2135,0.0005802,0.0000996,
1,17,2119,2136,0.0007098,0.0001495,
1,18,2119,2137,0.0008321,0.0001986,
1,19,2119,2138,0.0009391,0.0002410,
1,20,2119,2139,0.0010297,0.0002739,
1,21,2119,2140,0.0011033,0.0002953,
1,22,2119,2141,0.0011584,0.0003078,
1,23,2119,2142,0.0011978,0.0003209,
1,24,2119,2143,0.0012275,0.0003337,
1,25,2119,2144,0.0012521,0.0003335,
1,26,2119,2145,0.0012759,0.0003291,
1,27,2119,2146,0.0013058,0.0003304,
1,28,2119,2147,0.0013446,0.0003498,
1,29,2119,2148,0.0013859,0.0003633,
1,30,2119,2149,0.0014216,0.0003593,
1,31,2119,2150,0.0014530,0.0003515,
1,0,2120,2120,0.0091932,0.0000933,
1,1,2120,2121,0.0006668,0.0000010,
1,2,2120,2122,0.0003367,0.0000007,
1,3,2120,2123,0.0002291,0.0000006,
1,4,2120,2124,0.0001930,0.0000006,
1,5,2120,2125,0.0001870,0.0000009,
1,6,2120,2126,0.0001837,0.0000012,
1,7,2120,2127,0.0001828,0.0000016,
1,8,2120,2128,0.0001845,0.0000022,
1,9,2120,2129,0.0001904,0.0000030,
1,10,2120,2130,0.0002017,0.0000043,
1,11,2120,2131,0.0002200,0.0000064,
1,12,2120,2132,0.0002484,0.0000097,
1,13,2120,2133,0.0002934,0.0000162,
1,14,2120,2134,0.0003624,0.0000297,
1,15,2120,2135,0.0004596,0.0000563,
1,16,2120,2136,0.0005802,0.0000981,
1,17,2120,2137,0.0007098,0.0001476,
1,18,2120,2138,0.0008321,0.0001965,
1,19,2120,2139,0.0009391,0.0002385,
1,20,2120,2140,0.0010297,0.0002709,
1,21,2120,2141,0.0011033,0.0002920,
1,22,2120,2142,0.0011584,0.0003046,
1,23,2120,2143,0.0011978,0.0003179,
1,24,2120,2144,0.0012275,0.0003305,
1,25,2120,2145,0.0012521,0.0003301,
1,26,2120,2146,0.0012759,0.0003255,
1,27,2120,2147,0.0013058,0.0003271,
1,28,2120,2148,0.0013446,0.0003465,
1,29,2120,2149,0.0013859,0.0003599,
1,30,2120,2150,0.0014216,0.0003556,
1,0,2121,2121,0.0091932,0.0000891,
1,1,2121,2122,0.0006668,0.0000010,
1,2,2121,2123,0.0003367,0.0000007,
1,3,2121,2124,0.0002291,0.0000005,
1,4,2121,2125,0.0001930,0.0000006,
1,5,2121,2126,0.0001870,0.0000009,
1,6,2121,2127,0.0001837,0.0000012,
1,7,2121,2128,0.0001828,0.0000016,
1,8,2121,2129,0.0001845,0.0000021,
1,9,2121,2130,0.0001904,0.0000029,
1,10,2121,2131,0.0002017,0.0000042,
1,11,2121,2132,0.0002200,0.0000062,
1,12,2121,2133,0.0002484,0.0000095,
1,13,2121,2134,0.0002934,0.0000158,
1,14,2121,2135,0.0003624,0.0000291,
1,15,2121,2136,0.0004596,0.0000553,
1,16,2121,2137,0.0005802,0.0000967,
1,17,2121,2138,0.0007098,0.0001458,
1,18,2121,2139,0.0008321,0.0001943,
1,19,2121,2140,0.0009391,0.0002358,
1,20,2121,2141,0.0010297,0.0002679,
1,21,2121,2142,0.0011033,0.0002890,
1,22,2121,2143,0.0011584,0.0003017,
1,23,2121,2144,0.0011978,0.0003148,
1,24,2121,2145,0.0012275,0.0003271,
1,25,2121,2146,0.0012521,0.0003266,
1,26,2121,2147,0.0012759,0.0003222,
1,27,2121,2148,0.0013058,0.0003239,
1,28,2121,2149,0.0013446,0.0003432,
1,29,2121,2150,0.0013859,0.0003562,
1,0,2122,2122,0.0091932,0.0000854,
1,1,2122,2123,0.0006668,0.0000009,
1,2,2122,2124,0.0003367,0.0000007,
1,3,2122,2125,0.0002291,0.0000005,
1,4,2122,2126,0.0001930,0.0000006,
1,5,2122,2127,0.0001870,0.0000008,
1,6,2122,2128,0.0001837,0.0000011,
1,7,2122,2129,0.0001828,0.0000015,
1,8,2122,2130,0.0001845,0.0000020,
1,9,2122,2131,0.0001904,0.0000028,
1,10,2122,2132,0.0002017,0.0000040,
1,11,2122,2133,0.0002200,0.0000060,
1,12,2122,2134,0.0002484,0.0000093,
1,13,2122,2135,0.0002934,0.0000154,
1,14,2122,2136,0.0003624,0.0000285,
1,15,2122,2137,0.0004596,0.0000543,
1,16,2122,2138,0.0005802,0.0000954,
1,17,2122,2139,0.0007098,0.0001441,
1,18,2122,2140,0.0008321,0.0001920,
1,19,2122,2141,0.0009391,0.0002331,
1,20,2122,2142,0.0010297,0.0002651,
1,21,2122,2143,0.0011033,0.0002862,
1,22,2122,2144,0.0011584,0.0002988,
1,23,2122,2145,0.0011978,0.0003115,
1,24,2122,2146,0.0012275,0.0003236,
1,25,2122,2147,0.0012521,0.0003233,
1,26,2122,2148,0.0012759,0.0003192,
1,27,2122,2149,0.0013058,0.0003208,
1,28,2122,2150,0.0013446,0.0003397,
1,0,2123,2123,0.0091932,0.0000820,
1,1,2123,2124,0.0006668,0.0000008,
1,2,2123,2125,0.0003367,0.0000006,
1,3,2123,2126,0.0002291,0.0000005,
1,4,2123,2127,0.0001930,0.0000005,
1,5,2123,2128,0.0001870,0.0000008,
1,6,2123,2129,0.0001837,0.0000011,
1,7,2123,2130,0.0001828,0.0000015,
1,8,2123,2131,0.0001845,0.0000019,
1,9,2123,2132,0.0001904,0.0000027,
1,10,2123,2133,0.0002017,0.0000039,
1,11,2123,2134,0.0002200,0.0000059,
1,12,2123,2135,0.0002484,0.0000090,
1,13,2123,2136,0.0002934,0.0000150,
1,14,2123,2137,0.0003624,0.0000279,
1,15,2123,2138,0.0004596,0.0000534,
1,16,2123,2139,0.0005802,0.0000940,
1,17,2123,2140,0.0007098,0.0001422,
1,18,2123,2141,0.0008321,0.0001897,
1,19,2123,2142,0.0009391,0.0002305,
1,20,2123,2143,0.0010297,0.0002625,
1,21,2123,2144,0.0011033,0.0002834,
1,22,2123,2145,0.0011584,0.0002956,
1,23,2123,2146,0.0011978,0.0003082,
1,24,2123,2147,0.0012275,0.0003204,
1,25,2123,2148,0.0012521,0.0003203,
1,26,2123,2149,0.0012759,0.0003161,
1,27,2123,2150,0.0013058,0.0003174,
1,0,2124,2124,0.0091932,0.0000787,
1,1,2124,2125,0.0006668,0.0000008,
1,2,2124,2126,0.0003367,0.0000006,
1,3,2124,2127,0.0002291,0.0000005,
1,4,2124,2128,0.0001930,0.0000005,
1,5,2124,2129,0.0001870,0.0000007,
1,6,2124,2130,0.0001837,0.0000010,
1,7,2124,2131,0.0001828,0.0000014,
1,8,2124,2132,0.0001845,0.0000019,
1,9,2124,2133,0.0001904,0.0000026,
1,10,2124,2134,0.0002017,0.0000038,
1,11,2124,2135,0.0002200,0.0000057,
1,12,2124,2136,0.0002484,0.0000087,
1,13,2124,2137,0.0002934,0.0000146,
1,14,2124,2138,0.0003624,0.0000273,
1,15,2124,2139,0.0004596,0.0000526,
1,16,2124,2140,0.0005802,0.0000926,
1,17,2124,2141,0.0007098,0.0001403,
1,18,2124,2142,0.0008321,0.0001875,
1,19,2124,2143,0.0009391,0.0002282,
1,20,2124,2144,0.0010297,0.0002599,
1,21,2124,2145,0.0011033,0.0002804,
1,22,2124,2146,0.0011584,0.0002924,
1,23,2124,2147,0.0011978,0.0003051,
1,24,2124,2148,0.0012275,0.0003175,
1,25,2124,2149,0.0012521,0.0003172,
1,26,2124,2150,0.0012759,0.0003127,
1,0,2125,2125,0.0091932,0.0000752,
1,1,2125,2126,0.0006668,0.0000007,
1,2,2125,2127,0.0003367,0.0000006,
1,3,2125,2128,0.0002291,0.0000004,
1,4,2125,2129,0.0001930,0.0000005,
1,5,2125,2130,0.0001870,0.0000007,
1,6,2125,2131,0.0001837,0.0000010,
1,7,2125,2132,0.0001828,0.0000013,
1,8,2125,2133,0.0001845,0.0000018,
1,9,2125,2134,0.0001904,0.0000025,
1,10,2125,2135,0.0002017,0.0000037,
1,11,2125,2136,0.0002200,0.0000055,
1,12,2125,2137,0.0002484,0.0000085,
1,13,2125,2138,0.0002934,0.0000143,
1,14,2125,2139,0.0003624,0.0000268,
1,15,2125,2140,0.0004596,0.0000516,
1,16,2125,2141,0.0005802,0.0000912,
1,17,2125,2142,0.0007098,0.0001385,
1,18,2125,2143,0.0008321,0.0001855,
1,19,2125,2144,0.0009391,0.0002259,
1,20,2125,2145,0.0010297,0.0002571,
1,21,2125,2146,0.0011033,0.0002773,
1,22,2125,2147,0.0011584,0.0002894,
1,23,2125,2148,0.0011978,0.0003022,
1,24,2125,2149,0.0012275,0.0003145,
1,25,2125,2150,0.0012521,0.0003139,
1,0,2126,2126,0.0091932,0.0000718,
1,1,2126,2127,0.0006668,0.0000007,
1,2,2126,2128,0.0003367,0.0000005,
1,3,2126,2129,0.0002291,0.0000004,
1,4,2126,2130,0.0001930,0.0000004,
1,5,2126,2131,0.0001870,0.0000007,
1,6,2126,2132,0.0001837,0.0000009,
1,7,2126,2133,0.0001828,0.0000013,
1,8,2126,2134,0.0001845,0.0000017,
1,9,2126,2135,0.0001904,0.0000024,
1,10,2126,2136,0.0002017,0.0000035,
1,11,2126,2137,0.0002200,0.0000053,
1,12,2126,2138,0.0002484,0.0000083,
1,13,2126,2139,0.0002934,0.0000140,
1,14,2126,2140,0.0003624,0.0000262,
1,15,2126,2141,0.0004596,0.0000507,
1,16,2126,2142,0.0005802,0.0000899,
1,17,2126,2143,0.0007098,0.0001369,
1,18,2126,2144,0.0008321,0.0001835,
1,19,2126,2145,0.0009391,0.0002234,
1,20,2126,2146,0.0010297,0.0002543,
1,21,2126,2147,0.0011033,0.0002745,
1,22,2126,2148,0.0011584,0.0002866,
1,23,2126,2149,0.0011978,0.0002993,
1,24,2126,2150,0.0012275,0.0003112,
1,0,2127,2127,0.0091932,0.0000688,
1,1,2127,2128,0.0006668,0.0000007,
1,2,2127,2129,0.0003367,0.0000005,
1,3,2127,2130,0.0002291,0.0000004,
1,4,2127,2131,0.0001930,0.0000004,
1,5,2127,2132,0.0001870,0.0000006,
1,6,2127,2133,0.0001837,0.0000009,
1,7,2127,2134,0.0001828,0.0000012,
1,8,2127,2135,0.0001845,0.0000017,
1,9,2127,2136,0.0001904,0.0000023,
1,10,2127,2137,0.0002017,0.0000034,
1,11,2127,2138,0.0002200,0.0000052,
1,12,2127,2139,0.0002484,0.0000081,
1,13,2127,2140,0.0002934,0.0000136,
1,14,2127,2141,0.0003624,0.0000257,
1,15,2127,2142,0.0004596,0.0000498,
1,16,2127,2143,0.0005802,0.0000887,
1,17,2127,2144,0.0007098,0.0001353,
1,18,2127,2145,0.0008321,0.0001813,
1,19,2127,2146,0.0009391,0.0002208,
1,20,2127,2147,0.0010297,0.0002516,
1,21,2127,2148,0.0011033,0.0002719,
1,22,2127,2149,0.0011584,0.0002838,
1,23,2127,2150,0.0011978,0.0002962,
1,0,2128,2128,0.0091932,0.0000661,
1,1,2128,2129,0.0006668,0.0000006,
1,2,2128,2130,0.0003367,0.0000005,
1,3,2128,2131,0.0002291,0.0000004,
1,4,2128,2132,0.0001930,0.0000004,
1,5,2128,2133,0.0001870,0.0000006,
1,6,2128,2134,0.0001837,0.0000009,
1,7,2128,2135,0.0001828,0.0000012,
1,8,2128,2136,0.0001845,0.0000016,
1,9,2128,2137,0.0001904,0.0000022,
1,10,2128,2138,0.0002017,0.0000033,
1,11,2128,2139,0.0002200,0.0000050,
1,12,2128,2140,0.0002484,0.0000078,
1,13,2128,2141,0.0002934,0.0000133,
1,14,2128,2142,0.0003624,0.0000251,
1,15,2128,2143,0.0004596,0.0000490,
1,16,2128,2144,0.0005802,0.0000875,
1,17,2128,2145,0.0007098,0.0001335,
1,18,2128,2146,0.0008321,0.0001791,
1,19,2128,2147,0.0009391,0.0002184,
1,20,2128,2148,0.0010297,0.0002492,
1,21,2128,2149,0.0011033,0.0002692,
1,22,2128,2150,0.0011584,0.0002808,
1,0,2129,2129,0.0091932,0.0000634,
1,1,2129,2130,0.0006668,0.0000006,
1,2,2129,2131,0.0003367,0.0000004,
1,3,2129,2132,0.0002291,0.0000004,
1,4,2129,2133,0.0001930,0.0000004,
1,5,2129,2134,0.0001870,0.0000006,
1,6,2129,2135,0.0001837,0.0000008,
1,7,2129,2136,0.0001828,0.0000011,
1,8,2129,2137,0.0001845,0.0000015,
1,9,2129,2138,0.0001904,0.0000022,
1,10,2129,2139,0.0002017,0.0000032,
1,11,2129,2140,0.0002200,0.0000049,
1,12,2129,2141,0.0002484,0.0000076,
1,13,2129,2142,0.0002934,0.0000130,
1,14,2129,2143,0.0003624,0.0000247,
1,15,2129,2144,0.0004596,0.0000482,
1,16,2129,2145,0.0005802,0.0000862,
1,17,2129,2146,0.0007098,0.0001317,
1,18,2129,2147,0.0008321,0.0001770,
1,19,2129,2148,0.0009391,0.0002162,
1,20,2129,2149,0.0010297,0.0002467,
1,21,2129,2150,0.0011033,0.0002663,
1,0,2130,2130,0.0091932,0.0000606,
1,1,2130,2131,0.0006668,0.0000006,
1,2,2130,2132,0.0003367,0.0000004,
1,3,2130,2133,0.0002291,0.0000003,
1,4,2130,2134,0.0001930,0.0000004,
1,5,2130,2135,0.0001870,0.0000006,
1,6,2130,2136,0.0001837,0.0000008,
1,7,2130,2137,0.0001828,0.0000011,
1,8,2130,2138,0.0001845,0.0000015,
1,9,2130,2139,0.0001904,0.0000021,
1,10,2130,2140,0.0002017,0.0000031,
1,11,2130,2141,0.0002200,0.0000047,
1,12,2130,2142,0.0002484,0.0000074,
1,13,2130,2143,0.0002934,0.0000127,
1,14,2130,2144,0.0003624,0.0000242,
1,15,2130,2145,0.0004596,0.0000474,
1,16,2130,2146,0.0005802,0.0000849,
1,17,2130,2147,0.0007098,0.0001301,
1,18,2130,2148,0.0008321,0.0001752,
1,19,2130,2149,0.0009391,0.0002140,
1,20,2130,2150,0.0010297,0.0002441,
1,0,2131,2131,0.0091932,0.0000579,
1,1,2131,2132,0.0006668,0.0000005,
1,2,2131,2133,0.0003367,0.0000004,
1,3,2131,2134,0.0002291,0.0000003,
1,4,2131,2135,0.0001930,0.0000003,
1,5,2131,2136,0.0001870,0.0000005,
1,6,2131,2137,0.0001837,0.0000007,
1,7,2131,2138,0.0001828,0.0000010,
1,8,2131,2139,0.0001845,0.0000014,
1,9,2131,2140,0.0001904,0.0000020,
1,10,2131,2141,0.0002017,0.0000030,
1,11,2131,2142,0.0002200,0.0000046,
1,12,2131,2143,0.0002484,0.0000072,
1,13,2131,2144,0.0002934,0.0000124,
1,14,2131,2145,0.0003624,0.0000237,
1,15,2131,2146,0.0004596,0.0000465,
1,16,2131,2147,0.0005802,0.0000837,
1,17,2131,2148,0.0007098,0.0001286,
1,18,2131,2149,0.0008321,0.0001733,
1,19,2131,2150,0.0009391,0.0002116,
1,0,2132,2132,0.0091932,0.0000555,
1,1,2132,2133,0.0006668,0.0000005,
1,2,2132,2134,0.0003367,0.0000004,
1,3,2132,2135,0.0002291,0.0000003,
1,4,2132,2136,0.0001930,0.0000003,
1,5,2132,2137,0.0001870,0.0000005,
1,6,2132,2138,0.0001837,0.0000007,
1,7,2132,2139,0.0001828,0.0000010,
1,8,2132,2140,0.0001845,0.0000014,
1,9,2132,2141,0.0001904,0.0000019,
1,10,2132,2142,0.0002017,0.0000029,
1,11,2132,2143,0.0002200,0.0000045,
1,12,2132,2144,0.0002484,0.0000070,
1,13,2132,2145,0.0002934,0.0000121,
1,14,2132,2146,0.0003624,0.0000232,
1,15,2132,2147,0.0004596,0.0000457,
1,16,2132,2148,0.0005802,0.0000826,
1,17,2132,2149,0.0007098,0.0001270,
1,18,2132,2150,0.0008321,0.0001712,
1,0,2133,2133,0.0091932,0.0000533,
1,1,2133,2134,0.0006668,0.0000005,
1,2,2133,2135,0.0003367,0.0000004,
1,3,2133,2136,0.0002291,0.0000003,
1,4,2133,2137,0.0001930,0.0000003,
1,5,2133,2138,0.0001870,0.0000005,
1,6,2133,2139,0.0001837,0.0000007,
1,7,2133,2140,0.0001828,0.0000010,
1,8,2133,2141,0.0001845,0.0000013,
1,9,2133,2142,0.0001904,0.0000019,
1,10,2133,2143,0.0002017,0.0000028,
1,11,2133,2144,0.0002200,0.0000043,
1,12,2133,2145,0.0002484,0.0000068,
1,13,2133,2146,0.0002934,0.0000118,
1,14,2133,2147,0.0003624,0.0000227,
1,15,2133,2148,0.0004596,0.0000450,
1,16,2133,2149,0.0005802,0.0000815,
1,17,2133,2150,0.0007098,0.0001254,
1,0,2134,2134,0.0091932,0.0000511,
1,1,2134,2135,0.0006668,0.0000004,
1,2,2134,2136,0.0003367,0.0000003,
1,3,2134,2137,0.0002291,0.0000003,
1,4,2134,2138,0.0001930,0.0000003,
1,5,2134,2139,0.0001870,0.0000005,
1,6,2134,2140,0.0001837,0.0000007,
1,7,2134,2141,0.0001828,0.0000009,
1,8,2134,2142,0.0001845,0.0000013,
1,9,2134,2143,0.0001904,0.0000018,
1,10,2134,2144,0.0002017,0.0000027,
1,11,2134,2145,0.0002200,0.0000042,
1,12,2134,2146,0.0002484,0.0000067,
1,13,2134,2147,0.0002934,0.0000115,
1,14,2134,2148,0.0003624,0.0000223,
1,15,2134,2149,0.0004596,0.0000443,
1,16,2134,2150,0.0005802,0.0000803,
1,0,2135,2135,0.0091932,0.0000489,
1,1,2135,2136,0.0006668,0.0000004,
1,2,2135,2137,0.0003367,0.0000003,
1,3,2135,2138,0.0002291,0.0000003,
1,4,2135,2139,0.0001930,0.0000003,
1,5,2135,2140,0.0001870,0.0000004,
1,6,2135,2141,0.0001837,0.0000006,
1,7,2135,2142,0.0001828,0.0000009,
1,8,2135,2143,0.0001845,0.0000012,
1,9,2135,2144,0.0001904,0.0000017,
1,10,2135,2145,0.0002017,0.0000026,
1,11,2135,2146,0.0002200,0.0000041,
1,12,2135,2147,0.0002484,0.0000065,
1,13,2135,2148,0.0002934,0.0000112,
1,14,2135,2149,0.0003624,0.0000218,
1,15,2135,2150,0.0004596,0.0000435,
1,0,2136,2136,0.0091932,0.0000467,
1,1,2136,2137,0.0006668,0.0000004,
1,2,2136,2138,0.0003367,0.0000003,
1,3,2136,2139,0.0002291,0.0000002,
1,4,2136,2140,0.0001930,0.0000003,
1,5,2136,2141,0.0001870,0.0000004,
1,6,2136,2142,0.0001837,0.0000006,
1,7,2136,2143,0.0001828,0.0000008,
1,8,2136,2144,0.0001845,0.0000012,
1,9,2136,2145,0.0001904,0.0000017,
1,10,2136,2146,0.0002017,0.0000025,
1,11,2136,2147,0.0002200,0.0000040,
1,12,2136,2148,0.0002484,0.0000063,
1,13,2136,2149,0.0002934,0.0000110,
1,14,2136,2150,0.0003624,0.0000214,
1,0,2137,2137,0.0091932,0.0000447,
1,1,2137,2138,0.0006668,0.0000004,
1,2,2137,2139,0.0003367,0.0000003,
1,3,2137,2140,0.0002291,0.0000002,
1,4,2137,2141,0.0001930,0.0000003,
1,5,2137,2142,0.0001870,0.0000004,
1,6,2137,2143,0.0001837,0.0000006,
1,7,2137,2144,0.0001828,0.0000008,
1,8,2137,2145,0.0001845,0.0000011,
1,9,2137,2146,0.0001904,0.0000016,
1,10,2137,2147,0.0002017,0.0000025,
1,11,2137,2148,0.0002200,0.0000039,
1,12,2137,2149,0.0002484,0.0000062,
1,13,2137,2150,0.0002934,0.0000107,
1,0,2138,2138,0.0091932,0.0000429,
1,1,2138,2139,0.0006668,0.0000003,
1,2,2138,2140,0.0003367,0.0000003,
1,3,2138,2141,0.0002291,0.0000002,
1,4,2138,2142,0.0001930,0.0000002,
1,5,2138,2143,0.0001870,0.0000004,
1,6,2138,2144,0.0001837,0.0000005,
1,7,2138,2145,0.0001828,0.0000008,
1,8,2138,2146,0.0001845,0.0000011,
1,9,2138,2147,0.0001904,0.0000016,
1,10,2138,2148,0.0002017,0.0000024,
1,11,2138,2149,0.0002200,0.0000037,
1,12,2138,2150,0.0002484,0.0000060,
1,0,2139,2139,0.0091932,0.0000412,
1,1,2139,2140,0.0006668,0.0000003,
1,2,2139,2141,0.0003367,0.0000003,
1,3,2139,2142,0.0002291,0.0000002,
1,4,2139,2143,0.0001930,0.0000002,
1,5,2139,2144,0.0001870,0.0000004,
1,6,2139,2145,0.0001837,0.0000005,
1,7,2139,2146,0.0001828,0.0000007,
1,8,2139,2147,0.0001845,0.0000010,
1,9,2139,2148,0.0001904,0.0000015,
1,10,2139,2149,0.0002017,0.0000023,
1,11,2139,2150,0.0002200,0.0000036,
1,0,2140,2140,0.0091932,0.0000394,
1,1,2140,2141,0.0006668,0.0000003,
1,2,2140,2142,0.0003367,0.0000002,
1,3,2140,2143,0.0002291,0.0000002,
1,4,2140,2144,0.0001930,0.0000002,
1,5,2140,2145,0.0001870,0.0000003,
1,6,2140,2146,0.0001837,0.0000005,
1,7,2140,2147,0.0001828,0.0000007,
1,8,2140,2148,0.0001845,0.0000010,
1,9,2140,2149,0.0001904,0.0000015,
1,10,2140,2150,0.0002017,0.0000022,
1,0,2141,2141,0.0091932,0.0000376,
1,1,2141,2142,0.0006668,0.0000003,
1,2,2141,2143,0.0003367,0.0000002,
1,3,2141,2144,0.0002291,0.0000002,
1,4,2141,2145,0.0001930,0.0000002,
1,5,2141,2146,0.0001870,0.0000003,
1,6,2141,2147,0.0001837,0.0000005,
1,7,2141,2148,0.0001828,0.0000007,
1,8,2141,2149,0.0001845,0.0000010,
1,9,2141,2150,0.0001904,0.0000014,
1,0,2142,2142,0.0091932,0.0000360,
1,1,2142,2143,0.0006668,0.0000003,
1,2,2142,2144,0.0003367,0.0000002,
1,3,2142,2145,0.0002291,0.0000002,
1,4,2142,2146,0.0001930,0.0000002,
1,5,2142,2147,0.0001870,0.0000003,
1,6,2142,2148,0.0001837,0.0000005,
1,7,2142,2149,0.0001828,0.0000007,
1,8,2142,2150,0.0001845,0.0000009,
1,0,2143,2143,0.0091932,0.0000346,
1,1,2143,2144,0.0006668,0.0000003,
1,2,2143,2145,0.0003367,0.0000002,
1,3,2143,2146,0.0002291,0.0000002,
1,4,2143,2147,0.0001930,0.0000002,
1,5,2143,2148,0.0001870,0.0000003,
1,6,2143,2149,0.0001837,0.0000004,
1,7,2143,2150,0.0001828,0.0000006,
1,0,2144,2144,0.0091932,0.0000332,
1,1,2144,2145,0.0006668,0.0000002,
1,2,2144,2146,0.0003367,0.0000002,
1,3,2144,2147,0.0002291,0.0000002,
1,4,2144,2148,0.0001930,0.0000002,
1,5,2144,2149,0.0001870,0.0000003,
1,6,2144,2150,0.0001837,0.0000004,
1,0,2145,2145,0.0091932,0.0000318,
1,1,2145,2146,0.0006668,0.0000002,
1,2,2145,2147,0.0003367,0.0000002,
1,3,2145,2148,0.0002291,0.0000001,
1,4,2145,2149,0.0001930,0.0000002,
1,5,2145,2150,0.0001870,0.0000003,
1,0,2146,2146,0.0091932,0.0000304,
1,1,2146,2147,0.0006668,0.0000002,
1,2,2146,2148,0.0003367,0.0000002,
1,3,2146,2149,0.0002291,0.0000001,
1,4,2146,2150,0.0001930,0.0000002,
1,0,2147,2147,0.0091932,0.0000291,
1,1,2147,2148,0.0006668,0.0000002,
1,2,2147,2149,0.0003367,0.0000002,
1,3,2147,2150,0.0002291,0.0000001,
1,0,2148,2148,0.0091932,0.0000280,
1,1,2148,2149,0.0006668,0.0000002,
1,2,2148,2150,0.0003367,0.0000002,
1,0,2149,2149,0.0091932,0.0000269,
1,1,2149,2150,0.0006668,0.0000002,
1,0,2150,2150,0.0091932,0.0000257,
2,115,1885,2000,1.0000000,1.0000000,0.50
2,114,1886,2000,0.8433824,0.8377886,0.66
2,115,1886,2001,1.0000000,1.0000000,0.50
2,113,1887,2000,0.7923800,0.7887182,0.75
2,114,1887,2001,0.8433824,0.8382803,0.66
2,115,1887,2002,1.0000000,1.0000000,0.50
2,112,1888,2000,0.7424819,0.7406901,0.82
2,113,1888,2001,0.7923800,0.7890401,0.74
2,114,1888,2002,0.8433824,0.8387406,0.66
2,115,1888,2003,1.0000000,1.0000000,0.50
2,111,1889,2000,0.6939204,0.6939112,0.90
2,112,1889,2001,0.7424819,0.7408476,0.82
2,113,1889,2002,0.7923800,0.7893414,0.74
2,114,1889,2003,0.8433824,0.8391504,0.66
2,115,1889,2004,1.0000000,1.0000000,0.50
2,110,1890,2000,0.6469012,0.6485651,0.99
2,111,1890,2001,0.6939204,0.6939120,0.90
2,112,1890,2002,0.7424819,0.7409951,0.82
2,113,1890,2003,0.7923800,0.7896097,0.74
2,114,1890,2004,0.8433824,0.8395444,0.66
2,115,1890,2005,1.0000000,1.0000000,0.50
2,109,1891,2000,0.6016004,0.6048101,1.09
2,110,1891,2001,0.6469012,0.6484186,0.99
2,111,1891,2002,0.6939204,0.6939128,0.90
2,112,1891,2003,0.7424819,0.7411264,0.82
2,113,1891,2004,0.7923800,0.7898676,0.74
2,114,1891,2005,0.8433824,0.8399638,0.66
2,115,1891,2006,1.0000000,1.0000000,0.50
2,108,1892,2000,0.5581634,0.5627778,1.20
2,109,1892,2001,0.6016004,0.6045274,1.09
2,110,1892,2002,0.6469012,0.6482816,0.99
2,111,1892,2003,0.6939204,0.6939135,0.90
2,112,1892,2004,0.7424819,0.7412527,0.82
2,113,1892,2005,0.7923800,0.7901422,0.74
2,114,1892,2006,0.8433824,0.8403933,0.66
2,115,1892,2007,1.0000000,1.0000000,0.50
2,107,1893,2000,0.5167037,0.5225725,1.31
2,108,1893,2001,0.5581634,0.5623709,1.20
2,109,1893,2002,0.6016004,0.6042628,1.09
2,110,1893,2003,0.6469012,0.6481596,0.99
2,111,1893,2004,0.6939204,0.6939141,0.90
2,112,1893,2005,0.7424819,0.7413870,0.82
2,113,1893,2006,0.7923800,0.7904233,0.74
2,114,1893,2007,0.8433824,0.8408009,0.66
2,115,1893,2008,1.0000000,1.0000000,0.50
2,106,1894,2000,0.4773042,0.4842716,1.43
2,107,1894,2001,0.5167037,0.5220544,1.31
2,108,1894,2002,0.5581634,0.5619903,1.20
2,109,1894,2003,0.6016004,0.6040273,1.09
2,110,1894,2004,0.6469012,0.6480423,0.99
2,111,1894,2005,0.6939204,0.6939148,0.90
2,112,1894,2006,0.7424819,0.7415246,0.82
2,113,1894,2007,0.7923800,0.7906902,0.74
2,114,1894,2008,0.8433824,0.8411955,0.66
2,115,1894,2009,1.0000000,1.0000000,0.50
2,105,1895,2000,0.4400178,0.4479268,1.57
2,106,1895,2001,0.4773042,0.4836559,1.44
2,107,1895,2002,0.5167037,0.5215699,1.31
2,108,1895,2003,0.5581634,0.5616515,1.20
2,109,1895,2004,0.6016004,0.6038010,1.09
2,110,1895,2005,0.6469012,0.6479174,0.99
2,111,1895,2006,0.6939204,0.6939155,0.90
2,112,1895,2007,0.7424819,0.7416552,0.82
2,113,1895,2008,0.7923800,0.7909485,0.74
2,114,1895,2009,0.8433824,0.8416267,0.66
2,115,1895,2010,1.0000000,1.0000000,0.50
2,104,1896,2000,0.4048696,0.4135655,1.71
2,105,1896,2001,0.4400178,0.4472270,1.57
2,106,1896,2002,0.4773042,0.4830801,1.44
2,107,1896,2003,0.5167037,0.5211388,1.31
2,108,1896,2004,0.5581634,0.5613260,1.20
2,109,1896,2005,0.6016004,0.6035601,1.09
2,110,1896,2006,0.6469012,0.6477897,0.99
2,111,1896,2007,0.6939204,0.6939161,0.90
2,112,1896,2008,0.7424819,0.7417816,0.82
2,113,1896,2009,0.7923800,0.7912307,0.74
2,114,1896,2010,0.8433824,0.8421064,0.66
2,115,1896,2011,1.0000000,1.0000000,0.50
2,103,1897,2000,0.3718598,0.3811927,1.87
2,104,1897,2001,0.4048696,0.4127949,1.72
2,105,1897,2002,0.4400178,0.4465727,1.57
2,106,1897,2003,0.4773042,0.4825679,1.44
2,107,1897,2004,0.5167037,0.5207245,1.31
2,108,1897,2005,0.5581634,0.5609797,1.20
2,109,1897,2006,0.6016004,0.6033137,1.09
2,110,1897,2007,0.6469012,0.6476684,0.99
2,111,1897,2008,0.6939204,0.6939168,0.90
2,112,1897,2009,0.7424819,0.7419196,0.82
2,113,1897,2010,0.7923800,0.7915447,0.74
2,114,1897,2011,0.8433824,0.8425977,0.66
2,115,1897,2012,1.0000000,1.0000000,0.50
2,102,1898,2000,0.3409660,0.3507937,2.04
2,103,1898,2001,0.3718598,0.3803645,1.88
2,104,1898,2002,0.4048696,0.4120748,1.72
2,105,1898,2003,0.4400178,0.4459907,1.57
2,106,1898,2004,0.4773042,0.4820758,1.44
2,107,1898,2005,0.5167037,0.5202839,1.32
2,108,1898,2006,0.5581634,0.5606252,1.20
2,109,1898,2007,0.6016004,0.6030797,1.09
2,110,1898,2008,0.6469012,0.6475511,0.99
2,111,1898,2009,0.6939204,0.6939175,0.90
2,112,1898,2010,0.7424819,0.7420733,0.82
2,113,1898,2011,0.7923800,0.7918662,0.74
2,114,1898,2012,0.8433824,0.8430658,0.66
2,115,1898,2013,1.0000000,1.0000000,0.50
2,101,1899,2000,0.3121468,0.3223361,2.23
2,102,1899,2001,0.3409660,0.3499202,2.05
2,103,1899,2002,0.3718598,0.3795906,1.88
2,104,1899,2003,0.4048696,0.4114344,1.72
2,105,1899,2004,0.4400178,0.4454319,1.58
2,106,1899,2005,0.4773042,0.4815525,1.44
2,107,1899,2006,0.5167037,0.5198331,1.32
2,108,1899,2007,0.5581634,0.5602890,1.20
2,109,1899,2008,0.6016004,0.6028534,1.09
2,110,1899,2009,0.6469012,0.6474229,0.99
2,111,1899,2010,0.6939204,0.6939183,0.90
2,112,1899,2011,0.7424819,0.7422306,0.82
2,113,1899,2012,0.7923800,0.7921727,0.74
2,114,1899,2013,0.8433824,0.8435293,0.66
2,115,1899,2014,1.0000000,1.0000000,0.50
2,100,1900,2000,0.2853445,0.2957731,2.42
2,101,1900,2001,0.3121468,0.3214290,2.23
2,102,1900,2002,0.3409660,0.3491043,2.05
2,103,1900,2003,0.3718598,0.3789027,1.88
2,104,1900,2004,0.4048696,0.4108195,1.72
2,105,1900,2005,0.4400178,0.4448376,1.58
2,106,1900,2006,0.4773042,0.4810172,1.44
2,107,1900,2007,0.5167037,0.5194054,1.32
2,108,1900,2008,0.5581634,0.5599636,1.20
2,109,1900,2009,0.6016004,0.6026062,1.09
2,110,1900,2010,0.6469012,0.6472803,1.00
2,111,1900,2011,0.6939204,0.6939191,0.90
2,112,1900,2012,0.7424819,0.7423805,0.82
2,113,1900,2013,0.7923800,0.7924761,0.74
2,114,1900,2014,0.8433824,0.8440509,0.66
2,115,1900,2015,1.0000000,1.0000000,0.50
2,99,1901,2000,0.2604884,0.2710455,2.63
2,100,1901,2001,0.2853445,0.2948431,2.43
2,101,1901,2002,0.3121468,0.3205819,2.24
2,102,1901,2003,0.3409660,0.3483791,2.05
2,103,1901,2004,0.3718598,0.3782423,1.88
2,104,1901,2005,0.4048696,0.4101658,1.73
2,105,1901,2006,0.4400178,0.4442298,1.58
2,106,1901,2007,0.4773042,0.4805094,1.44
2,107,1901,2008,0.5167037,0.5189916,1.32
2,108,1901,2009,0.5581634,0.5596083,1.20
2,109,1901,2010,0.6016004,0.6023312,1.09
2,110,1901,2011,0.6469012,0.6471343,1.00
2,111,1901,2012,0.6939204,0.6939199,0.90
2,112,1901,2013,0.7424819,0.7425289,0.82
2,113,1901,2014,0.7923800,0.7928175,0.74
2,114,1901,2015,0.8433824,0.8446368,0.66
2,115,1901,2016,1.0000000,1.0000000,0.50
2,98,1902,2000,0.2374976,0.2480842,2.86
2,99,1902,2001,0.2604884,0.2701024,2.64
2,100,1902,2002,0.2853445,0.2939750,2.43
2,101,1902,2003,0.3121468,0.3198293,2.24
2,102,1902,2004,0.3409660,0.3476832,2.06
2,103,1902,2005,0.3718598,0.3775404,1.89
2,104,1902,2006,0.4048696,0.4094973,1.73
2,105,1902,2007,0.4400178,0.4436534,1.58
2,106,1902,2008,0.4773042,0.4800183,1.45
2,107,1902,2009,0.5167037,0.5185399,1.32
2,108,1902,2010,0.5581634,0.5592132,1.20
2,109,1902,2011,0.6016004,0.6020498,1.10
2,110,1902,2012,0.6469012,0.6469952,1.00
2,111,1902,2013,0.6939204,0.6939207,0.90
2,112,1902,2014,0.7424819,0.7426959,0.82
2,113,1902,2015,0.7923800,0.7932010,0.74
2,114,1902,2016,0.8433824,0.8452368,0.65
2,115,1902,2017,1.0000000,1.0000000,0.50
2,97,1903,2000,0.2162837,0.2268129,3.11
2,98,1903,2001,0.2374976,0.2471368,2.87
2,99,1903,2002,0.2604884,0.2692223,2.65
2,100,1903,2003,0.2853445,0.2932039,2.44
2,101,1903,2004,0.3121468,0.3191072,2.24
2,102,1903,2005,0.3409660,0.3469437,2.06
2,103,1903,2006,0.3718598,0.3768228,1.89
2,104,1903,2007,0.4048696,0.4088636,1.73
2,105,1903,2008,0.4400178,0.4430960,1.58
2,106,1903,2009,0.4773042,0.4794822,1.45
2,107,1903,2010,0.5167037,0.5180377,1.32
2,108,1903,2011,0.5581634,0.5588088,1.20
2,109,1903,2012,0.6016004,0.6017817,1.10
2,110,1903,2013,0.6469012,0.6468576,1.00
2,111,1903,2014,0.6939204,0.6939215,0.90
2,112,1903,2015,0.7424819,0.7428834,0.82
2,113,1903,2016,0.7923800,0.7935937,0.74
2,114,1903,2017,0.8433824,0.8458022,0.65
2,115,1903,2018,1.0000000,1.0000000,0.50
2,96,1904,2000,0.1967531,0.2071498,3.37
2,97,1904,2001,0.2162837,0.2258689,3.11
2,98,1904,2002,0.2374976,0.2462530,2.88
2,99,1904,2003,0.2604884,0.2684408,2.65
2,100,1904,2004,0.2853445,0.2924642,2.44
2,101,1904,2005,0.3121468,0.3183401,2.25
2,102,1904,2006,0.3409660,0.3461879,2.07
2,103,1904,2007,0.3718598,0.3761427,1.89
2,104,1904,2008,0.4048696,0.4082510,1.73
2,105,1904,2009,0.4400178,0.4424877,1.59
2,106,1904,2010,0.4773042,0.4788863,1.45
2,107,1904,2011,0.5167037,0.5175238,1.32
2,108,1904,2012,0.5581634,0.5584237,1.20
2,109,1904,2013,0.6016004,0.6015164,1.10
2,110,1904,2014,0.6469012,0.6467026,1.00
2,111,1904,2015,0.6939204,0.6939225,0.90
2,112,1904,2016,0.7424819,0.7430755,0.82
2,113,1904,2017,0.7923800,0.7939637,0.74
2,114,1904,2018,0.8433824,0.8463263,0.65
2,115,1904,2019,1.0000000,1.0000000,0.50
2,95,1905,2000,0.1788093,0.1890096,3.64
2,96,1905,2001,0.1967531,0.2062159,3.38
2,97,1905,2002,0.2162837,0.2249886,3.12
2,98,1905,2003,0.2374976,0.2454684,2.88
2,99,1905,2004,0.2604884,0.2676914,2.66
2,100,1905,2005,0.2853445,0.2916786,2.45
2,101,1905,2006,0.3121468,0.3175563,2.25
2,102,1905,2007,0.3409660,0.3454717,2.07
2,103,1905,2008,0.3718598,0.3754852,1.90
2,104,1905,2009,0.4048696,0.4075824,1.74
2,105,1905,2010,0.4400178,0.4418117,1.59
2,106,1905,2011,0.4773042,0.4782767,1.45
2,107,1905,2012,0.5167037,0.5170345,1.32
2,108,1905,2013,0.5581634,0.5580427,1.21
2,109,1905,2014,0.6016004,0.6012179,1.10
2,110,1905,2015,0.6469012,0.6465288,1.00
2,111,1905,2016,0.6939204,0.6939235,0.90
2,112,1905,2017,0.7424819,0.7432565,0.82
2,113,1905,2018,0.7923800,0.7943068,0.74
2,114,1905,2019,0.8433824,0.8468640,0.65
2,115,1905,2020,1.0000000,1.0000000,0.50
2,94,1906,2000,0.1623547,0.1723053,3.94
2,95,1906,2001,0.1788093,0.1880917,3.65
2,96,1906,2002,0.1967531,0.2053454,3.39
2,97,1906,2003,0.2162837,0.2242073,3.13
2,98,1906,2004,0.2374976,0.2447162,2.89
2,99,1906,2005,0.2604884,0.2668957,2.67
2,100,1906,2006,0.2853445,0.2908762,2.46
2,101,1906,2007,0.3121468,0.3168138,2.26
2,102,1906,2008,0.3409660,0.3447796,2.07
2,103,1906,2009,0.3718598,0.3747681,1.90
2,104,1906,2010,0.4048696,0.4068397,1.74
2,105,1906,2011,0.4400178,0.4411204,1.59
2,106,1906,2012,0.4773042,0.4776964,1.45
2,107,1906,2013,0.5167037,0.5165504,1.33
2,108,1906,2014,0.5581634,0.5576140,1.21
2,109,1906,2015,0.6016004,0.6008828,1.10
2,110,1906,2016,0.6469012,0.6463507,1.00
2,111,1906,2017,0.6939204,0.6939244,0.90
2,112,1906,2018,0.7424819,0.7434242,0.82
2,113,1906,2019,0.7923800,0.7946587,0.74
2,114,1906,2020,0.8433824,0.8474500,0.65
2,115,1906,2021,1.0000000,1.0000000,0.50
2,93,1907,2000,0.1472918,0.1569494,4.25
2,94,1907,2001,0.1623547,0.1714082,3.95
2,95,1907,2002,0.1788093,0.1872363,3.67
2,96,1907,2003,0.1967531,0.2045731,3.40
2,97,1907,2004,0.2162837,0.2234585,3.14
2,98,1907,2005,0.2374976,0.2439179,2.90
2,99,1907,2006,0.2604884,0.2660832,2.67
2,100,1907,2007,0.2853445,0.2901162,2.46
2,101,1907,2008,0.3121468,0.3160964,2.26
2,102,1907,2009,0.3409660,0.3440249,2.08
2,103,1907,2010,0.3718598,0.3739716,1.90
2,104,1907,2011,0.4048696,0.4060803,1.74
2,105,1907,2012,0.4400178,0.4404623,1.59
2,106,1907,2013,0.4773042,0.4771224,1.46
2,107,1907,2014,0.5167037,0.5160059,1.33
2,108,1907,2015,0.5581634,0.5571329,1.21
2,109,1907,2016,0.6016004,0.6005398,1.10
2,110,1907,2017,0.6469012,0.6461830,1.00
2,111,1907,2018,0.6939204,0.6939253,0.90
2,112,1907,2019,0.7424819,0.7435963,0.82
2,113,1907,2020,0.7923800,0.7950422,0.74
2,114,1907,2021,0.8433824,0.8480501,0.65
2,115,1907,2022,1.0000000,1.0000000,0.50
2,92,1908,2000,0.1335249,0.1428550,4.59
2,93,1908,2001,0.1472918,0.1560770,4.27
2,94,1908,2002,0.1623547,0.1705724,3.96
2,95,1908,2003,0.1788093,0.1864776,3.68
2,96,1908,2004,0.1967531,0.2038331,3.40
2,97,1908,2005,0.2162837,0.2226641,3.15
2,98,1908,2006,0.2374976,0.2431028,2.91
2,99,1908,2007,0.2604884,0.2653139,2.68
2,100,1908,2008,0.2853445,0.2893822,2.47
2,101,1908,2009,0.3121468,0.3153143,2.27
2,102,1908,2010,0.3409660,0.3431868,2.08
2,103,1908,2011,0.3718598,0.3731574,1.91
2,104,1908,2012,0.4048696,0.4053577,1.75
2,105,1908,2013,0.4400178,0.4398117,1.60
2,106,1908,2014,0.4773042,0.4764769,1.46
2,107,1908,2015,0.5167037,0.5153950,1.33
2,108,1908,2016,0.5581634,0.5566406,1.21
2,109,1908,2017,0.6016004,0.6002167,1.10
2,110,1908,2018,0.6469012,0.6460276,1.00
2,111,1908,2019,0.6939204,0.6939262,0.90
2,112,1908,2020,0.7424819,0.7437839,0.82
2,113,1908,2021,0.7923800,0.7954350,0.74
2,114,1908,2022,0.8433824,0.8486155,0.65
2,115,1908,2023,1.0000000,1.0000000,0.50
2,91,1909,2000,0.1209607,0.1299371,4.94
2,92,1909,2001,0.1335249,0.1420106,4.60
2,93,1909,2002,0.1472918,0.1552646,4.28
2,94,1909,2003,0.1623547,0.1698314,3.98
2,95,1909,2004,0.1788093,0.1857510,3.69
2,96,1909,2005,0.1967531,0.2030481,3.41
2,97,1909,2006,0.2162837,0.2218532,3.16
2,98,1909,2007,0.2374976,0.2423314,2.91
2,99,1909,2008,0.2604884,0.2645711,2.69
2,100,1909,2009,0.2853445,0.2885822,2.47
2,101,1909,2010,0.3121468,0.3144461,2.27
2,102,1909,2011,0.3409660,0.3423304,2.09
2,103,1909,2012,0.3718598,0.3723828,1.91
2,104,1909,2013,0.4048696,0.4046434,1.75
2,105,1909,2014,0.4400178,0.4390802,1.60
2,106,1909,2015,0.4773042,0.4757530,1.46
2,107,1909,2016,0.5167037,0.5147700,1.33
2,108,1909,2017,0.5581634,0.5561770,1.21
2,109,1909,2018,0.6016004,0.5999175,1.10
2,110,1909,2019,0.6469012,0.6458682,1.00
2,111,1909,2020,0.6939204,0.6939271,0.90
2,112,1909,2021,0.7424819,0.7439759,0.82
2,113,1909,2022,0.7923800,0.7958050,0.73
2,114,1909,2023,0.8433824,0.8491397,0.65
2,115,1909,2024,1.0000000,1.0000000,0.50
2,90,1910,2000,0.1095094,0.1181130,5.31
2,91,1910,2001,0.1209607,0.1291231,4.96
2,92,1910,2002,0.1335249,0.1412245,4.62
2,93,1910,2003,0.1472918,0.1545446,4.29
2,94,1910,2004,0.1623547,0.1691219,3.99
2,95,1910,2005,0.1788093,0.1849804,3.70
2,96,1910,2006,0.1967531,0.2022472,3.42
2,97,1910,2007,0.2162837,0.2210860,3.17
2,98,1910,2008,0.2374976,0.2415867,2.92
2,99,1910,2009,0.2604884,0.2637616,2.69
2,100,1910,2010,0.2853445,0.2876944,2.48
2,101,1910,2011,0.3121468,0.3135592,2.28
2,102,1910,2012,0.3409660,0.3415159,2.09
2,103,1910,2013,0.3718598,0.3716174,1.92
2,104,1910,2014,0.4048696,0.4038405,1.75
2,105,1910,2015,0.4400178,0.4382599,1.60
2,106,1910,2016,0.4773042,0.4750124,1.46
2,107,1910,2017,0.5167037,0.5141817,1.33
2,108,1910,2018,0.5581634,0.5557476,1.21
2,109,1910,2019,0.6016004,0.5996105,1.10
2,110,1910,2020,0.6469012,0.6456945,1.00
2,111,1910,2021,0.6939204,0.6939281,0.90
2,112,1910,2022,0.7424819,0.7441568,0.82
2,113,1910,2023,0.7923800,0.7961479,0.73
2,114,1910,2024,0.8433824,0.8496773,0.65
2,115,1910,2025,1.0000000,1.0000000,0.50
2,89,1911,2000,0.0990850,0.1073031,5.71
2,90,1911,2001,0.1095094,0.1173313,5.33
2,91,1911,2002,0.1209607,0.1283657,4.97
2,92,1911,2003,0.1335249,0.1405280,4.63
2,93,1911,2004,0.1472918,0.1538553,4.31
2,94,1911,2005,0.1623547,0.1683698,4.00
2,95,1911,2006,0.1788093,0.1841944,3.71
2,96,1911,2007,0.1967531,0.2014897,3.43
2,97,1911,2008,0.2162837,0.2203456,3.17
2,98,1911,2009,0.2374976,0.2407755,2.93
2,99,1911,2010,0.2604884,0.2628637,2.70
2,100,1911,2011,0.2853445,0.2867877,2.49
2,101,1911,2012,0.3121468,0.3127159,2.28
2,102,1911,2013,0.3409660,0.3407113,2.10
2,103,1911,2014,0.3718598,0.3707573,1.92
2,104,1911,2015,0.4048696,0.4029405,1.76
2,105,1911,2016,0.4400178,0.4374211,1.60
2,106,1911,2017,0.4773042,0.4743155,1.46
2,107,1911,2018,0.5167037,0.5136367,1.33
2,108,1911,2019,0.5581634,0.5553072,1.21
2,109,1911,2020,0.6016004,0.5992762,1.10
2,110,1911,2021,0.6469012,0.6455168,1.00
2,111,1911,2022,0.6939204,0.6939290,0.90
2,112,1911,2023,0.7424819,0.7443245,0.82
2,113,1911,2024,0.7923800,0.7964998,0.73
2,114,1911,2025,0.8433824,0.8502632,0.65
2,115,1911,2026,1.0000000,1.0000000,0.50
2,88,1912,2000,0.0896059,0.0974362,6.12
2,89,1912,2001,0.0990850,0.1065551,5.73
2,90,1912,2002,0.1095094,0.1166042,5.35
2,91,1912,2003,0.1209607,0.1276948,4.99
2,92,1912,2004,0.1335249,0.1398615,4.65
2,93,1912,2005,0.1472918,0.1531249,4.32
2,94,1912,2006,0.1623547,0.1676028,4.01
2,95,1912,2007,0.1788093,0.1834512,3.72
2,96,1912,2008,0.1967531,0.2007588,3.44
2,97,1912,2009,0.2162837,0.2195393,3.18
2,98,1912,2010,0.2374976,0.2398759,2.94
2,99,1912,2011,0.2604884,0.2619469,2.71
2,100,1912,2012,0.2853445,0.2859260,2.49
2,101,1912,2013,0.3121468,0.3118832,2.29
2,102,1912,2014,0.3409660,0.3398074,2.10
2,103,1912,2015,0.3718598,0.3697935,1.92
2,104,1912,2016,0.4048696,0.4020205,1.76
2,105,1912,2017,0.4400178,0.4366320,1.61
2,106,1912,2018,0.4773042,0.4736702,1.47
2,107,1912,2019,0.5167037,0.5130780,1.33
2,108,1912,2020,0.5581634,0.5548277,1.21
2,109,1912,2021,0.6016004,0.5989339,1.10
2,110,1912,2022,0.6469012,0.6453493,1.00
2,111,1912,2023,0.6939204,0.6939299,0.90
2,112,1912,2024,0.7424819,0.7444965,0.82
2,113,1912,2025,0.7923800,0.7968833,0.73
2,114,1912,2026,0.8433824,0.8508633,0.65
2,115,1912,2027,1.0000000,1.0000000,0.50
2,87,1913,2000,0.0809950,0.0884467,6.56
2,88,1913,2001,0.0896059,0.0967221,6.14
2,89,1913,2002,0.0990850,0.1058594,5.75
2,90,1913,2003,0.1095094,0.1159604,5.37
2,91,1913,2004,0.1209607,0.1270529,5.01
2,92,1913,2005,0.1335249,0.1391554,4.66
2,93,1913,2006,0.1472918,0.1523802,4.34
2,94,1913,2007,0.1623547,0.1668777,4.03
2,95,1913,2008,0.1788093,0.1827344,3.73
2,96,1913,2009,0.1967531,0.1999631,3.45
2,97,1913,2010,0.2162837,0.2186453,3.19
2,98,1913,2011,0.2374976,0.2389577,2.95
2,99,1913,2012,0.2604884,0.2610760,2.72
2,100,1913,2013,0.2853445,0.2850752,2.50
2,101,1913,2014,0.3121468,0.3109480,2.30
2,102,1913,2015,0.3409660,0.3387948,2.11
2,103,1913,2016,0.3718598,0.3688086,1.93
2,104,1913,2017,0.4048696,0.4011552,1.76
2,105,1913,2018,0.4400178,0.4359015,1.61
2,106,1913,2019,0.4773042,0.4730088,1.47
2,107,1913,2020,0.5167037,0.5124698,1.34
2,108,1913,2021,0.5581634,0.5543370,1.21
2,109,1913,2022,0.6016004,0.5986117,1.10
2,110,1913,2023,0.6469012,0.6451941,1.00
2,111,1913,2024,0.6939204,0.6939307,0.90
2,112,1913,2025,0.7424819,0.7446840,0.81
2,113,1913,2026,0.7923800,0.7972759,0.73
2,114,1913,2027,0.8433824,0.8514286,0.65
2,115,1913,2028,1.0000000,1.0000000,0.50
2,86,1914,2000,0.0731799,0.0802602,7.01
2,87,1914,2001,0.0809950,0.0877657,6.58
2,88,1914,2002,0.0896059,0.0960582,6.17
2,89,1914,2003,0.0990850,0.1052437,5.77
2,90,1914,2004,0.1095094,0.1153446,5.39
2,91,1914,2005,0.1209607,0.1263732,5.02
2,92,1914,2006,0.1335249,0.1384358,4.68
2,93,1914,2007,0.1472918,0.1516766,4.35
2,94,1914,2008,0.1623547,0.1661787,4.04
2,95,1914,2009,0.1788093,0.1819542,3.74
2,96,1914,2010,0.1967531,0.1990813,3.47
2,97,1914,2011,0.2162837,0.2177333,3.20
2,98,1914,2012,0.2374976,0.2380857,2.96
2,99,1914,2013,0.2604884,0.2602163,2.72
2,100,1914,2014,0.2853445,0.2841201,2.51
2,101,1914,2015,0.3121468,0.3099007,2.30
2,102,1914,2016,0.3409660,0.3377605,2.11
2,103,1914,2017,0.3718598,0.3678827,1.93
2,104,1914,2018,0.4048696,0.4003544,1.77
2,105,1914,2019,0.4400178,0.4351530,1.61
2,106,1914,2020,0.4773042,0.4722890,1.47
2,107,1914,2021,0.5167037,0.5118476,1.34
2,108,1914,2022,0.5581634,0.5538750,1.21
2,109,1914,2023,0.6016004,0.5983131,1.10
2,110,1914,2024,0.6469012,0.6450349,1.00
2,111,1914,2025,0.6939204,0.6939317,0.90
2,112,1914,2026,0.7424819,0.7448758,0.81
2,113,1914,2027,0.7923800,0.7976458,0.73
2,114,1914,2028,0.8433824,0.8519524,0.65
2,115,1914,2029,1.0000000,1.0000000,0.50
2,85,1915,2000,0.0660929,0.0728047,7.49
2,86,1915,2001,0.0731799,0.0796118,7.04
2,87,1915,2002,0.0809950,0.0871329,6.61
2,88,1915,2003,0.0896059,0.0954708,6.19
2,89,1915,2004,0.0990850,0.1046550,5.79
2,90,1915,2005,0.1095094,0.1146927,5.41
2,91,1915,2006,0.1209607,0.1256807,5.04
2,92,1915,2007,0.1335249,0.1377561,4.70
2,93,1915,2008,0.1472918,0.1509984,4.37
2,94,1915,2009,0.1623547,0.1654181,4.05
2,95,1915,2010,0.1788093,0.1810899,3.76
2,96,1915,2011,0.1967531,0.1981820,3.48
2,97,1915,2012,0.2162837,0.2168674,3.21
2,98,1915,2013,0.2374976,0.2372253,2.97
2,99,1915,2014,0.2604884,0.2592516,2.73
2,100,1915,2015,0.2853445,0.2830509,2.51
2,101,1915,2016,0.3121468,0.3088313,2.31
2,102,1915,2017,0.3409660,0.3367884,2.12
2,103,1915,2018,0.3718598,0.3670260,1.94
2,104,1915,2019,0.4048696,0.3995342,1.77
2,105,1915,2020,0.4400178,0.4343386,1.62
2,106,1915,2021,0.4773042,0.4715527,1.47
2,107,1915,2022,0.5167037,0.5112619,1.34
2,108,1915,2023,0.5581634,0.5534469,1.22
2,109,1915,2024,0.6016004,0.5980068,1.10
2,110,1915,2025,0.6469012,0.6448615,1.00
2,111,1915,2026,0.6939204,0.6939327,0.90
2,112,1915,2027,0.7424819,0.7450567,0.81
2,113,1915,2028,0.7923800,0.7979887,0.73
2,114,1915,2029,0.8433824,0.8524894,0.65
2,115,1915,2030,1.0000000,1.0000000,0.50
2,84,1916,2000,0.0596709,0.0660153,7.99
2,85,1916,2001,0.0660929,0.0721888,7.52
2,86,1916,2002,0.0731799,0.0790096,7.07
2,87,1916,2003,0.0809950,0.0865732,6.63
2,88,1916,2004,0.0896059,0.0949094,6.21
2,89,1916,2005,0.0990850,0.1040319,5.81
2,90,1916,2006,0.1095094,0.1140288,5.43
2,91,1916,2007,0.1209607,0.1250267,5.06
2,92,1916,2008,0.1335249,0.1371011,4.71
2,93,1916,2009,0.1472918,0.1502607,4.38
2,94,1916,2010,0.1623547,0.1645758,4.07
2,95,1916,2011,0.1788093,0.1802087,3.77
2,96,1916,2012,0.1967531,0.1973284,3.49
2,97,1916,2013,0.2162837,0.2160134,3.22
2,98,1916,2014,0.2374976,0.2362601,2.98
2,99,1916,2015,0.2604884,0.2581721,2.74
2,100,1916,2016,0.2853445,0.2819597,2.52
2,101,1916,2017,0.3121468,0.3078267,2.31
2,102,1916,2018,0.3409660,0.3358894,2.12
2,103,1916,2019,0.3718598,0.3661488,1.94
2,104,1916,2020,0.4048696,0.3986420,1.77
2,105,1916,2021,0.4400178,0.4335059,1.62
2,106,1916,2022,0.4773042,0.4708598,1.47
2,107,1916,2023,0.5167037,0.5107194,1.34
2,108,1916,2024,0.5581634,0.5530081,1.22
2,109,1916,2025,0.6016004,0.5976734,1.10
2,110,1916,2026,0.6469012,0.6446840,1.00
2,111,1916,2027,0.6939204,0.6939336,0.90
2,112,1916,2028,0.7424819,0.7452242,0.81
2,113,1916,2029,0.7923800,0.7983400,0.73
2,114,1916,2030,0.8433824,0.8530744,0.65
2,115,1916,2031,1.0000000,1.0000000,0.50
2,83,1917,2000,0.0538556,0.0598418,8.51
2,84,1917,2001,0.0596709,0.0654320,8.02
2,85,1917,2002,0.0660929,0.0716169,7.55
2,86,1917,2003,0.0731799,0.0784771,7.09
2,87,1917,2004,0.0809950,0.0860384,6.66
2,88,1917,2005,0.0896059,0.0943153,6.23
2,89,1917,2006,0.0990850,0.1033975,5.83
2,90,1917,2007,0.1095094,0.1134020,5.45
2,91,1917,2008,0.1209607,0.1243968,5.08
2,92,1917,2009,0.1335249,0.1363889,4.73
2,93,1917,2010,0.1472918,0.1494439,4.40
2,94,1917,2011,0.1623547,0.1637173,4.08
2,95,1917,2012,0.1788093,0.1793727,3.78
2,96,1917,2013,0.1967531,0.1964868,3.50
2,97,1917,2014,0.2162837,0.2150557,3.24
2,98,1917,2015,0.2374976,0.2351804,2.99
2,99,1917,2016,0.2604884,0.2570707,2.75
2,100,1917,2017,0.2853445,0.2809348,2.53
2,101,1917,2018,0.3121468,0.3068979,2.32
2,102,1917,2019,0.3409660,0.3349691,2.13
2,103,1917,2020,0.3718598,0.3651949,1.95
2,104,1917,2021,0.4048696,0.3977301,1.78
2,105,1917,2022,0.4400178,0.4327224,1.62
2,106,1917,2023,0.4773042,0.4702183,1.48
2,107,1917,2024,0.5167037,0.5101634,1.34
2,108,1917,2025,0.5581634,0.5525303,1.22
2,109,1917,2026,0.6016004,0.5973320,1.10
2,110,1917,2027,0.6469012,0.6445169,1.00
2,111,1917,2028,0.6939204,0.6939345,0.90
2,112,1917,2029,0.7424819,0.7453960,0.81
2,113,1917,2030,0.7923800,0.7987229,0.73
2,114,1917,2031,0.8433824,0.8536736,0.65
2,115,1917,2032,1.0000000,1.0000000,0.50
2,82,1918,2000,0.0485928,0.0542391,9.06
2,83,1918,2001,0.0538556,0.0592903,8.55
2,84,1918,2002,0.0596709,0.0648905,8.05
2,85,1918,2003,0.0660929,0.0711115,7.58
2,86,1918,2004,0.0731799,0.0779684,7.12
2,87,1918,2005,0.0809950,0.0854727,6.68
2,88,1918,2006,0.0896059,0.0937107,6.26
2,89,1918,2007,0.0990850,0.1027989,5.85
2,90,1918,2008,0.1095094,0.1127984,5.47
2,91,1918,2009,0.1209607,0.1237120,5.10
2,92,1918,2010,0.1335249,0.1356006,4.75
2,93,1918,2011,0.1472918,0.1486119,4.41
2,94,1918,2012,0.1623547,0.1629032,4.10
2,95,1918,2013,0.1788093,0.1785486,3.80
2,96,1918,2014,0.1967531,0.1955433,3.51
2,97,1918,2015,0.2162837,0.2139847,3.25
2,98,1918,2016,0.2374976,0.2340793,3.00
2,99,1918,2017,0.2604884,0.2560368,2.76
2,100,1918,2018,0.2853445,0.2799877,2.54
2,101,1918,2019,0.3121468,0.3059475,2.33
2,102,1918,2020,0.3409660,0.3339688,2.13
2,103,1918,2021,0.3718598,0.3642202,1.95
2,104,1918,2022,0.4048696,0.3968723,1.78
2,105,1918,2023,0.4400178,0.4319973,1.62
2,106,1918,2024,0.4773042,0.4695609,1.48
2,107,1918,2025,0.5167037,0.5095581,1.34
2,108,1918,2026,0.5581634,0.5520414,1.22
2,109,1918,2027,0.6016004,0.5970106,1.10
2,110,1918,2028,0.6469012,0.6443620,1.00
2,111,1918,2029,0.6939204,0.6939353,0.90
2,112,1918,2030,0.7424819,0.7455831,0.81
2,113,1918,2031,0.7923800,0.7991149,0.73
2,114,1918,2032,0.8433824,0.8542378,0.65
2,115,1918,2033,1.0000000,1.0000000,0.50
2,81,1919,2000,0.0438328,0.0491551,9.62
2,82,1919,2001,0.0485928,0.0537177,9.09
2,83,1919,2002,0.0538556,0.0587785,8.58
2,84,1919,2003,0.0596709,0.0644121,8.09
2,85,1919,2004,0.0660929,0.0706289,7.61
2,86,1919,2005,0.0731799,0.0774306,7.15
2,87,1919,2006,0.0809950,0.0848972,6.71
2,88,1919,2007,0.0896059,0.0931403,6.28
2,89,1919,2008,0.0990850,0.1022225,5.88
2,90,1919,2009,0.1095094,0.1121425,5.49
2,91,1919,2010,0.1209607,0.1229544,5.12
2,92,1919,2011,0.1335249,0.1347979,4.77
2,93,1919,2012,0.1472918,0.1478231,4.43
2,94,1919,2013,0.1623547,0.1621009,4.11
2,95,1919,2014,0.1788093,0.1776252,3.81
2,96,1919,2015,0.1967531,0.1944888,3.53
2,97,1919,2016,0.2162837,0.2128931,3.26
2,98,1919,2017,0.2374976,0.2330461,3.01
2,99,1919,2018,0.2604884,0.2550816,2.77
2,100,1919,2019,0.2853445,0.2790188,2.54
2,101,1919,2020,0.3121468,0.3049147,2.33
2,102,1919,2021,0.3409660,0.3329470,2.14
2,103,1919,2022,0.3718598,0.3633039,1.95
2,104,1919,2023,0.4048696,0.3960787,1.78
2,105,1919,2024,0.4400178,0.4312544,1.63
2,106,1919,2025,0.4773042,0.4688453,1.48
2,107,1919,2026,0.5167037,0.5089388,1.34
2,108,1919,2027,0.5581634,0.5515810,1.22
2,109,1919,2028,0.6016004,0.5967129,1.10
2,110,1919,2029,0.6469012,0.6442033,1.00
2,111,1919,2030,0.6939204,0.6939363,0.90
2,112,1919,2031,0.7424819,0.7457746,0.81
2,113,1919,2032,0.7923800,0.7994841,0.73
2,114,1919,2033,0.8433824,0.8547592,0.65
2,115,1919,2034,1.0000000,1.0000000,0.50
2,80,1920,2000,0.0395295,0.0445439,10.21
2,81,1920,2001,0.0438328,0.0486626,9.66
2,82,1920,2002,0.0485928,0.0532343,9.13
2,83,1920,2003,0.0538556,0.0583266,8.62
2,84,1920,2004,0.0596709,0.0639555,8.12
2,85,1920,2005,0.0660929,0.0701187,7.64
2,86,1920,2006,0.0731799,0.0768836,7.18
2,87,1920,2007,0.0809950,0.0843544,6.73
2,88,1920,2008,0.0896059,0.0925914,6.31
2,89,1920,2009,0.0990850,0.1015964,5.90
2,90,1920,2010,0.1095094,0.1114171,5.51
2,91,1920,2011,0.1209607,0.1221831,5.14
2,92,1920,2012,0.1335249,0.1340371,4.79
2,93,1920,2013,0.1472918,0.1470461,4.45
2,94,1920,2014,0.1623547,0.1612023,4.13
2,95,1920,2015,0.1788093,0.1765935,3.83
2,96,1920,2016,0.1967531,0.1934144,3.54
2,97,1920,2017,0.2162837,0.2118692,3.27
2,98,1920,2018,0.2374976,0.2320920,3.01
2,99,1920,2019,0.2604884,0.2541049,2.78
2,100,1920,2020,0.2853445,0.2779665,2.55
2,101,1920,2021,0.3121468,0.3038602,2.34
2,102,1920,2022,0.3409660,0.3319867,2.14
2,103,1920,2023,0.3718598,0.3624562,1.96
2,104,1920,2024,0.4048696,0.3952658,1.79
2,105,1920,2025,0.4400178,0.4304461,1.63
2,106,1920,2026,0.4773042,0.4681135,1.48
2,107,1920,2027,0.5167037,0.5083559,1.35
2,108,1920,2028,0.5581634,0.5511548,1.22
2,109,1920,2029,0.6016004,0.5964078,1.10
2,110,1920,2030,0.6469012,0.6440304,1.00
2,111,1920,2031,0.6939204,0.6939373,0.90
2,112,1920,2032,0.7424819,0.7459550,0.81
2,113,1920,2033,0.7923800,0.7998253,0.73
2,114,1920,2034,0.8433824,0.8552915,0.64
2,115,1920,2035,1.0000000,1.0000000,0.50
2,79,1921,2000,0.0345982,0.0394593,10.83
2,80,1921,2001,0.0395295,0.0440788,10.25
2,81,1921,2002,0.0438328,0.0482061,9.70
2,82,1921,2003,0.0485928,0.0528074,9.17
2,83,1921,2004,0.0538556,0.0578953,8.65
2,84,1921,2005,0.0596709,0.0634729,8.15
2,85,1921,2006,0.0660929,0.0696000,7.67
2,86,1921,2007,0.0731799,0.0763678,7.21
2,87,1921,2008,0.0809950,0.0838322,6.76
2,88,1921,2009,0.0896059,0.0919952,6.33
2,89,1921,2010,0.0990850,0.1009042,5.93
2,90,1921,2011,0.1095094,0.1106789,5.53
2,91,1921,2012,0.1209607,0.1214525,5.16
2,92,1921,2013,0.1335249,0.1332880,4.81
2,93,1921,2014,0.1472918,0.1461760,4.47
2,94,1921,2015,0.1623547,0.1601987,4.15
2,95,1921,2016,0.1788093,0.1755428,3.84
2,96,1921,2017,0.1967531,0.1924070,3.55
2,97,1921,2018,0.2162837,0.2109240,3.28
2,98,1921,2019,0.2374976,0.2311168,3.02
2,99,1921,2020,0.2604884,0.2530444,2.78
2,100,1921,2021,0.2853445,0.2768924,2.56
2,101,1921,2022,0.3121468,0.3028696,2.35
2,102,1921,2023,0.3409660,0.3310987,2.15
2,103,1921,2024,0.3718598,0.3615883,1.96
2,104,1921,2025,0.4048696,0.3943817,1.79
2,105,1921,2026,0.4400178,0.4296196,1.63
2,106,1921,2027,0.4773042,0.4674249,1.48
2,107,1921,2028,0.5167037,0.5078162,1.35
2,108,1921,2029,0.5581634,0.5507180,1.22
2,109,1921,2030,0.6016004,0.5960756,1.11
2,110,1921,2031,0.6469012,0.6438535,1.00
2,111,1921,2032,0.6939204,0.6939383,0.90
2,112,1921,2033,0.7424819,0.7461217,0.81
2,113,1921,2034,0.7923800,0.8001736,0.73
2,114,1921,2035,0.8433824,0.8558707,0.64
2,115,1921,2036,1.0000000,1.0000000,0.50
2,78,1922,2000,0.0310443,0.0356429,11.47
2,79,1922,2001,0.0345982,0.0390061,10.87
2,80,1922,2002,0.0395295,0.0436479,10.29
2,81,1922,2003,0.0438328,0.0478031,9.74
2,82,1922,2004,0.0485928,0.0524002,9.21
2,83,1922,2005,0.0538556,0.0574397,8.69
2,84,1922,2006,0.0596709,0.0629825,8.19
2,85,1922,2007,0.0660929,0.0691111,7.70
2,86,1922,2008,0.0731799,0.0758718,7.24
2,87,1922,2009,0.0809950,0.0832652,6.79
2,88,1922,2010,0.0896059,0.0913363,6.36
2,89,1922,2011,0.0990850,0.1002000,5.95
2,90,1922,2012,0.1095094,0.1099798,5.56
2,91,1922,2013,0.1209607,0.1207333,5.18
2,92,1922,2014,0.1335249,0.1324495,4.83
2,93,1922,2015,0.1472918,0.1452048,4.49
2,94,1922,2016,0.1623547,0.1591771,4.16
2,95,1922,2017,0.1788093,0.1745581,3.86
2,96,1922,2018,0.1967531,0.1914775,3.57
2,97,1922,2019,0.2162837,0.2099582,3.29
2,98,1922,2020,0.2374976,0.2300583,3.04
2,99,1922,2021,0.2604884,0.2519625,2.79
2,100,1922,2022,0.2853445,0.2758838,2.56
2,101,1922,2023,0.3121468,0.3019538,2.35
2,102,1922,2024,0.3409660,0.3301898,2.15
2,103,1922,2025,0.3718598,0.3606447,1.97
2,104,1922,2026,0.4048696,0.3934780,1.79
2,105,1922,2027,0.4400178,0.4288421,1.63
2,106,1922,2028,0.4773042,0.4667875,1.49
2,107,1922,2029,0.5167037,0.5072634,1.35
2,108,1922,2030,0.5581634,0.5502425,1.22
2,109,1922,2031,0.6016004,0.5957356,1.11
2,110,1922,2032,0.6469012,0.6436869,1.00
2,111,1922,2033,0.6939204,0.6939391,0.90
2,112,1922,2034,0.7424819,0.7462919,0.81
2,113,1922,2035,0.7923800,0.8005525,0.73
2,114,1922,2036,0.8433824,0.8564638,0.64
2,115,1922,2037,1.0000000,1.0000000,0.50
2,77,1923,2000,0.0279666,0.0323009,12.13
2,78,1923,2001,0.0310443,0.0352128,11.52
2,79,1923,2002,0.0345982,0.0385865,10.92
2,80,1923,2003,0.0395295,0.0432678,10.34
2,81,1923,2004,0.0438328,0.0474189,9.78
2,82,1923,2005,0.0485928,0.0519702,9.24
2,83,1923,2006,0.0538556,0.0569768,8.72
2,84,1923,2007,0.0596709,0.0625204,8.22
2,85,1923,2008,0.0660929,0.0686411,7.74
2,86,1923,2009,0.0731799,0.0753335,7.27
2,87,1923,2010,0.0809950,0.0826388,6.82
2,88,1923,2011,0.0896059,0.0906663,6.39
2,89,1923,2012,0.0990850,0.0995334,5.98
2,90,1923,2013,0.1095094,0.1092919,5.58
2,91,1923,2014,0.1209607,0.1199286,5.21
2,92,1923,2015,0.1335249,0.1315139,4.85
2,93,1923,2016,0.1472918,0.1442165,4.50
2,94,1923,2017,0.1623547,0.1582201,4.18
2,95,1923,2018,0.1788093,0.1736499,3.87
2,96,1923,2019,0.1967531,0.1905281,3.58
2,97,1923,2020,0.2162837,0.2089105,3.30
2,98,1923,2021,0.2374976,0.2289789,3.05
2,99,1923,2022,0.2604884,0.2509469,2.80
2,100,1923,2023,0.2853445,0.2749517,2.57
2,101,1923,2024,0.3121468,0.3010169,2.36
2,102,1923,2025,0.3409660,0.3292019,2.16
2,103,1923,2026,0.3718598,0.3596804,1.97
2,104,1923,2027,0.4048696,0.3926281,1.80
2,105,1923,2028,0.4400178,0.4281227,1.64
2,106,1923,2029,0.4773042,0.4661348,1.49
2,107,1923,2030,0.5167037,0.5066618,1.35
2,108,1923,2031,0.5581634,0.5497559,1.22
2,109,1923,2032,0.6016004,0.5954155,1.11
2,110,1923,2033,0.6469012,0.6435330,1.00
2,111,1923,2034,0.6939204,0.6939400,0.90
2,112,1923,2035,0.7424819,0.7464770,0.81
2,113,1923,2036,0.7923800,0.8009406,0.73
2,114,1923,2037,0.8433824,0.8570226,0.64
2,115,1923,2038,1.0000000,1.0000000,0.50
2,76,1924,2000,0.0253497,0.0294109,12.81
2,77,1924,2001,0.0279666,0.0318944,12.18
2,78,1924,2002,0.0310443,0.0348149,11.57
2,79,1924,2003,0.0345982,0.0382167,10.96
2,80,1924,2004,0.0395295,0.0429054,10.38
2,81,1924,2005,0.0438328,0.0470133,9.82
2,82,1924,2006,0.0485928,0.0515334,9.28
2,83,1924,2007,0.0538556,0.0565408,8.76
2,84,1924,2008,0.0596709,0.0620763,8.26
2,85,1924,2009,0.0660929,0.0681311,7.77
2,86,1924,2010,0.0731799,0.0747390,7.30
2,87,1924,2011,0.0809950,0.0820022,6.85
2,88,1924,2012,0.0896059,0.0900323,6.42
2,89,1924,2013,0.0990850,0.0988777,6.00
2,90,1924,2014,0.1095094,0.1085225,5.61
2,91,1924,2015,0.1209607,0.1190310,5.23
2,92,1924,2016,0.1335249,0.1305623,4.87
2,93,1924,2017,0.1472918,0.1432911,4.52
2,94,1924,2018,0.1623547,0.1573377,4.20
2,95,1924,2019,0.1788093,0.1727226,3.89
2,96,1924,2020,0.1967531,0.1894985,3.59
2,97,1924,2021,0.2162837,0.2078425,3.32
2,98,1924,2022,0.2374976,0.2279660,3.06
2,99,1924,2023,0.2604884,0.2500088,2.81
2,100,1924,2024,0.2853445,0.2739984,2.58
2,101,1924,2025,0.3121468,0.2999988,2.36
2,102,1924,2026,0.3409660,0.3281928,2.16
2,103,1924,2027,0.3718598,0.3587740,1.98
2,104,1924,2028,0.4048696,0.3918420,1.80
2,105,1924,2029,0.4400178,0.4273862,1.64
2,106,1924,2030,0.4773042,0.4654247,1.49
2,107,1924,2031,0.5167037,0.5060462,1.35
2,108,1924,2032,0.5581634,0.5492981,1.22
2,109,1924,2033,0.6016004,0.5951199,1.11
2,110,1924,2034,0.6469012,0.6433759,1.00
2,111,1924,2035,0.6939204,0.6939409,0.90
2,112,1924,2036,0.7424819,0.7466666,0.81
2,113,1924,2037,0.7923800,0.8013062,0.73
2,114,1924,2038,0.8433824,0.8575404,0.64
2,115,1924,2039,1.0000000,1.0000000,0.50
2,75,1925,2000,0.0231062,0.0268899,13.50
2,76,1925,2001,0.0253497,0.0290293,12.86
2,77,1925,2002,0.0279666,0.0315186,12.23
2,78,1925,2003,0.0310443,0.0344644,11.61
2,79,1925,2004,0.0345982,0.0378645,11.01
2,80,1925,2005,0.0395295,0.0425230,10.43
2,81,1925,2006,0.0438328,0.0466015,9.87
2,82,1925,2007,0.0485928,0.0511223,9.32
2,83,1925,2008,0.0538556,0.0561219,8.80
2,84,1925,2009,0.0596709,0.0615946,8.29
2,85,1925,2010,0.0660929,0.0675682,7.80
2,86,1925,2011,0.0731799,0.0741349,7.33
2,87,1925,2012,0.0809950,0.0813999,6.88
2,88,1925,2013,0.0896059,0.0894089,6.45
2,89,1925,2014,0.0990850,0.0981446,6.03
2,90,1925,2015,0.1095094,0.1076647,5.63
2,91,1925,2016,0.1209607,0.1181186,5.25
2,92,1925,2017,0.1335249,0.1296717,4.89
2,93,1925,2018,0.1472918,0.1424383,4.54
2,94,1925,2019,0.1623547,0.1564372,4.21
2,95,1925,2020,0.1788093,0.1717174,3.90
2,96,1925,2021,0.1967531,0.1884495,3.61
2,97,1925,2022,0.2162837,0.2068408,3.33
2,98,1925,2023,0.2374976,0.2270308,3.06
2,99,1925,2024,0.2604884,0.2490496,2.82
2,100,1925,2025,0.2853445,0.2729630,2.59
2,101,1925,2026,0.3121468,0.2989594,2.37
2,102,1925,2027,0.3409660,0.3272446,2.17
2,103,1925,2028,0.3718598,0.3579358,1.98
2,104,1925,2029,0.4048696,0.3910375,1.80
2,105,1925,2030,0.4400178,0.4265850,1.64
2,106,1925,2031,0.4773042,0.4646983,1.49
2,107,1925,2032,0.5167037,0.5054671,1.35
2,108,1925,2033,0.5581634,0.5488752,1.23
2,109,1925,2034,0.6016004,0.5948182,1.11
2,110,1925,2035,0.6469012,0.6432050,1.00
2,111,1925,2036,0.6939204,0.6939419,0.90
2,112,1925,2037,0.7424819,0.7468452,0.81
2,113,1925,2038,0.7923800,0.8016450,0.73
2,114,1925,2039,0.8433824,0.8580714,0.64
2,115,1925,2040,1.0000000,1.0000000,0.50
2,74,1926,2000,0.0210750,0.0245885,14.22
2,75,1926,2001,0.0231062,0.0265339,13.56
2,76,1926,2002,0.0253497,0.0286765,12.92
2,77,1926,2003,0.0279666,0.0311877,12.29
2,78,1926,2004,0.0310443,0.0341308,11.67
2,79,1926,2005,0.0345982,0.0374931,11.06
2,80,1926,2006,0.0395295,0.0421349,10.47
2,81,1926,2007,0.0438328,0.0462139,9.91
2,82,1926,2008,0.0485928,0.0507273,9.37
2,83,1926,2009,0.0538556,0.0556678,8.84
2,84,1926,2010,0.0596709,0.0610630,8.33
2,85,1926,2011,0.0660929,0.0669964,7.84
2,86,1926,2012,0.0731799,0.0735637,7.37
2,87,1926,2013,0.0809950,0.0808079,6.91
2,88,1926,2014,0.0896059,0.0887121,6.48
2,89,1926,2015,0.0990850,0.0973277,6.06
2,90,1926,2016,0.1095094,0.1067931,5.66
2,91,1926,2017,0.1209607,0.1172649,5.27
2,92,1926,2018,0.1335249,0.1288512,4.91
2,93,1926,2019,0.1472918,0.1415683,4.56
2,94,1926,2020,0.1623547,0.1554615,4.23
2,95,1926,2021,0.1788093,0.1706937,3.92
2,96,1926,2022,0.1967531,0.1874661,3.62
2,97,1926,2023,0.2162837,0.2059162,3.34
2,98,1926,2024,0.2374976,0.2260750,3.07
2,99,1926,2025,0.2604884,0.2480083,2.83
2,100,1926,2026,0.2853445,0.2719063,2.59
2,101,1926,2027,0.3121468,0.2979830,2.38
2,102,1926,2028,0.3409660,0.3263681,2.17
2,103,1926,2029,0.3718598,0.3570782,1.98
2,104,1926,2030,0.4048696,0.3901625,1.81
2,105,1926,2031,0.4400178,0.4257659,1.65
2,106,1926,2032,0.4773042,0.4640150,1.49
2,107,1926,2033,0.5167037,0.5049325,1.35
2,108,1926,2034,0.5581634,0.5484437,1.23
2,109,1926,2035,0.6016004,0.5944901,1.11
2,110,1926,2036,0.6469012,0.6430301,1.00
2,111,1926,2037,0.6939204,0.6939428,0.90
2,112,1926,2038,0.7424819,0.7470107,0.81
2,113,1926,2039,0.7923800,0.8019924,0.73
2,114,1926,2040,0.8433824,0.8586499,0.64
2,115,1926,2041,1.0000000,1.0000000,0.50
2,73,1927,2000,0.0190837,0.0223468,14.95
2,74,1927,2001,0.0210750,0.0242575,14.28
2,75,1927,2002,0.0231062,0.0262048,13.62
2,76,1927,2003,0.0253497,0.0283660,12.97
2,77,1927,2004,0.0279666,0.0308728,12.34
2,78,1927,2005,0.0310443,0.0337791,11.72
2,79,1927,2006,0.0345982,0.0371166,11.11
2,80,1927,2007,0.0395295,0.0417698,10.52
2,81,1927,2008,0.0438328,0.0458417,9.95
2,82,1927,2009,0.0485928,0.0502992,9.41
2,83,1927,2010,0.0538556,0.0551667,8.88
2,84,1927,2011,0.0596709,0.0605233,8.37
2,85,1927,2012,0.0660929,0.0664559,7.88
2,86,1927,2013,0.0731799,0.0730025,7.40
2,87,1927,2014,0.0809950,0.0801466,6.94
2,88,1927,2015,0.0896059,0.0879360,6.51
2,89,1927,2016,0.0990850,0.0964978,6.09
2,90,1927,2017,0.1095094,0.1059780,5.68
2,91,1927,2018,0.1209607,0.1164789,5.30
2,92,1927,2019,0.1335249,0.1280146,4.93
2,93,1927,2020,0.1472918,0.1406261,4.58
2,94,1927,2021,0.1623547,0.1544682,4.25
2,95,1927,2022,0.1788093,0.1697344,3.93
2,96,1927,2023,0.1967531,0.1865587,3.63
2,97,1927,2024,0.2162837,0.2049716,3.35
2,98,1927,2025,0.2374976,0.2250377,3.09
2,99,1927,2026,0.2604884,0.2469460,2.84
2,100,1927,2027,0.2853445,0.2709141,2.60
2,101,1927,2028,0.3121468,0.2970807,2.38
2,102,1927,2029,0.3409660,0.3254716,2.18
2,103,1927,2030,0.3718598,0.3561459,1.99
2,104,1927,2031,0.4048696,0.3892682,1.81
2,105,1927,2032,0.4400178,0.4249956,1.65
2,106,1927,2033,0.4773042,0.4633844,1.50
2,107,1927,2034,0.5167037,0.5043870,1.36
2,108,1927,2035,0.5581634,0.5479746,1.23
2,109,1927,2036,0.6016004,0.5941543,1.11
2,110,1927,2037,0.6469012,0.6428654,1.00
2,111,1927,2038,0.6939204,0.6939436,0.90
2,112,1927,2039,0.7424819,0.7471804,0.81
2,113,1927,2040,0.7923800,0.8023710,0.73
2,114,1927,2041,0.8433824,0.8592423,0.64
2,115,1927,2042,1.0000000,1.0000000,0.50
2,72,1928,2000,0.0170987,0.0201290,15.70
2,73,1928,2001,0.0190837,0.0220389,15.01
2,74,1928,2002,0.0210750,0.0239516,14.34
2,75,1928,2003,0.0231062,0.0259153,13.68
2,76,1928,2004,0.0253497,0.0280707,13.03
2,77,1928,2005,0.0279666,0.0305411,12.39
2,78,1928,2006,0.0310443,0.0334228,11.77
2,79,1928,2007,0.0345982,0.0367627,11.16
2,80,1928,2008,0.0395295,0.0414193,10.56
2,81,1928,2009,0.0438328,0.0454385,10.00
2,82,1928,2010,0.0485928,0.0498272,9.45
2,83,1928,2011,0.0538556,0.0546583,8.92
2,84,1928,2012,0.0596709,0.0600134,8.41
2,85,1928,2013,0.0660929,0.0659251,7.91
2,86,1928,2014,0.0731799,0.0723758,7.44
2,87,1928,2015,0.0809950,0.0794102,6.98
2,88,1928,2016,0.0896059,0.0871480,6.54
2,89,1928,2017,0.0990850,0.0957222,6.11
2,90,1928,2018,0.1095094,0.1052278,5.71
2,91,1928,2019,0.1209607,0.1156777,5.32
2,92,1928,2020,0.1335249,0.1271088,4.95
2,93,1928,2021,0.1472918,0.1396673,4.60
2,94,1928,2022,0.1623547,0.1535378,4.26
2,95,1928,2023,0.1788093,0.1688496,3.95
2,96,1928,2024,0.1967531,0.1856321,3.65
2,97,1928,2025,0.2162837,0.2039470,3.36
2,98,1928,2026,0.2374976,0.2239799,3.10
2,99,1928,2027,0.2604884,0.2459488,2.84
2,100,1928,2028,0.2853445,0.2699976,2.61
2,101,1928,2029,0.3121468,0.2961582,2.39
2,102,1928,2030,0.3409660,0.3244973,2.18
2,103,1928,2031,0.3718598,0.3551934,1.99
2,104,1928,2032,0.4048696,0.3884276,1.82
2,105,1928,2033,0.4400178,0.4242848,1.65
2,106,1928,2034,0.4773042,0.4627411,1.50
2,107,1928,2035,0.5167037,0.5037941,1.36
2,108,1928,2036,0.5581634,0.5474946,1.23
2,109,1928,2037,0.6016004,0.5938380,1.11
2,110,1928,2038,0.6469012,0.6427127,1.00
2,111,1928,2039,0.6939204,0.6939445,0.90
2,112,1928,2040,0.7424819,0.7473652,0.81
2,113,1928,2041,0.7923800,0.8027585,0.72
2,114,1928,2042,0.8433824,0.8598002,0.64
2,115,1928,2043,1.0000000,1.0000000,0.50
2,71,1929,2000,0.0152518,0.0180623,16.48
2,72,1929,2001,0.0170987,0.0198423,15.77
2,73,1929,2002,0.0190837,0.0217545,15.08
2,74,1929,2003,0.0210750,0.0236826,14.40
2,75,1929,2004,0.0231062,0.0256400,13.74
2,76,1929,2005,0.0253497,0.0277597,13.09
2,77,1929,2006,0.0279666,0.0302051,12.45
2,78,1929,2007,0.0310443,0.0330880,11.82
2,79,1929,2008,0.0345982,0.0364233,11.21
2,80,1929,2009,0.0395295,0.0410397,10.61
2,81,1929,2010,0.0438328,0.0449941,10.05
2,82,1929,2011,0.0485928,0.0493484,9.50
2,83,1929,2012,0.0538556,0.0541780,8.96
2,84,1929,2013,0.0596709,0.0595128,8.45
2,85,1929,2014,0.0660929,0.0653326,7.95
2,86,1929,2015,0.0731799,0.0716783,7.47
2,87,1929,2016,0.0809950,0.0786629,7.01
2,88,1929,2017,0.0896059,0.0864118,6.57
2,89,1929,2018,0.0990850,0.0950086,6.14
2,90,1929,2019,0.1095094,0.1044634,5.73
2,91,1929,2020,0.1209607,0.1148106,5.34
2,92,1929,2021,0.1335249,0.1261876,4.97
2,93,1929,2022,0.1472918,0.1387696,4.62
2,94,1929,2023,0.1623547,0.1526801,4.28
2,95,1929,2024,0.1788093,0.1679465,3.96
2,96,1929,2025,0.1967531,0.1846273,3.66
2,97,1929,2026,0.2162837,0.2029025,3.37
2,98,1929,2027,0.2374976,0.2229875,3.11
2,99,1929,2028,0.2604884,0.2450281,2.85
2,100,1929,2029,0.2853445,0.2690607,2.62
2,101,1929,2030,0.3121468,0.2951561,2.40
2,102,1929,2031,0.3409660,0.3235022,2.19
2,103,1929,2032,0.3718598,0.3542983,2.00
2,104,1929,2033,0.4048696,0.3876521,1.82
2,105,1929,2034,0.4400178,0.4235601,1.65
2,106,1929,2035,0.4773042,0.4620422,1.50
2,107,1929,2036,0.5167037,0.5031875,1.36
2,108,1929,2037,0.5581634,0.5470426,1.23
2,109,1929,2038,0.6016004,0.5935451,1.11
2,110,1929,2039,0.6469012,0.6425563,1.00
2,111,1929,2040,0.6939204,0.6939455,0.90
2,112,1929,2041,0.7424819,0.7475545,0.81
2,113,1929,2042,0.7923800,0.8031235,0.72
2,114,1929,2043,0.8433824,0.8603154,0.64
2,115,1929,2044,1.0000000,1.0000000,0.50
2,70,1930,2000,0.0136702,0.0162623,17.27
2,71,1930,2001,0.0152518,0.0177957,16.55
2,72,1930,2002,0.0170987,0.0195777,15.84
2,73,1930,2003,0.0190837,0.0215043,15.15
2,74,1930,2004,0.0210750,0.0234268,14.47
2,75,1930,2005,0.0231062,0.0253501,13.80
2,76,1930,2006,0.0253497,0.0274448,13.15
2,77,1930,2007,0.0279666,0.0298896,12.51
2,78,1930,2008,0.0310443,0.0327671,11.88
2,79,1930,2009,0.0345982,0.0360560,11.26
2,80,1930,2010,0.0395295,0.0406215,10.66
2,81,1930,2011,0.0438328,0.0445434,10.09
2,82,1930,2012,0.0485928,0.0488962,9.54
2,83,1930,2013,0.0538556,0.0537067,9.01
2,84,1930,2014,0.0596709,0.0589541,8.49
2,85,1930,2015,0.0660929,0.0646734,7.99
2,86,1930,2016,0.0731799,0.0709708,7.51
2,87,1930,2017,0.0809950,0.0779651,7.04
2,88,1930,2018,0.0896059,0.0857348,6.60
2,89,1930,2019,0.0990850,0.0942818,6.17
2,90,1930,2020,0.1095094,0.1036365,5.76
2,91,1930,2021,0.1209607,0.1139292,5.37
2,92,1930,2022,0.1335249,0.1253255,4.99
2,93,1930,2023,0.1472918,0.1379424,4.63
2,94,1930,2024,0.1623547,0.1518049,4.30
2,95,1930,2025,0.1788093,0.1669676,3.98
2,96,1930,2026,0.1967531,0.1836035,3.67
2,97,1930,2027,0.2162837,0.2019230,3.39
2,98,1930,2028,0.2374976,0.2220715,3.11
2,99,1930,2029,0.2604884,0.2440874,2.86
2,100,1930,2030,0.2853445,0.2680435,2.62
2,101,1930,2031,0.3121468,0.2941329,2.40
2,102,1930,2032,0.3409660,0.3225675,2.19
2,103,1930,2033,0.3718598,0.3534728,2.00
2,104,1930,2034,0.4048696,0.3868617,1.82
2,105,1930,2035,0.4400178,0.4227728,1.66
2,106,1930,2036,0.4773042,0.4613274,1.50
2,107,1930,2037,0.5167037,0.5026166,1.36
2,108,1930,2038,0.5581634,0.5466241,1.23
2,109,1930,2039,0.6016004,0.5932449,1.11
2,110,1930,2040,0.6469012,0.6423858,1.00
2,111,1930,2041,0.6939204,0.6939464,0.90
2,112,1930,2042,0.7424819,0.7477328,0.81
2,113,1930,2043,0.7923800,0.8034606,0.72
2,114,1930,2044,0.8433824,0.8608411,0.64
2,115,1930,2045,1.0000000,1.0000000,0.50
2,69,1931,2000,0.0123584,0.0147375,18.08
2,70,1931,2001,0.0136702,0.0160160,17.35
2,71,1931,2002,0.0152518,0.0175497,16.62
2,72,1931,2003,0.0170987,0.0193450,15.91
2,73,1931,2004,0.0190837,0.0212665,15.21
2,74,1931,2005,0.0210750,0.0231575,14.53
2,75,1931,2006,0.0231062,0.0250567,13.87
2,76,1931,2007,0.0253497,0.0271492,13.21
2,77,1931,2008,0.0279666,0.0295873,12.56
2,78,1931,2009,0.0310443,0.0324201,11.93
2,79,1931,2010,0.0345982,0.0356517,11.31
2,80,1931,2011,0.0395295,0.0401976,10.71
2,81,1931,2012,0.0438328,0.0441181,10.14
2,82,1931,2013,0.0485928,0.0484527,9.59
2,83,1931,2014,0.0538556,0.0531810,9.05
2,84,1931,2015,0.0596709,0.0583329,8.53
2,85,1931,2016,0.0660929,0.0640052,8.03
2,86,1931,2017,0.0731799,0.0703104,7.54
2,87,1931,2018,0.0809950,0.0773236,7.07
2,88,1931,2019,0.0896059,0.0850455,6.63
2,89,1931,2020,0.0990850,0.0934960,6.20
2,90,1931,2021,0.1095094,0.1027963,5.78
2,91,1931,2022,0.1209607,0.1131046,5.39
2,92,1931,2023,0.1335249,0.1245313,5.01
2,93,1931,2024,0.1472918,0.1370986,4.65
2,94,1931,2025,0.1623547,0.1508567,4.31
2,95,1931,2026,0.1788093,0.1659706,3.99
2,96,1931,2027,0.1967531,0.1826438,3.68
2,97,1931,2028,0.2162837,0.2010193,3.40
2,98,1931,2029,0.2374976,0.2211359,3.13
2,99,1931,2030,0.2604884,0.2430663,2.87
2,100,1931,2031,0.2853445,0.2670053,2.63
2,101,1931,2032,0.3121468,0.2931722,2.41
2,102,1931,2033,0.3409660,0.3217058,2.20
2,103,1931,2034,0.3718598,0.3526316,2.01
2,104,1931,2035,0.4048696,0.3860033,1.83
2,105,1931,2036,0.4400178,0.4219679,1.66
2,106,1931,2037,0.4773042,0.4606547,1.50
2,107,1931,2038,0.5167037,0.5020881,1.36
2,108,1931,2039,0.5581634,0.5461951,1.23
2,109,1931,2040,0.6016004,0.5929179,1.11
2,110,1931,2041,0.6469012,0.6422114,1.00
2,111,1931,2042,0.6939204,0.6939474,0.90
2,112,1931,2043,0.7424819,0.7478974,0.81
2,113,1931,2044,0.7923800,0.8038046,0.72
2,114,1931,2045,0.8433824,0.8614128,0.64
2,115,1931,2046,1.0000000,1.0000000,0.50
2,68,1932,2000,0.0112531,0.0134381,18.91
2,69,1932,2001,0.0123584,0.0145111,18.16
2,70,1932,2002,0.0136702,0.0157887,17.42
2,71,1932,2003,0.0152518,0.0173336,16.69
2,72,1932,2004,0.0170987,0.0191240,15.98
2,73,1932,2005,0.0190837,0.0210163,15.28
2,74,1932,2006,0.0210750,0.0228850,14.60
2,75,1932,2007,0.0231062,0.0247813,13.93
2,76,1932,2008,0.0253497,0.0268660,13.27
2,77,1932,2009,0.0279666,0.0292605,12.62
2,78,1932,2010,0.0310443,0.0320383,11.99
2,79,1932,2011,0.0345982,0.0352424,11.37
2,80,1932,2012,0.0395295,0.0397977,10.77
2,81,1932,2013,0.0438328,0.0437010,10.19
2,82,1932,2014,0.0485928,0.0479582,9.63
2,83,1932,2015,0.0538556,0.0525967,9.09
2,84,1932,2016,0.0596709,0.0577035,8.57
2,85,1932,2017,0.0660929,0.0633817,8.07
2,86,1932,2018,0.0731799,0.0697036,7.58
2,87,1932,2019,0.0809950,0.0766708,7.11
2,88,1932,2020,0.0896059,0.0843005,6.66
2,89,1932,2021,0.0990850,0.0926978,6.22
2,90,1932,2022,0.1095094,0.1020107,5.81
2,91,1932,2023,0.1209607,0.1123454,5.41
2,92,1932,2024,0.1335249,0.1237216,5.03
2,93,1932,2025,0.1472918,0.1361848,4.67
2,94,1932,2026,0.1623547,0.1498914,4.33
2,95,1932,2027,0.1788093,0.1650365,4.00
2,96,1932,2028,0.1967531,0.1817588,3.70
2,97,1932,2029,0.2162837,0.2000966,3.41
2,98,1932,2030,0.2374976,0.2201208,3.14
2,99,1932,2031,0.2604884,0.2420247,2.88
2,100,1932,2032,0.2853445,0.2660309,2.64
2,101,1932,2033,0.3121468,0.2922869,2.41
2,102,1932,2034,0.3409660,0.3208280,2.20
2,103,1932,2035,0.3718598,0.3517185,2.01
2,104,1932,2036,0.4048696,0.3851259,1.83
2,105,1932,2037,0.4400178,0.4212106,1.66
2,106,1932,2038,0.4773042,0.4600321,1.51
2,107,1932,2039,0.5167037,0.5015464,1.36
2,108,1932,2040,0.5581634,0.5457281,1.23
2,109,1932,2041,0.6016004,0.5925833,1.11
2,110,1932,2042,0.6469012,0.6420472,1.00
2,111,1932,2043,0.6939204,0.6939481,0.90
2,112,1932,2044,0.7424819,0.7480654,0.81
2,113,1932,2045,0.7923800,0.8041785,0.72
2,114,1932,2046,0.8433824,0.8619983,0.64
2,115,1932,2047,1.0000000,1.0000000,0.50
2,67,1933,2000,0.0103010,0.0123089,19.75
2,68,1933,2001,0.0112531,0.0132300,18.99
2,69,1933,2002,0.0123584,0.0143023,18.24
2,70,1933,2003,0.0136702,0.0155891,17.50
2,71,1933,2004,0.0152518,0.0171283,16.77
2,72,1933,2005,0.0170987,0.0188915,16.05
2,73,1933,2006,0.0190837,0.0207632,15.35
2,74,1933,2007,0.0210750,0.0226293,14.67
2,75,1933,2008,0.0231062,0.0245175,13.99
2,76,1933,2009,0.0253497,0.0265601,13.33
2,77,1933,2010,0.0279666,0.0289012,12.68
2,78,1933,2011,0.0310443,0.0316519,12.05
2,79,1933,2012,0.0345982,0.0348567,11.42
2,80,1933,2013,0.0395295,0.0394057,10.82
2,81,1933,2014,0.0438328,0.0432362,10.24
2,82,1933,2015,0.0485928,0.0474089,9.68
2,83,1933,2016,0.0538556,0.0520049,9.14
2,84,1933,2017,0.0596709,0.0571165,8.61
2,85,1933,2018,0.0660929,0.0628091,8.10
2,86,1933,2019,0.0731799,0.0690864,7.61
2,87,1933,2020,0.0809950,0.0759656,7.14
2,88,1933,2021,0.0896059,0.0835442,6.69
2,89,1933,2022,0.0990850,0.0919518,6.25
2,90,1933,2023,0.1095094,0.1012876,5.83
2,91,1933,2024,0.1209607,0.1115717,5.43
2,92,1933,2025,0.1335249,0.1228451,5.05
2,93,1933,2026,0.1472918,0.1352551,4.69
2,94,1933,2027,0.1623547,0.1489873,4.35
2,95,1933,2028,0.1788093,0.1641753,4.02
2,96,1933,2029,0.1967531,0.1808555,3.71
2,97,1933,2030,0.2162837,0.1990959,3.42
2,98,1933,2031,0.2374976,0.2190857,3.15
2,99,1933,2032,0.2604884,0.2410474,2.89
2,100,1933,2033,0.2853445,0.2651332,2.65
2,101,1933,2034,0.3121468,0.2913853,2.42
2,102,1933,2035,0.3409660,0.3198754,2.21
2,103,1933,2036,0.3718598,0.3507856,2.01
2,104,1933,2037,0.4048696,0.3843007,1.83
2,105,1933,2038,0.4400178,0.4205098,1.66
2,106,1933,2039,0.4773042,0.4593943,1.51
2,107,1933,2040,0.5167037,0.5009570,1.36
2,108,1933,2041,0.5581634,0.5452502,1.23
2,109,1933,2042,0.6016004,0.5922683,1.11
2,110,1933,2043,0.6469012,0.6418955,1.00
2,111,1933,2044,0.6939204,0.6939490,0.90
2,112,1933,2045,0.7424819,0.7482480,0.81
2,113,1933,2046,0.7923800,0.8045616,0.72
2,114,1933,2047,0.8433824,0.8625503,0.64
2,115,1933,2048,1.0000000,1.0000000,0.50
2,66,1934,2000,0.0094558,0.0112986,20.61
2,67,1934,2001,0.0103010,0.0121177,19.84
2,68,1934,2002,0.0112531,0.0130382,19.08
2,69,1934,2003,0.0123584,0.0141190,18.32
2,70,1934,2004,0.0136702,0.0153996,17.58
2,71,1934,2005,0.0152518,0.0169124,16.84
2,72,1934,2006,0.0170987,0.0186563,16.12
2,73,1934,2007,0.0190837,0.0205257,15.42
2,74,1934,2008,0.0210750,0.0223844,14.73
2,75,1934,2009,0.0231062,0.0242326,14.06
2,76,1934,2010,0.0253497,0.0262237,13.40
2,77,1934,2011,0.0279666,0.0285378,12.74
2,78,1934,2012,0.0310443,0.0312880,12.10
2,79,1934,2013,0.0345982,0.0344790,11.48
2,80,1934,2014,0.0395295,0.0389691,10.87
2,81,1934,2015,0.0438328,0.0427201,10.29
2,82,1934,2016,0.0485928,0.0468528,9.73
2,83,1934,2017,0.0538556,0.0514533,9.18
2,84,1934,2018,0.0596709,0.0565777,8.65
2,85,1934,2019,0.0660929,0.0622268,8.14
2,86,1934,2020,0.0731799,0.0684199,7.65
2,87,1934,2021,0.0809950,0.0752500,7.17
2,88,1934,2022,0.0896059,0.0828377,6.72
2,89,1934,2023,0.0990850,0.0912655,6.28
2,90,1934,2024,0.1095094,0.1005510,5.86
2,91,1934,2025,0.1209607,0.1107344,5.46
2,92,1934,2026,0.1335249,0.1219537,5.07
2,93,1934,2027,0.1472918,0.1343846,4.71
2,94,1934,2028,0.1623547,0.1481542,4.36
2,95,1934,2029,0.1788093,0.1632968,4.03
2,96,1934,2030,0.1967531,0.1798763,3.72
2,97,1934,2031,0.2162837,0.1980760,3.43
2,98,1934,2032,0.2374976,0.2181150,3.16
2,99,1934,2033,0.2604884,0.2401474,2.90
2,100,1934,2034,0.2853445,0.2642195,2.65
2,101,1934,2035,0.3121468,0.2904073,2.43
2,102,1934,2036,0.3409660,0.3189025,2.22
2,103,1934,2037,0.3718598,0.3499084,2.02
2,104,1934,2038,0.4048696,0.3835374,1.84
2,105,1934,2039,0.4400178,0.4197923,1.67
2,106,1934,2040,0.4773042,0.4587003,1.51
2,107,1934,2041,0.5167037,0.5003539,1.37
2,108,1934,2042,0.5581634,0.5448006,1.23
2,109,1934,2043,0.6016004,0.5919775,1.11
2,110,1934,2044,0.6469012,0.6417408,1.00
2,111,1934,2045,0.6939204,0.6939500,0.90
2,112,1934,2046,0.7424819,0.7484350,0.81
2,113,1934,2047,0.7923800,0.8049227,0.72
2,114,1934,2048,0.8433824,0.8630641,0.64
2,115,1934,2049,1.0000000,1.0000000,0.50
2,65,1935,2000,0.0086645,0.0103562,21.48
2,66,1935,2001,0.0094558,0.0111231,20.70
2,67,1935,2002,0.0103010,0.0119414,19.92
2,68,1935,2003,0.0112531,0.0128698,19.16
2,69,1935,2004,0.0123584,0.0139450,18.40
2,70,1935,2005,0.0136702,0.0152004,17.65
2,71,1935,2006,0.0152518,0.0166943,16.92
2,72,1935,2007,0.0170987,0.0184358,16.20
2,73,1935,2008,0.0190837,0.0202984,15.49
2,74,1935,2009,0.0210750,0.0221200,14.80
2,75,1935,2010,0.0231062,0.0239195,14.13
2,76,1935,2011,0.0253497,0.0258837,13.46
2,77,1935,2012,0.0279666,0.0281956,12.80
2,78,1935,2013,0.0310443,0.0309319,12.16
2,79,1935,2014,0.0345982,0.0340586,11.53
2,80,1935,2015,0.0395295,0.0384845,10.92
2,81,1935,2016,0.0438328,0.0421978,10.34
2,82,1935,2017,0.0485928,0.0463347,9.77
2,83,1935,2018,0.0538556,0.0509472,9.22
2,84,1935,2019,0.0596709,0.0560300,8.69
2,85,1935,2020,0.0660929,0.0615984,8.18
2,86,1935,2021,0.0731799,0.0677439,7.68
2,87,1935,2022,0.0809950,0.0745817,7.21
2,88,1935,2023,0.0896059,0.0821880,6.75
2,89,1935,2024,0.0990850,0.0905667,6.31
2,90,1935,2025,0.1095094,0.0997543,5.88
2,91,1935,2026,0.1209607,0.1098833,5.48
2,92,1935,2027,0.1335249,0.1211195,5.09
2,93,1935,2028,0.1472918,0.1335828,4.73
2,94,1935,2029,0.1623547,0.1473047,4.38
2,95,1935,2030,0.1788093,0.1623448,4.05
2,96,1935,2031,0.1967531,0.1788786,3.74
2,97,1935,2032,0.2162837,0.1971198,3.44
2,98,1935,2033,0.2374976,0.2172215,3.17
2,99,1935,2034,0.2604884,0.2392317,2.90
2,100,1935,2035,0.2853445,0.2632286,2.66
2,101,1935,2036,0.3121468,0.2894088,2.43
2,102,1935,2037,0.3409660,0.3179882,2.22
2,103,1935,2038,0.3718598,0.3490973,2.02
2,104,1935,2039,0.4048696,0.3827560,1.84
2,105,1935,2040,0.4400178,0.4190117,1.67
2,106,1935,2041,0.4773042,0.4579904,1.51
2,107,1935,2042,0.5167037,0.4997865,1.37
2,108,1935,2043,0.5581634,0.5443855,1.24
2,109,1935,2044,0.6016004,0.5916810,1.11
2,110,1935,2045,0.6469012,0.6415727,1.00
2,111,1935,2046,0.6939204,0.6939510,0.90
2,112,1935,2047,0.7424819,0.7486113,0.81
2,113,1935,2048,0.7923800,0.8052589,0.72
2,114,1935,2049,0.8433824,0.8635946,0.64
2,115,1935,2050,1.0000000,1.0000000,0.50
2,64,1936,2000,0.0078986,0.0094568,22.36
2,65,1936,2001,0.0086645,0.0101950,21.57
2,66,1936,2002,0.0094558,0.0109613,20.78
2,67,1936,2003,0.0103010,0.0117865,20.01
2,68,1936,2004,0.0112531,0.0127099,19.24
2,69,1936,2005,0.0123584,0.0137621,18.48
2,70,1936,2006,0.0136702,0.0149991,17.73
2,71,1936,2007,0.0152518,0.0164897,17.00
2,72,1936,2008,0.0170987,0.0182248,16.27
2,73,1936,2009,0.0190837,0.0200529,15.57
2,74,1936,2010,0.0210750,0.0218294,14.87
2,75,1936,2011,0.0231062,0.0236031,14.19
2,76,1936,2012,0.0253497,0.0255638,13.53
2,77,1936,2013,0.0279666,0.0278610,12.87
2,78,1936,2014,0.0310443,0.0305359,12.22
2,79,1936,2015,0.0345982,0.0335927,11.59
2,80,1936,2016,0.0395295,0.0379944,10.98
2,81,1936,2017,0.0438328,0.0417116,10.39
2,82,1936,2018,0.0485928,0.0458595,9.82
2,83,1936,2019,0.0538556,0.0504329,9.27
2,84,1936,2020,0.0596709,0.0554392,8.73
2,85,1936,2021,0.0660929,0.0609614,8.22
2,86,1936,2022,0.0731799,0.0671130,7.72
2,87,1936,2023,0.0809950,0.0739675,7.24
2,88,1936,2024,0.0896059,0.0815267,6.78
2,89,1936,2025,0.0990850,0.0898111,6.33
2,90,1936,2026,0.1095094,0.0989447,5.91
2,91,1936,2027,0.1209607,0.1090872,5.50
2,92,1936,2028,0.1335249,0.1203514,5.11
2,93,1936,2029,0.1472918,0.1327656,4.75
2,94,1936,2030,0.1623547,0.1463845,4.40
2,95,1936,2031,0.1788093,0.1613752,4.06
2,96,1936,2032,0.1967531,0.1779438,3.75
2,97,1936,2033,0.2162837,0.1962401,3.45
2,98,1936,2034,0.2374976,0.2163125,3.18
2,99,1936,2035,0.2604884,0.2382390,2.91
2,100,1936,2036,0.2853445,0.2622174,2.67
2,101,1936,2037,0.3121468,0.2884708,2.44
2,102,1936,2038,0.3409660,0.3171429,2.23
2,103,1936,2039,0.3718598,0.3482672,2.03
2,104,1936,2040,0.4048696,0.3819062,1.84
2,105,1936,2041,0.4400178,0.4182135,1.67
2,106,1936,2042,0.4773042,0.4573229,1.51
2,107,1936,2043,0.5167037,0.4992629,1.37
2,108,1936,2044,0.5581634,0.5439623,1.24
2,109,1936,2045,0.6016004,0.5913587,1.11
2,110,1936,2046,0.6469012,0.6414005,1.00
2,111,1936,2047,0.6939204,0.6939518,0.90
2,112,1936,2048,0.7424819,0.7487754,0.81
2,113,1936,2049,0.7923800,0.8056059,0.72
2,114,1936,2050,0.8433824,0.8641738,0.64
2,115,1936,2051,1.0000000,1.0000000,0.50
2,63,1937,2000,0.0071641,0.0086071,23.25
2,64,1937,2001,0.0078986,0.0093083,22.45
2,65,1937,2002,0.0086645,0.0100465,21.66
2,66,1937,2003,0.0094558,0.0108192,20.87
2,67,1937,2004,0.0103010,0.0116396,20.10
2,68,1937,2005,0.0112531,0.0125419,19.33
2,69,1937,2006,0.0123584,0.0135773,18.56
2,70,1937,2007,0.0136702,0.0148105,17.81
2,71,1937,2008,0.0152518,0.0162942,17.07
2,72,1937,2009,0.0170987,0.0179970,16.35
2,73,1937,2010,0.0190837,0.0197833,15.64
2,74,1937,2011,0.0210750,0.0215358,14.94
2,75,1937,2012,0.0231062,0.0233054,14.26
2,76,1937,2013,0.0253497,0.0252510,13.59
2,77,1937,2014,0.0279666,0.0274891,12.93
2,78,1937,2015,0.0310443,0.0300971,12.28
2,79,1937,2016,0.0345982,0.0331221,11.65
2,80,1937,2017,0.0395295,0.0375383,11.03
2,81,1937,2018,0.0438328,0.0412658,10.44
2,82,1937,2019,0.0485928,0.0453769,9.87
2,83,1937,2020,0.0538556,0.0498784,9.31
2,84,1937,2021,0.0596709,0.0548405,8.77
2,85,1937,2022,0.0660929,0.0603671,8.26
2,86,1937,2023,0.0731799,0.0665333,7.75
2,87,1937,2024,0.0809950,0.0733425,7.27
2,88,1937,2025,0.0896059,0.0808119,6.81
2,89,1937,2026,0.0990850,0.0890437,6.36
2,90,1937,2027,0.1095094,0.0981878,5.93
2,91,1937,2028,0.1209607,0.1083545,5.52
2,92,1937,2029,0.1335249,0.1195689,5.14
2,93,1937,2030,0.1472918,0.1318807,4.77
2,94,1937,2031,0.1623547,0.1454478,4.41
2,95,1937,2032,0.1788093,0.1604672,4.08
2,96,1937,2033,0.1967531,0.1770840,3.76
2,97,1937,2034,0.2162837,0.1953455,3.47
2,98,1937,2035,0.2374976,0.2153277,3.19
2,99,1937,2036,0.2604884,0.2372264,2.92
2,100,1937,2037,0.2853445,0.2612678,2.68
2,101,1937,2038,0.3121468,0.2876040,2.45
2,102,1937,2039,0.3409660,0.3162782,2.23
2,103,1937,2040,0.3718598,0.3473647,2.03
2,104,1937,2041,0.4048696,0.3810376,1.85
2,105,1937,2042,0.4400178,0.4174631,1.67
2,106,1937,2043,0.4773042,0.4567069,1.52
2,107,1937,2044,0.5167037,0.4987292,1.37
2,108,1937,2045,0.5581634,0.5435024,1.24
2,109,1937,2046,0.6016004,0.5910287,1.11
2,110,1937,2047,0.6469012,0.6412383,1.00
2,111,1937,2048,0.6939204,0.6939527,0.90
2,112,1937,2049,0.7424819,0.7489449,0.81
2,113,1937,2050,0.7923800,0.8059849,0.72
2,114,1937,2051,0.8433824,0.8647671,0.64
2,115,1937,2052,1.0000000,1.0000000,0.50
2,62,1938,2000,0.0064757,0.0078080,24.16
2,63,1938,2001,0.0071641,0.0084693,23.35
2,64,1938,2002,0.0078986,0.0091713,22.54
2,65,1938,2003,0.0086645,0.0099160,21.75
2,66,1938,2004,0.0094558,0.0106843,20.96
2,67,1938,2005,0.0103010,0.0114852,20.18
2,68,1938,2006,0.0112531,0.0123722,19.41
2,69,1938,2007,0.0123584,0.0134042,18.65
2,70,1938,2008,0.0136702,0.0146302,17.89
2,71,1938,2009,0.0152518,0.0160832,17.15
2,72,1938,2010,0.0170987,0.0177470,16.43
2,73,1938,2011,0.0190837,0.0195110,15.71
2,74,1938,2012,0.0210750,0.0212597,15.02
2,75,1938,2013,0.0231062,0.0230144,14.33
2,76,1938,2014,0.0253497,0.0249034,13.66
2,77,1938,2015,0.0279666,0.0270773,12.99
2,78,1938,2016,0.0310443,0.0296544,12.34
2,79,1938,2017,0.0345982,0.0326847,11.70
2,80,1938,2018,0.0395295,0.0371203,11.08
2,81,1938,2019,0.0438328,0.0408133,10.49
2,82,1938,2020,0.0485928,0.0448568,9.91
2,83,1938,2021,0.0538556,0.0493169,9.36
2,84,1938,2022,0.0596709,0.0542822,8.82
2,85,1938,2023,0.0660929,0.0598213,8.29
2,86,1938,2024,0.0731799,0.0659438,7.79
2,87,1938,2025,0.0809950,0.0726675,7.30
2,88,1938,2026,0.0896059,0.0800864,6.84
2,89,1938,2027,0.0990850,0.0883265,6.39
2,90,1938,2028,0.1095094,0.0974915,5.96
2,91,1938,2029,0.1209607,0.1076083,5.55
2,92,1938,2030,0.1335249,0.1187219,5.16
2,93,1938,2031,0.1472918,0.1309803,4.78
2,94,1938,2032,0.1623547,0.1445708,4.43
2,95,1938,2033,0.1788093,0.1596323,4.09
2,96,1938,2034,0.1967531,0.1762101,3.78
2,97,1938,2035,0.2162837,0.1943767,3.48
2,98,1938,2036,0.2374976,0.2143235,3.20
2,99,1938,2037,0.2604884,0.2362759,2.93
2,100,1938,2038,0.2853445,0.2603905,2.68
2,101,1938,2039,0.3121468,0.2867175,2.45
2,102,1938,2040,0.3409660,0.3153385,2.24
2,103,1938,2041,0.3718598,0.3464426,2.04
2,104,1938,2042,0.4048696,0.3802212,1.85
2,105,1938,2043,0.4400178,0.4167710,1.68
2,106,1938,2044,0.4773042,0.4560793,1.52
2,107,1938,2045,0.5167037,0.4981492,1.37
2,108,1938,2046,0.5581634,0.5430317,1.24
2,109,1938,2047,0.6016004,0.5907178,1.11
2,110,1938,2048,0.6469012,0.6410872,1.00
2,111,1938,2049,0.6939204,0.6939536,0.90
2,112,1938,2050,0.7424819,0.7491298,0.81
2,113,1938,2051,0.7923800,0.8063730,0.72
2,114,1938,2052,0.8433824,0.8653266,0.63
2,115,1938,2053,1.0000000,1.0000000,0.50
2,61,1939,2000,0.0058480,0.0070714,25.09
2,62,1939,2001,0.0064757,0.0076806,24.26
2,63,1939,2002,0.0071641,0.0083424,23.45
2,64,1939,2003,0.0078986,0.0090511,22.64
2,65,1939,2004,0.0086645,0.0097922,21.84
2,66,1939,2005,0.0094558,0.0105426,21.05
2,67,1939,2006,0.0103010,0.0113292,20.27
2,68,1939,2007,0.0112531,0.0122132,19.50
2,69,1939,2008,0.0123584,0.0132388,18.73
2,70,1939,2009,0.0136702,0.0144357,17.98
2,71,1939,2010,0.0152518,0.0158516,17.23
2,72,1939,2011,0.0170987,0.0174945,16.50
2,73,1939,2012,0.0190837,0.0192549,15.79
2,74,1939,2013,0.0210750,0.0209899,15.09
2,75,1939,2014,0.0231062,0.0226912,14.40
2,76,1939,2015,0.0253497,0.0245187,13.72
2,77,1939,2016,0.0279666,0.0266619,13.06
2,78,1939,2017,0.0310443,0.0292431,12.40
2,79,1939,2018,0.0345982,0.0322844,11.76
2,80,1939,2019,0.0395295,0.0366963,11.13
2,81,1939,2020,0.0438328,0.0403258,10.54
2,82,1939,2021,0.0485928,0.0443303,9.96
2,83,1939,2022,0.0538556,0.0487935,9.40
2,84,1939,2023,0.0596709,0.0537698,8.86
2,85,1939,2024,0.0660929,0.0592665,8.33
2,86,1939,2025,0.0731799,0.0653073,7.82
2,87,1939,2026,0.0809950,0.0719824,7.34
2,88,1939,2027,0.0896059,0.0794086,6.87
2,89,1939,2028,0.0990850,0.0876670,6.42
2,90,1939,2029,0.1095094,0.0967826,5.98
2,91,1939,2030,0.1209607,0.1068010,5.57
2,92,1939,2031,0.1335249,0.1178605,5.18
2,93,1939,2032,0.1472918,0.1301378,4.80
2,94,1939,2033,0.1623547,0.1437649,4.45
2,95,1939,2034,0.1788093,0.1587841,4.11
2,96,1939,2035,0.1967531,0.1752640,3.79
2,97,1939,2036,0.2162837,0.1933892,3.49
2,98,1939,2037,0.2374976,0.2133813,3.21
2,99,1939,2038,0.2604884,0.2353982,2.94
2,100,1939,2039,0.2853445,0.2594938,2.69
2,101,1939,2040,0.3121468,0.2857544,2.46
2,102,1939,2041,0.3409660,0.3143786,2.24
2,103,1939,2042,0.3718598,0.3455763,2.04
2,104,1939,2043,0.4048696,0.3794685,1.85
2,105,1939,2044,0.4400178,0.4160658,1.68
2,106,1939,2045,0.4773042,0.4553975,1.52
2,107,1939,2046,0.5167037,0.4975560,1.37
2,108,1939,2047,0.5581634,0.5425882,1.24
2,109,1939,2048,0.6016004,0.5904285,1.12
2,110,1939,2049,0.6469012,0.6409314,1.00
2,111,1939,2050,0.6939204,0.6939545,0.90
2,112,1939,2051,0.7424819,0.7493193,0.81
2,113,1939,2052,0.7923800,0.8067390,0.72
2,114,1939,2053,0.8433824,0.8658484,0.63
2,115,1939,2054,1.0000000,1.0000000,0.50
2,60,1940,2000,0.0052973,0.0064192,26.02
2,61,1940,2001,0.0058480,0.0069542,25.19
2,62,1940,2002,0.0064757,0.0075632,24.36
2,63,1940,2003,0.0071641,0.0082309,23.54
2,64,1940,2004,0.0078986,0.0089370,22.73
2,65,1940,2005,0.0086645,0.0096621,21.93
2,66,1940,2006,0.0094558,0.0103994,21.14
2,67,1940,2007,0.0103010,0.0111831,20.36
2,68,1940,2008,0.0112531,0.0120613,19.58
2,69,1940,2009,0.0123584,0.0130604,18.82
2,70,1940,2010,0.0136702,0.0142224,18.06
2,71,1940,2011,0.0152518,0.0156179,17.31
2,72,1940,2012,0.0170987,0.0172573,16.58
2,73,1940,2013,0.0190837,0.0190048,15.86
2,74,1940,2014,0.0210750,0.0206902,15.16
2,75,1940,2015,0.0231062,0.0223336,14.47
2,76,1940,2016,0.0253497,0.0241310,13.79
2,77,1940,2017,0.0279666,0.0262764,13.12
2,78,1940,2018,0.0310443,0.0288669,12.46
2,79,1940,2019,0.0345982,0.0318787,11.81
2,80,1940,2020,0.0395295,0.0362398,11.19
2,81,1940,2021,0.0438328,0.0398326,10.59
2,82,1940,2022,0.0485928,0.0438399,10.01
2,83,1940,2023,0.0538556,0.0483132,9.44
2,84,1940,2024,0.0596709,0.0532491,8.90
2,85,1940,2025,0.0660929,0.0586677,8.37
2,86,1940,2026,0.0731799,0.0646616,7.86
2,87,1940,2027,0.0809950,0.0713428,7.37
2,88,1940,2028,0.0896059,0.0787856,6.90
2,89,1940,2029,0.0990850,0.0869959,6.44
2,90,1940,2030,0.1095094,0.0960160,6.01
2,91,1940,2031,0.1209607,0.1059803,5.59
2,92,1940,2032,0.1335249,0.1170548,5.20
2,93,1940,2033,0.1472918,0.1293638,4.82
2,94,1940,2034,0.1623547,0.1429464,4.46
2,95,1940,2035,0.1788093,0.1578663,4.12
2,96,1940,2036,0.1967531,0.1743000,3.80
2,97,1940,2037,0.2162837,0.1924630,3.50
2,98,1940,2038,0.2374976,0.2125115,3.22
2,99,1940,2039,0.2604884,0.2345012,2.95
2,100,1940,2040,0.2853445,0.2585199,2.70
2,101,1940,2041,0.3121468,0.2847711,2.46
2,102,1940,2042,0.3409660,0.3134771,2.25
2,103,1940,2043,0.3718598,0.3447777,2.04
2,104,1940,2044,0.4048696,0.3787018,1.86
2,105,1940,2045,0.4400178,0.4153000,1.68
2,106,1940,2046,0.4773042,0.4547001,1.52
2,107,1940,2047,0.5167037,0.4969971,1.38
2,108,1940,2048,0.5581634,0.5421757,1.24
2,109,1940,2049,0.6016004,0.5901299,1.12
2,110,1940,2050,0.6469012,0.6407613,1.00
2,111,1940,2051,0.6939204,0.6939555,0.90
2,112,1940,2052,0.7424819,0.7494980,0.81
2,113,1940,2053,0.7923800,0.8070804,0.72
2,114,1940,2054,0.8433824,0.8663886,0.63
2,115,1940,2055,1.0000000,1.0000000,0.50
2,59,1941,2000,0.0048296,0.0058582,26.97
2,60,1941,2001,0.0052973,0.0063117,26.13
2,61,1941,2002,0.0058480,0.0068463,25.29
2,62,1941,2003,0.0064757,0.0074602,24.46
2,63,1941,2004,0.0071641,0.0081252,23.64
2,64,1941,2005,0.0078986,0.0088172,22.83
2,65,1941,2006,0.0086645,0.0095307,22.03
2,66,1941,2007,0.0094558,0.0102654,21.24
2,67,1941,2008,0.0103010,0.0110435,20.45
2,68,1941,2009,0.0112531,0.0118975,19.67
2,69,1941,2010,0.0123584,0.0128647,18.90
2,70,1941,2011,0.0136702,0.0140072,18.14
2,71,1941,2012,0.0152518,0.0153985,17.39
2,72,1941,2013,0.0170987,0.0170256,16.66
2,73,1941,2014,0.0190837,0.0187271,15.94
2,74,1941,2015,0.0210750,0.0203587,15.23
2,75,1941,2016,0.0231062,0.0219733,14.54
2,76,1941,2017,0.0253497,0.0237712,13.85
2,77,1941,2018,0.0279666,0.0259240,13.18
2,78,1941,2019,0.0310443,0.0284860,12.52
2,79,1941,2020,0.0345982,0.0314424,11.87
2,80,1941,2021,0.0395295,0.0357781,11.24
2,81,1941,2022,0.0438328,0.0393734,10.64
2,82,1941,2023,0.0485928,0.0433900,10.05
2,83,1941,2024,0.0538556,0.0478254,9.49
2,84,1941,2025,0.0596709,0.0526873,8.94
2,85,1941,2026,0.0660929,0.0580606,8.41
2,86,1941,2027,0.0731799,0.0640591,7.89
2,87,1941,2028,0.0809950,0.0707552,7.40
2,88,1941,2029,0.0896059,0.0781518,6.93
2,89,1941,2030,0.0990850,0.0862704,6.47
2,90,1941,2031,0.1095094,0.0952370,6.03
2,91,1941,2032,0.1209607,0.1052130,5.62
2,92,1941,2033,0.1335249,0.1163149,5.22
2,93,1941,2034,0.1472918,0.1285781,4.84
2,94,1941,2035,0.1623547,0.1420611,4.48
2,95,1941,2036,0.1788093,0.1569315,4.14
2,96,1941,2037,0.1967531,0.1733963,3.82
2,97,1941,2038,0.2162837,0.1916084,3.51
2,98,1941,2039,0.2374976,0.2116230,3.23
2,99,1941,2040,0.2604884,0.2335274,2.96
2,100,1941,2041,0.2853445,0.2575260,2.71
2,101,1941,2042,0.3121468,0.2838479,2.47
2,102,1941,2043,0.3409660,0.3126464,2.25
2,103,1941,2044,0.3718598,0.3439646,2.05
2,104,1941,2045,0.4048696,0.3778695,1.86
2,105,1941,2046,0.4400178,0.4145170,1.69
2,106,1941,2047,0.4773042,0.4540434,1.52
2,107,1941,2048,0.5167037,0.4964773,1.38
2,108,1941,2049,0.5581634,0.5417500,1.24
2,109,1941,2050,0.6016004,0.5898041,1.12
2,110,1941,2051,0.6469012,0.6405870,1.00
2,111,1941,2052,0.6939204,0.6939564,0.90
2,112,1941,2053,0.7424819,0.7496645,0.80
2,113,1941,2054,0.7923800,0.8074337,0.72
2,114,1941,2055,0.8433824,0.8669790,0.63
2,115,1941,2056,1.0000000,1.0000000,0.50
2,58,1942,2000,0.0044295,0.0053697,27.93
2,59,1942,2001,0.0048296,0.0057595,27.08
2,60,1942,2002,0.0052973,0.0062127,26.23
2,61,1942,2003,0.0058480,0.0067517,25.39
2,62,1942,2004,0.0064757,0.0073625,24.56
2,63,1942,2005,0.0071641,0.0080142,23.74
2,64,1942,2006,0.0078986,0.0086961,22.93
2,65,1942,2007,0.0086645,0.0094076,22.12
2,66,1942,2008,0.0094558,0.0101372,21.33
2,67,1942,2009,0.0103010,0.0108930,20.54
2,68,1942,2010,0.0112531,0.0117178,19.76
2,69,1942,2011,0.0123584,0.0126674,18.99
2,70,1942,2012,0.0136702,0.0138051,18.23
2,71,1942,2013,0.0152518,0.0151842,17.48
2,72,1942,2014,0.0170987,0.0167686,16.74
2,73,1942,2015,0.0190837,0.0184201,16.01
2,74,1942,2016,0.0210750,0.0200248,15.31
2,75,1942,2017,0.0231062,0.0216390,14.61
2,76,1942,2018,0.0253497,0.0234425,13.92
2,77,1942,2019,0.0279666,0.0255673,13.24
2,78,1942,2020,0.0310443,0.0280765,12.58
2,79,1942,2021,0.0345982,0.0310018,11.93
2,80,1942,2022,0.0395295,0.0353484,11.29
2,81,1942,2023,0.0438328,0.0389524,10.69
2,82,1942,2024,0.0485928,0.0429333,10.10
2,83,1942,2025,0.0538556,0.0472994,9.53
2,84,1942,2026,0.0596709,0.0521181,8.98
2,85,1942,2027,0.0660929,0.0574944,8.44
2,86,1942,2028,0.0731799,0.0635058,7.93
2,87,1942,2029,0.0809950,0.0701576,7.43
2,88,1942,2030,0.0896059,0.0774671,6.96
2,89,1942,2031,0.0990850,0.0855336,6.50
2,90,1942,2032,0.1095094,0.0945091,6.06
2,91,1942,2033,0.1209607,0.1045087,5.64
2,92,1942,2034,0.1335249,0.1155642,5.24
2,93,1942,2035,0.1472918,0.1277286,4.86
2,94,1942,2036,0.1623547,0.1411598,4.50
2,95,1942,2037,0.1788093,0.1560555,4.15
2,96,1942,2038,0.1967531,0.1725629,3.83
2,97,1942,2039,0.2162837,0.1907357,3.52
2,98,1942,2040,0.2374976,0.2106589,3.24
2,99,1942,2041,0.2604884,0.2325341,2.97
2,100,1942,2042,0.2853445,0.2565932,2.71
2,101,1942,2043,0.3121468,0.2829976,2.48
2,102,1942,2044,0.3409660,0.3118009,2.26
2,103,1942,2045,0.3718598,0.3430822,2.05
2,104,1942,2046,0.4048696,0.3770187,1.86
2,105,1942,2047,0.4400178,0.4137799,1.69
2,106,1942,2048,0.4773042,0.4534328,1.53
2,107,1942,2049,0.5167037,0.4959411,1.38
2,108,1942,2050,0.5581634,0.5412855,1.24
2,109,1942,2051,0.6016004,0.5894704,1.12
2,110,1942,2052,0.6469012,0.6404228,1.00
2,111,1942,2053,0.6939204,0.6939572,0.90
2,112,1942,2054,0.7424819,0.7498370,0.80
2,113,1942,2055,0.7923800,0.8078200,0.72
2,114,1942,2056,0.8433824,0.8675836,0.63
2,115,1942,2057,1.0000000,1.0000000,0.50
2,57,1943,2000,0.0040692,0.0049259,28.89
2,58,1943,2001,0.0044295,0.0052796,28.04
2,59,1943,2002,0.0048296,0.0056687,27.18
2,60,1943,2003,0.0052973,0.0061258,26.33
2,61,1943,2004,0.0058480,0.0066619,25.49
2,62,1943,2005,0.0064757,0.0072600,24.66
2,63,1943,2006,0.0071641,0.0079020,23.84
2,64,1943,2007,0.0078986,0.0085828,23.02
2,65,1943,2008,0.0086645,0.0092900,22.22
2,66,1943,2009,0.0094558,0.0099991,21.42
2,67,1943,2010,0.0103010,0.0107279,20.63
2,68,1943,2011,0.0112531,0.0115367,19.85
2,69,1943,2012,0.0123584,0.0124821,19.08
2,70,1943,2013,0.0136702,0.0136080,18.31
2,71,1943,2014,0.0152518,0.0149467,17.56
2,72,1943,2015,0.0170987,0.0164845,16.82
2,73,1943,2016,0.0190837,0.0181109,16.09
2,74,1943,2017,0.0210750,0.0197152,15.38
2,75,1943,2018,0.0231062,0.0213338,14.68
2,76,1943,2019,0.0253497,0.0231100,13.99
2,77,1943,2020,0.0279666,0.0251841,13.30
2,78,1943,2021,0.0310443,0.0276634,12.64
2,79,1943,2022,0.0345982,0.0305922,11.98
2,80,1943,2023,0.0395295,0.0349547,11.34
2,81,1943,2024,0.0438328,0.0385252,10.74
2,82,1943,2025,0.0485928,0.0424411,10.15
2,83,1943,2026,0.0538556,0.0467667,9.57
2,84,1943,2027,0.0596709,0.0515874,9.02
2,85,1943,2028,0.0660929,0.0569746,8.48
2,86,1943,2029,0.0731799,0.0629434,7.96
2,87,1943,2030,0.0809950,0.0695123,7.47
2,88,1943,2031,0.0896059,0.0767720,6.99
2,89,1943,2032,0.0990850,0.0848454,6.53
2,90,1943,2033,0.1095094,0.0938412,6.08
2,91,1943,2034,0.1209607,0.1037943,5.66
2,92,1943,2035,0.1335249,0.1147527,5.26
2,93,1943,2036,0.1472918,0.1268641,4.88
2,94,1943,2037,0.1623547,0.1403157,4.51
2,95,1943,2038,0.1788093,0.1552479,4.17
2,96,1943,2039,0.1967531,0.1717120,3.84
2,97,1943,2040,0.2162837,0.1897891,3.53
2,98,1943,2041,0.2374976,0.2096757,3.25
2,99,1943,2042,0.2604884,0.2316022,2.97
2,100,1943,2043,0.2853445,0.2557343,2.72
2,101,1943,2044,0.3121468,0.2821324,2.48
2,102,1943,2045,0.3409660,0.3108836,2.26
2,103,1943,2046,0.3718598,0.3421806,2.06
2,104,1943,2047,0.4048696,0.3762181,1.87
2,105,1943,2048,0.4400178,0.4130947,1.69
2,106,1943,2049,0.4773042,0.4528030,1.53
2,107,1943,2050,0.5167037,0.4953561,1.38
2,108,1943,2051,0.5581634,0.5408101,1.24
2,109,1943,2052,0.6016004,0.5891560,1.12
2,110,1943,2053,0.6469012,0.6402696,1.00
2,111,1943,2054,0.6939204,0.6939581,0.90
2,112,1943,2055,0.7424819,0.7500256,0.80
2,113,1943,2056,0.7923800,0.8082156,0.72
2,114,1943,2057,0.8433824,0.8681532,0.63
2,115,1943,2058,1.0000000,1.0000000,0.50
2,56,1944,2000,0.0037277,0.0045097,29.87
2,57,1944,2001,0.0040692,0.0048438,29.00
2,58,1944,2002,0.0044295,0.0051966,28.14
2,59,1944,2003,0.0048296,0.0055890,27.29
2,60,1944,2004,0.0052973,0.0060435,26.44
2,61,1944,2005,0.0058480,0.0065677,25.60
2,62,1944,2006,0.0064757,0.0071564,24.76
2,63,1944,2007,0.0071641,0.0077971,23.94
2,64,1944,2008,0.0078986,0.0084744,23.12
2,65,1944,2009,0.0086645,0.0091632,22.31
2,66,1944,2010,0.0094558,0.0098476,21.52
2,67,1944,2011,0.0103010,0.0105615,20.72
2,68,1944,2012,0.0112531,0.0113667,19.94
2,69,1944,2013,0.0123584,0.0123015,19.16
2,70,1944,2014,0.0136702,0.0133895,18.40
2,71,1944,2015,0.0152518,0.0146843,17.64
2,72,1944,2016,0.0170987,0.0161986,16.89
2,73,1944,2017,0.0190837,0.0178243,16.16
2,74,1944,2018,0.0210750,0.0194325,15.45
2,75,1944,2019,0.0231062,0.0210250,14.75
2,76,1944,2020,0.0253497,0.0227530,14.05
2,77,1944,2021,0.0279666,0.0247978,13.37
2,78,1944,2022,0.0310443,0.0272796,12.69
2,79,1944,2023,0.0345982,0.0302174,12.04
2,80,1944,2024,0.0395295,0.0345554,11.40
2,81,1944,2025,0.0438328,0.0380650,10.79
2,82,1944,2026,0.0485928,0.0419429,10.19
2,83,1944,2027,0.0538556,0.0462702,9.62
2,84,1944,2028,0.0596709,0.0511005,9.06
2,85,1944,2029,0.0660929,0.0564465,8.52
2,86,1944,2030,0.0731799,0.0623363,8.00
2,87,1944,2031,0.0809950,0.0688575,7.50
2,88,1944,2032,0.0896059,0.0761230,7.02
2,89,1944,2033,0.0990850,0.0842142,6.55
2,90,1944,2034,0.1095094,0.0931640,6.11
2,91,1944,2035,0.1209607,0.1030226,5.69
2,92,1944,2036,0.1335249,0.1139275,5.28
2,93,1944,2037,0.1472918,0.1260548,4.90
2,94,1944,2038,0.1623547,0.1395376,4.53
2,95,1944,2039,0.1788093,0.1544238,4.18
2,96,1944,2040,0.1967531,0.1707896,3.86
2,97,1944,2041,0.2162837,0.1888243,3.55
2,98,1944,2042,0.2374976,0.2087538,3.26
2,99,1944,2043,0.2604884,0.2307445,2.98
2,100,1944,2044,0.2853445,0.2548607,2.73
2,101,1944,2045,0.3121468,0.2811941,2.49
2,102,1944,2046,0.3409660,0.3099467,2.27
2,103,1944,2047,0.3718598,0.3413323,2.06
2,104,1944,2048,0.4048696,0.3754741,1.87
2,105,1944,2049,0.4400178,0.4123883,1.69
2,106,1944,2050,0.4773042,0.4521161,1.53
2,107,1944,2051,0.5167037,0.4947577,1.38
2,108,1944,2052,0.5581634,0.5403621,1.24
2,109,1944,2053,0.6016004,0.5888629,1.12
2,110,1944,2054,0.6469012,0.6401111,1.00
2,111,1944,2055,0.6939204,0.6939591,0.90
2,112,1944,2056,0.7424819,0.7502186,0.80
2,113,1944,2057,0.7923800,0.8085881,0.72
2,114,1944,2058,0.8433824,0.8686807,0.63
2,115,1944,2059,1.0000000,1.0000000,0.50
2,55,1945,2000,0.0034035,0.0041244,30.86
2,56,1945,2001,0.0037277,0.0044348,29.98
2,57,1945,2002,0.0040692,0.0047682,29.11
2,58,1945,2003,0.0044295,0.0051238,28.25
2,59,1945,2004,0.0048296,0.0055135,27.39
2,60,1945,2005,0.0052973,0.0059570,26.54
2,61,1945,2006,0.0058480,0.0064726,25.70
2,62,1945,2007,0.0064757,0.0070595,24.86
2,63,1945,2008,0.0071641,0.0076968,24.04
2,64,1945,2009,0.0078986,0.0083577,23.22
2,65,1945,2010,0.0086645,0.0090241,22.41
2,66,1945,2011,0.0094558,0.0096948,21.61
2,67,1945,2012,0.0103010,0.0104053,20.82
2,68,1945,2013,0.0112531,0.0112009,20.03
2,69,1945,2014,0.0123584,0.0121012,19.25
2,70,1945,2015,0.0136702,0.0131483,18.48
2,71,1945,2016,0.0152518,0.0144204,17.72
2,72,1945,2017,0.0170987,0.0159338,16.97
2,73,1945,2018,0.0190837,0.0175627,16.24
2,74,1945,2019,0.0210750,0.0191466,15.52
2,75,1945,2020,0.0231062,0.0206936,14.81
2,76,1945,2021,0.0253497,0.0223931,14.12
2,77,1945,2022,0.0279666,0.0244391,13.43
2,78,1945,2023,0.0310443,0.0269286,12.75
2,79,1945,2024,0.0345982,0.0298377,12.09
2,80,1945,2025,0.0395295,0.0341255,11.45
2,81,1945,2026,0.0438328,0.0375993,10.83
2,82,1945,2027,0.0485928,0.0414788,10.24
2,83,1945,2028,0.0538556,0.0458149,9.66
2,84,1945,2029,0.0596709,0.0506060,9.10
2,85,1945,2030,0.0660929,0.0558767,8.56
2,86,1945,2031,0.0731799,0.0617205,8.03
2,87,1945,2032,0.0809950,0.0682464,7.53
2,88,1945,2033,0.0896059,0.0755280,7.05
2,89,1945,2034,0.0990850,0.0835744,6.58
2,90,1945,2035,0.1095094,0.0924327,6.13
2,91,1945,2036,0.1209607,0.1022380,5.71
2,92,1945,2037,0.1335249,0.1131551,5.30
2,93,1945,2038,0.1472918,0.1253092,4.91
2,94,1945,2039,0.1623547,0.1387441,4.55
2,95,1945,2040,0.1788093,0.1535308,4.20
2,96,1945,2041,0.1967531,0.1698498,3.87
2,97,1945,2042,0.2162837,0.1879200,3.56
2,98,1945,2043,0.2374976,0.2079056,3.27
2,99,1945,2044,0.2604884,0.2298725,2.99
2,100,1945,2045,0.2853445,0.2539137,2.73
2,101,1945,2046,0.3121468,0.2802361,2.50
2,102,1945,2047,0.3409660,0.3090656,2.27
2,103,1945,2048,0.3718598,0.3405443,2.06
2,104,1945,2049,0.4048696,0.3747072,1.87
2,105,1945,2050,0.4400178,0.4116180,1.70
2,106,1945,2051,0.4773042,0.4514136,1.53
2,107,1945,2052,0.5167037,0.4941937,1.38
2,108,1945,2053,0.5581634,0.5399446,1.24
2,109,1945,2054,0.6016004,0.5885596,1.12
2,110,1945,2055,0.6469012,0.6399380,1.00
2,111,1945,2056,0.6939204,0.6939601,0.90
2,112,1945,2057,0.7424819,0.7504004,0.80
2,113,1945,2058,0.7923800,0.8089332,0.72
2,114,1945,2059,0.8433824,0.8692210,0.63
2,115,1945,2060,1.0000000,1.0000000,0.50
2,54,1946,2000,0.0031082,0.0037756,31.85
2,55,1946,2001,0.0034035,0.0040553,30.97
2,56,1946,2002,0.0037277,0.0043658,30.09
2,57,1946,2003,0.0040692,0.0047019,29.22
2,58,1946,2004,0.0044295,0.0050548,28.36
2,59,1946,2005,0.0048296,0.0054343,27.50
2,60,1946,2006,0.0052973,0.0058698,26.65
2,61,1946,2007,0.0058480,0.0063836,25.80
2,62,1946,2008,0.0064757,0.0069669,24.97
2,63,1946,2009,0.0071641,0.0075887,24.14
2,64,1946,2010,0.0078986,0.0082296,23.32
2,65,1946,2011,0.0086645,0.0088839,22.51
2,66,1946,2012,0.0094558,0.0095515,21.70
2,67,1946,2013,0.0103010,0.0102530,20.91
2,68,1946,2014,0.0112531,0.0110171,20.12
2,69,1946,2015,0.0123584,0.0118802,19.34
2,70,1946,2016,0.0136702,0.0129058,18.56
2,71,1946,2017,0.0152518,0.0141761,17.80
2,72,1946,2018,0.0170987,0.0156921,17.05
2,73,1946,2019,0.0190837,0.0172983,16.31
2,74,1946,2020,0.0210750,0.0188399,15.59
2,75,1946,2021,0.0231062,0.0203597,14.88
2,76,1946,2022,0.0253497,0.0220592,14.18
2,77,1946,2023,0.0279666,0.0241113,13.49
2,78,1946,2024,0.0310443,0.0265733,12.81
2,79,1946,2025,0.0345982,0.0294293,12.15
2,80,1946,2026,0.0395295,0.0336907,11.50
2,81,1946,2027,0.0438328,0.0371658,10.88
2,82,1946,2028,0.0485928,0.0410533,10.28
2,83,1946,2029,0.0538556,0.0453527,9.70
2,84,1946,2030,0.0596709,0.0500726,9.14
2,85,1946,2031,0.0660929,0.0552990,8.60
2,86,1946,2032,0.0731799,0.0611461,8.07
2,87,1946,2033,0.0809950,0.0676864,7.56
2,88,1946,2034,0.0896059,0.0749251,7.07
2,89,1946,2035,0.0990850,0.0828838,6.61
2,90,1946,2036,0.1095094,0.0916896,6.16
2,91,1946,2037,0.1209607,0.1015040,5.73
2,92,1946,2038,0.1335249,0.1124439,5.32
2,93,1946,2039,0.1472918,0.1245491,4.93
2,94,1946,2040,0.1623547,0.1378845,4.56
2,95,1946,2041,0.1788093,0.1526213,4.21
2,96,1946,2042,0.1967531,0.1689692,3.88
2,97,1946,2043,0.2162837,0.1870883,3.57
2,98,1946,2044,0.2374976,0.2070436,3.28
2,99,1946,2045,0.2604884,0.2289275,3.00
2,100,1946,2046,0.2853445,0.2529472,2.74
2,101,1946,2047,0.3121468,0.2793355,2.50
2,102,1946,2048,0.3409660,0.3082474,2.28
2,103,1946,2049,0.3718598,0.3397324,2.07
2,104,1946,2050,0.4048696,0.3738713,1.88
2,105,1946,2051,0.4400178,0.4108304,1.70
2,106,1946,2052,0.4773042,0.4507519,1.53
2,107,1946,2053,0.5167037,0.4936683,1.38
2,108,1946,2054,0.5581634,0.5395126,1.25
2,109,1946,2055,0.6016004,0.5882282,1.12
2,110,1946,2056,0.6469012,0.6397607,1.00
2,111,1946,2057,0.6939204,0.6939610,0.90
2,112,1946,2058,0.7424819,0.7505688,0.80
2,113,1946,2059,0.7923800,0.8092867,0.72
2,114,1946,2060,0.8433824,0.8698094,0.63
2,115,1946,2061,1.0000000,1.0000000,0.50
2,53,1947,2000,0.0028474,0.0034651,32.85
2,54,1947,2001,0.0031082,0.0037115,31.97
2,55,1947,2002,0.0034035,0.0039916,31.08
2,56,1947,2003,0.0037277,0.0043053,30.20
2,57,1947,2004,0.0040692,0.0046390,29.33
2,58,1947,2005,0.0044295,0.0049823,28.47
2,59,1947,2006,0.0048296,0.0053543,27.61
2,60,1947,2007,0.0052973,0.0057882,26.75
2,61,1947,2008,0.0058480,0.0062986,25.91
2,62,1947,2009,0.0064757,0.0068672,25.07
2,63,1947,2010,0.0071641,0.0074702,24.24
2,64,1947,2011,0.0078986,0.0081006,23.42
2,65,1947,2012,0.0086645,0.0087524,22.60
2,66,1947,2013,0.0094558,0.0094117,21.80
2,67,1947,2014,0.0103010,0.0100842,21.00
2,68,1947,2015,0.0112531,0.0108143,20.21
2,69,1947,2016,0.0123584,0.0116581,19.43
2,70,1947,2017,0.0136702,0.0126814,18.65
2,71,1947,2018,0.0152518,0.0139534,17.88
2,72,1947,2019,0.0170987,0.0154480,17.13
2,73,1947,2020,0.0190837,0.0170147,16.39
2,74,1947,2021,0.0210750,0.0185309,15.66
2,75,1947,2022,0.0231062,0.0200500,14.95
2,76,1947,2023,0.0253497,0.0217541,14.25
2,77,1947,2024,0.0279666,0.0237795,13.55
2,78,1947,2025,0.0310443,0.0261913,12.87
2,79,1947,2026,0.0345982,0.0290169,12.20
2,80,1947,2027,0.0395295,0.0332861,11.55
2,81,1947,2028,0.0438328,0.0367686,10.93
2,82,1947,2029,0.0485928,0.0406216,10.33
2,83,1947,2030,0.0538556,0.0448544,9.75
2,84,1947,2031,0.0596709,0.0495322,9.18
2,85,1947,2032,0.0660929,0.0547605,8.63
2,86,1947,2033,0.0731799,0.0606200,8.10
2,87,1947,2034,0.0809950,0.0671193,7.59
2,88,1947,2035,0.0896059,0.0742747,7.10
2,89,1947,2036,0.0990850,0.0821824,6.63
2,90,1947,2037,0.1095094,0.0909948,6.18
2,91,1947,2038,0.1209607,0.1008285,5.75
2,92,1947,2039,0.1335249,0.1117191,5.34
2,93,1947,2040,0.1472918,0.1237260,4.95
2,94,1947,2041,0.1623547,0.1370095,4.58
2,95,1947,2042,0.1788093,0.1517695,4.23
2,96,1947,2043,0.1967531,0.1681598,3.89
2,97,1947,2044,0.2162837,0.1862433,3.58
2,98,1947,2045,0.2374976,0.2061098,3.29
2,99,1947,2046,0.2604884,0.2279634,3.01
2,100,1947,2047,0.2853445,0.2520390,2.75
2,101,1947,2048,0.3121468,0.2784995,2.51
2,102,1947,2049,0.3409660,0.3074046,2.28
2,103,1947,2050,0.3718598,0.3388477,2.07
2,104,1947,2051,0.4048696,0.3730169,1.88
2,105,1947,2052,0.4400178,0.4100887,1.70
2,106,1947,2053,0.4773042,0.4501355,1.54
2,107,1947,2054,0.5167037,0.4931248,1.39
2,108,1947,2055,0.5581634,0.5390407,1.25
2,109,1947,2056,0.6016004,0.5878890,1.12
2,110,1947,2057,0.6469012,0.6395938,1.00
2,111,1947,2058,0.6939204,0.6939619,0.90
2,112,1947,2059,0.7424819,0.7507412,0.80
2,113,1947,2060,0.7923800,0.8096716,0.71
2,114,1947,2061,0.8433824,0.8704119,0.63
2,115,1947,2062,1.0000000,1.0000000,0.50
2,52,1948,2000,0.0026115,0.0031751,33.86
2,53,1948,2001,0.0028474,0.0034058,32.97
2,54,1948,2002,0.0031082,0.0036526,32.08
2,55,1948,2003,0.0034035,0.0039358,31.20
2,56,1948,2004,0.0037277,0.0042479,30.32
2,57,1948,2005,0.0040692,0.0045731,29.44
2,58,1948,2006,0.0044295,0.0049092,28.58
2,59,1948,2007,0.0048296,0.0052795,27.72
2,60,1948,2008,0.0052973,0.0057103,26.86
2,61,1948,2009,0.0058480,0.0062071,26.01
2,62,1948,2010,0.0064757,0.0067579,25.17
2,63,1948,2011,0.0071641,0.0073509,24.34
2,64,1948,2012,0.0078986,0.0079795,23.51
2,65,1948,2013,0.0086645,0.0086241,22.70
2,66,1948,2014,0.0094558,0.0092568,21.89
2,67,1948,2015,0.0103010,0.0098979,21.09
2,68,1948,2016,0.0112531,0.0106106,20.30
2,69,1948,2017,0.0123584,0.0114526,19.51
2,70,1948,2018,0.0136702,0.0124768,18.73
2,71,1948,2019,0.0152518,0.0137285,17.96
2,72,1948,2020,0.0170987,0.0151864,17.20
2,73,1948,2021,0.0190837,0.0167291,16.46
2,74,1948,2022,0.0210750,0.0182444,15.73
2,75,1948,2023,0.0231062,0.0197672,15.02
2,76,1948,2024,0.0253497,0.0214456,14.31
2,77,1948,2025,0.0279666,0.0234233,13.61
2,78,1948,2026,0.0310443,0.0258059,12.93
2,79,1948,2027,0.0345982,0.0286336,12.26
2,80,1948,2028,0.0395295,0.0329156,11.60
2,81,1948,2029,0.0438328,0.0363657,10.98
2,82,1948,2030,0.0485928,0.0401564,10.38
2,83,1948,2031,0.0538556,0.0443498,9.79
2,84,1948,2032,0.0596709,0.0490286,9.22
2,85,1948,2033,0.0660929,0.0542674,8.67
2,86,1948,2034,0.0731799,0.0600874,8.14
2,87,1948,2035,0.0809950,0.0665076,7.63
2,88,1948,2036,0.0896059,0.0736144,7.13
2,89,1948,2037,0.0990850,0.0815268,6.66
2,90,1948,2038,0.1095094,0.0903555,6.21
2,91,1948,2039,0.1209607,0.1001403,5.78
2,92,1948,2040,0.1335249,0.1109346,5.36
2,93,1948,2041,0.1472918,0.1228884,4.97
2,94,1948,2042,0.1623547,0.1361904,4.60
2,95,1948,2043,0.1788093,0.1509868,4.24
2,96,1948,2044,0.1967531,0.1673376,3.91
2,97,1948,2045,0.2162837,0.1853283,3.59
2,98,1948,2046,0.2374976,0.2051575,3.30
2,99,1948,2047,0.2604884,0.2270578,3.02
2,100,1948,2048,0.2853445,0.2511961,2.76
2,101,1948,2049,0.3121468,0.2776387,2.51
2,102,1948,2050,0.3409660,0.3064866,2.29
2,103,1948,2051,0.3718598,0.3379437,2.08
2,104,1948,2052,0.4048696,0.3722126,1.88
2,105,1948,2053,0.4400178,0.4093981,1.70
2,106,1948,2054,0.4773042,0.4494981,1.54
2,107,1948,2055,0.5167037,0.4925314,1.39
2,108,1948,2056,0.5581634,0.5385579,1.25
2,109,1948,2057,0.6016004,0.5875697,1.12
2,110,1948,2058,0.6469012,0.6394392,1.00
2,111,1948,2059,0.6939204,0.6939628,0.90
2,112,1948,2060,0.7424819,0.7509291,0.80
2,113,1948,2061,0.7923800,0.8100657,0.71
2,114,1948,2062,0.8433824,0.8709799,0.63
2,115,1948,2063,1.0000000,1.0000000,0.50
2,51,1949,2000,0.0023896,0.0028996,34.88
2,52,1949,2001,0.0026115,0.0031210,33.98
2,53,1949,2002,0.0028474,0.0033512,33.08
2,54,1949,2003,0.0031082,0.0036009,32.19
2,55,1949,2004,0.0034035,0.0038829,31.31
2,56,1949,2005,0.0037277,0.0041877,30.43
2,57,1949,2006,0.0040692,0.0045065,29.55
2,58,1949,2007,0.0044295,0.0048408,28.69
2,59,1949,2008,0.0048296,0.0052081,27.82
2,60,1949,2009,0.0052973,0.0056264,26.97
2,61,1949,2010,0.0058480,0.0061068,26.12
2,62,1949,2011,0.0064757,0.0066478,25.27
2,63,1949,2012,0.0071641,0.0072389,24.44
2,64,1949,2013,0.0078986,0.0078614,23.61
2,65,1949,2014,0.0086645,0.0084819,22.80
2,66,1949,2015,0.0094558,0.0090858,21.99
2,67,1949,2016,0.0103010,0.0097108,21.18
2,68,1949,2017,0.0112531,0.0104221,20.39
2,69,1949,2018,0.0123584,0.0112653,19.60
2,70,1949,2019,0.0136702,0.0122704,18.81
2,71,1949,2020,0.0152518,0.0134875,18.04
2,72,1949,2021,0.0170987,0.0149230,17.28
2,73,1949,2022,0.0190837,0.0164644,16.54
2,74,1949,2023,0.0210750,0.0179828,15.80
2,75,1949,2024,0.0231062,0.0194811,15.08
2,76,1949,2025,0.0253497,0.0211143,14.37
2,77,1949,2026,0.0279666,0.0230639,13.67
2,78,1949,2027,0.0310443,0.0254480,12.98
2,79,1949,2028,0.0345982,0.0282830,12.31
2,80,1949,2029,0.0395295,0.0325399,11.65
2,81,1949,2030,0.0438328,0.0359319,11.03
2,82,1949,2031,0.0485928,0.0396855,10.42
2,83,1949,2032,0.0538556,0.0438797,9.83
2,84,1949,2033,0.0596709,0.0485677,9.26
2,85,1949,2034,0.0660929,0.0537684,8.71
2,86,1949,2035,0.0731799,0.0595133,8.17
2,87,1949,2036,0.0809950,0.0658869,7.66
2,88,1949,2037,0.0896059,0.0729975,7.16
2,89,1949,2038,0.0990850,0.0809239,6.69
2,90,1949,2039,0.1095094,0.0897044,6.23
2,91,1949,2040,0.1209607,0.0993956,5.80
2,92,1949,2041,0.1335249,0.1101367,5.38
2,93,1949,2042,0.1472918,0.1221048,4.99
2,94,1949,2043,0.1623547,0.1354379,4.61
2,95,1949,2044,0.1788093,0.1501922,4.26
2,96,1949,2045,0.1967531,0.1664479,3.92
2,97,1949,2046,0.2162837,0.1843957,3.60
2,98,1949,2047,0.2374976,0.2042634,3.31
2,99,1949,2048,0.2604884,0.2262178,3.03
2,100,1949,2049,0.2853445,0.2503286,2.76
2,101,1949,2050,0.3121468,0.2767013,2.52
2,102,1949,2051,0.3409660,0.3055490,2.29
2,103,1949,2052,0.3718598,0.3370931,2.08
2,104,1949,2053,0.4048696,0.3714639,1.89
2,105,1949,2054,0.4400178,0.4086841,1.71
2,106,1949,2055,0.4773042,0.4488022,1.54
2,107,1949,2056,0.5167037,0.4919242,1.39
2,108,1949,2057,0.5581634,0.5381033,1.25
2,109,1949,2058,0.6016004,0.5872740,1.12
2,110,1949,2059,0.6469012,0.6392809,1.00
2,111,1949,2060,0.6939204,0.6939637,0.90
2,112,1949,2061,0.7424819,0.7511214,0.80
2,113,1949,2062,0.7923800,0.8104373,0.71
2,114,1949,2063,0.8433824,0.8715076,0.63
2,115,1949,2064,1.0000000,1.0000000,0.50
2,50,1950,2000,0.0021845,0.0026470,35.90
2,51,1950,2001,0.0023896,0.0028507,35.00
2,52,1950,2002,0.0026115,0.0030712,34.10
2,53,1950,2003,0.0028474,0.0033033,33.20
2,54,1950,2004,0.0031082,0.0035519,32.31
2,55,1950,2005,0.0034035,0.0038274,31.42
2,56,1950,2006,0.0037277,0.0041269,30.54
2,57,1950,2007,0.0040692,0.0044442,29.66
2,58,1950,2008,0.0044295,0.0047755,28.80
2,59,1950,2009,0.0048296,0.0051311,27.93
2,60,1950,2010,0.0052973,0.0055345,27.07
2,61,1950,2011,0.0058480,0.0060059,26.22
2,62,1950,2012,0.0064757,0.0065446,25.38
2,63,1950,2013,0.0071641,0.0071297,24.54
2,64,1950,2014,0.0078986,0.0077306,23.71
2,65,1950,2015,0.0086645,0.0083250,22.89
2,66,1950,2016,0.0094558,0.0089141,22.08
2,67,1950,2017,0.0103010,0.0095377,21.28
2,68,1950,2018,0.0112531,0.0102504,20.48
2,69,1950,2019,0.0123584,0.0110764,19.68
2,70,1950,2020,0.0136702,0.0120494,18.90
2,71,1950,2021,0.0152518,0.0132452,18.12
2,72,1950,2022,0.0170987,0.0146790,17.36
2,73,1950,2023,0.0190837,0.0162228,16.61
2,74,1950,2024,0.0210750,0.0177183,15.87
2,75,1950,2025,0.0231062,0.0191742,15.15
2,76,1950,2026,0.0253497,0.0207804,14.44
2,77,1950,2027,0.0279666,0.0227304,13.73
2,78,1950,2028,0.0310443,0.0251208,13.04
2,79,1950,2029,0.0345982,0.0279280,12.37
2,80,1950,2030,0.0395295,0.0321356,11.71
2,81,1950,2031,0.0438328,0.0354929,11.08
2,82,1950,2032,0.0485928,0.0392471,10.47
2,83,1950,2033,0.0538556,0.0434497,9.87
2,84,1950,2034,0.0596709,0.0481015,9.30
2,85,1950,2035,0.0660929,0.0532308,8.74
2,86,1950,2036,0.0731799,0.0589310,8.21
2,87,1950,2037,0.0809950,0.0653074,7.69
2,88,1950,2038,0.0896059,0.0724304,7.19
2,89,1950,2039,0.0990850,0.0803102,6.72
2,90,1950,2040,0.1095094,0.0890004,6.26
2,91,1950,2041,0.1209607,0.0986387,5.82
2,92,1950,2042,0.1335249,0.1093905,5.40
2,93,1950,2043,0.1472918,0.1213852,5.01
2,94,1950,2044,0.1623547,0.1346744,4.63
2,95,1950,2045,0.1788093,0.1493325,4.27
2,96,1950,2046,0.1967531,0.1655413,3.93
2,97,1950,2047,0.2162837,0.1835204,3.62
2,98,1950,2048,0.2374976,0.2034343,3.32
2,99,1950,2049,0.2604884,0.2253535,3.03
2,100,1950,2050,0.2853445,0.2493844,2.77
2,101,1950,2051,0.3121468,0.2757443,2.53
2,102,1950,2052,0.3409660,0.3046669,2.30
2,103,1950,2053,0.3718598,0.3363014,2.09
2,104,1950,2054,0.4048696,0.3706901,1.89
2,105,1950,2055,0.4400178,0.4079049,1.71
2,106,1950,2056,0.4773042,0.4480905,1.54
2,107,1950,2057,0.5167037,0.4913528,1.39
2,108,1950,2058,0.5581634,0.5376827,1.25
2,109,1950,2059,0.6016004,0.5869714,1.12
2,110,1950,2060,0.6469012,0.6391086,1.00
2,111,1950,2061,0.6939204,0.6939647,0.90
2,112,1950,2062,0.7424819,0.7513027,0.80
2,113,1950,2063,0.7923800,0.8107825,0.71
2,114,1950,2064,0.8433824,0.8720508,0.63
2,115,1950,2065,1.0000000,1.0000000,0.50
2,49,1951,2000,0.0020059,0.0024311,36.93
2,50,1951,2001,0.0021845,0.0026027,36.02
2,51,1951,2002,0.0023896,0.0028056,35.12
2,52,1951,2003,0.0026115,0.0030275,34.21
2,53,1951,2004,0.0028474,0.0032579,33.32
2,54,1951,2005,0.0031082,0.0035004,32.42
2,55,1951,2006,0.0034035,0.0037713,31.53
2,56,1951,2007,0.0037277,0.0040700,30.65
2,57,1951,2008,0.0040692,0.0043847,29.78
2,58,1951,2009,0.0044295,0.0047052,28.90
2,59,1951,2010,0.0048296,0.0050469,28.04
2,60,1951,2011,0.0052973,0.0054420,27.18
2,61,1951,2012,0.0058480,0.0059112,26.32
2,62,1951,2013,0.0064757,0.0064440,25.48
2,63,1951,2014,0.0071641,0.0070088,24.64
2,64,1951,2015,0.0078986,0.0075863,23.81
2,65,1951,2016,0.0086645,0.0081674,22.99
2,66,1951,2017,0.0094558,0.0087552,22.17
2,67,1951,2018,0.0103010,0.0093800,21.37
2,68,1951,2019,0.0112531,0.0100772,20.56
2,69,1951,2020,0.0123584,0.0108742,19.77
2,70,1951,2021,0.0136702,0.0118272,18.98
2,71,1951,2022,0.0152518,0.0130208,18.20
2,72,1951,2023,0.0170987,0.0144565,17.43
2,73,1951,2024,0.0190837,0.0159786,16.68
2,74,1951,2025,0.0210750,0.0174345,15.94
2,75,1951,2026,0.0231062,0.0188649,15.22
2,76,1951,2027,0.0253497,0.0204707,14.50
2,77,1951,2028,0.0279666,0.0224257,13.79
2,78,1951,2029,0.0310443,0.0247896,13.10
2,79,1951,2030,0.0345982,0.0275463,12.42
2,80,1951,2031,0.0395295,0.0317267,11.76
2,81,1951,2032,0.0438328,0.0350844,11.13
2,82,1951,2033,0.0485928,0.0388463,10.51
2,83,1951,2034,0.0538556,0.0430150,9.92
2,84,1951,2035,0.0596709,0.0475994,9.34
2,85,1951,2036,0.0660929,0.0526857,8.78
2,86,1951,2037,0.0731799,0.0583875,8.24
2,87,1951,2038,0.0809950,0.0647748,7.72
2,88,1951,2039,0.0896059,0.0718533,7.22
2,89,1951,2040,0.0990850,0.0796467,6.74
2,90,1951,2041,0.1095094,0.0882850,6.28
2,91,1951,2042,0.1209607,0.0979310,5.84
2,92,1951,2043,0.1335249,0.1087055,5.42
2,93,1951,2044,0.1472918,0.1206553,5.03
2,94,1951,2045,0.1623547,0.1338487,4.65
2,95,1951,2046,0.1788093,0.1484570,4.29
2,96,1951,2047,0.1967531,0.1646907,3.95
2,97,1951,2048,0.2162837,0.1827091,3.63
2,98,1951,2049,0.2374976,0.2025816,3.33
2,99,1951,2050,0.2604884,0.2244131,3.04
2,100,1951,2051,0.2853445,0.2484207,2.78
2,101,1951,2052,0.3121468,0.2748444,2.53
2,102,1951,2053,0.3409660,0.3038464,2.30
2,103,1951,2054,0.3718598,0.3354836,2.09
2,104,1951,2055,0.4048696,0.3698458,1.89
2,105,1951,2056,0.4400178,0.4071082,1.71
2,106,1951,2057,0.4773042,0.4474208,1.55
2,107,1951,2058,0.5167037,0.4908241,1.39
2,108,1951,2059,0.5581634,0.5372521,1.25
2,109,1951,2060,0.6016004,0.5866419,1.12
2,110,1951,2061,0.6469012,0.6389322,1.00
2,111,1951,2062,0.6939204,0.6939656,0.90
2,112,1951,2063,0.7424819,0.7514710,0.80
2,113,1951,2064,0.7923800,0.8111379,0.71
2,114,1951,2065,0.8433824,0.8726435,0.63
2,115,1951,2066,1.0000000,1.0000000,0.50
2,48,1952,2000,0.0018531,0.0022500,37.97
2,49,1952,2001,0.0020059,0.0023903,37.05
2,50,1952,2002,0.0021845,0.0025619,36.14
2,51,1952,2003,0.0023896,0.0027661,35.23
2,52,1952,2004,0.0026115,0.0029861,34.33
2,53,1952,2005,0.0028474,0.0032103,33.43
2,54,1952,2006,0.0031082,0.0034485,32.54
2,55,1952,2007,0.0034035,0.0037189,31.65
2,56,1952,2008,0.0037277,0.0040157,30.76
2,57,1952,2009,0.0040692,0.0043206,29.89
2,58,1952,2010,0.0044295,0.0046282,29.01
2,59,1952,2011,0.0048296,0.0049621,28.15
2,60,1952,2012,0.0052973,0.0053552,27.28
2,61,1952,2013,0.0058480,0.0058189,26.43
2,62,1952,2014,0.0064757,0.0063326,25.58
2,63,1952,2015,0.0071641,0.0068755,24.74
2,64,1952,2016,0.0078986,0.0074413,23.91
2,65,1952,2017,0.0086645,0.0080216,23.08
2,66,1952,2018,0.0094558,0.0086105,22.27
2,67,1952,2019,0.0103010,0.0092210,21.46
2,68,1952,2020,0.0112531,0.0098918,20.65
2,69,1952,2021,0.0123584,0.0106709,19.85
2,70,1952,2022,0.0136702,0.0116216,19.06
2,71,1952,2023,0.0152518,0.0128162,18.28
2,72,1952,2024,0.0170987,0.0142317,17.51
2,73,1952,2025,0.0190837,0.0157168,16.76
2,74,1952,2026,0.0210750,0.0171486,16.01
2,75,1952,2027,0.0231062,0.0185780,15.29
2,76,1952,2028,0.0253497,0.0201878,14.57
2,77,1952,2029,0.0279666,0.0221176,13.86
2,78,1952,2030,0.0310443,0.0244339,13.16
2,79,1952,2031,0.0345982,0.0271608,12.47
2,80,1952,2032,0.0395295,0.0313464,11.81
2,81,1952,2033,0.0438328,0.0347110,11.17
2,82,1952,2034,0.0485928,0.0384412,10.56
2,83,1952,2035,0.0538556,0.0425470,9.96
2,84,1952,2036,0.0596709,0.0470907,9.38
2,85,1952,2037,0.0660929,0.0521773,8.82
2,86,1952,2038,0.0731799,0.0578883,8.28
2,87,1952,2039,0.0809950,0.0642331,7.76
2,88,1952,2040,0.0896059,0.0712298,7.25
2,89,1952,2041,0.0990850,0.0789729,6.77
2,90,1952,2042,0.1095094,0.0876164,6.31
2,91,1952,2043,0.1209607,0.0972818,5.87
2,92,1952,2044,0.1335249,0.1080110,5.45
2,93,1952,2045,0.1472918,0.1198663,5.04
2,94,1952,2046,0.1623547,0.1330081,4.66
2,95,1952,2047,0.1788093,0.1476360,4.30
2,96,1952,2048,0.1967531,0.1639027,3.96
2,97,1952,2049,0.2162837,0.1818750,3.64
2,98,1952,2050,0.2374976,0.2016542,3.34
2,99,1952,2051,0.2604884,0.2234538,3.05
2,100,1952,2052,0.2853445,0.2475150,2.79
2,101,1952,2053,0.3121468,0.2740076,2.54
2,102,1952,2054,0.3409660,0.3029990,2.31
2,103,1952,2055,0.3718598,0.3345916,2.10
2,104,1952,2056,0.4048696,0.3689829,1.90
2,105,1952,2057,0.4400178,0.4063588,1.72
2,106,1952,2058,0.4773042,0.4468015,1.55
2,107,1952,2059,0.5167037,0.4902830,1.39
2,108,1952,2060,0.5581634,0.5367835,1.25
2,109,1952,2061,0.6016004,0.5863047,1.12
2,110,1952,2062,0.6469012,0.6387659,1.01
2,111,1952,2063,0.6939204,0.6939664,0.90
2,112,1952,2064,0.7424819,0.7516444,0.80
2,113,1952,2065,0.7923800,0.8115255,0.71
2,114,1952,2066,0.8433824,0.8732504,0.63
2,115,1952,2067,1.0000000,1.0000000,0.50
2,47,1953,2000,0.0017152,0.0020876,39.01
2,48,1953,2001,0.0018531,0.0022119,38.09
2,49,1953,2002,0.0020059,0.0023528,37.17
2,50,1953,2003,0.0021845,0.0025260,36.26
2,51,1953,2004,0.0023896,0.0027287,35.35
2,52,1953,2005,0.0026115,0.0029427,34.45
2,53,1953,2006,0.0028474,0.0031622,33.55
2,54,1953,2007,0.0031082,0.0034000,32.65
2,55,1953,2008,0.0034035,0.0036688,31.76
2,56,1953,2009,0.0037277,0.0039572,30.88
2,57,1953,2010,0.0040692,0.0042504,30.00
2,58,1953,2011,0.0044295,0.0045507,29.12
2,59,1953,2012,0.0048296,0.0048826,28.25
2,60,1953,2013,0.0052973,0.0052707,27.39
2,61,1953,2014,0.0058480,0.0057168,26.53
2,62,1953,2015,0.0064757,0.0062098,25.68
2,63,1953,2016,0.0071641,0.0067416,24.84
2,64,1953,2017,0.0078986,0.0073072,24.01
2,65,1953,2018,0.0086645,0.0078888,23.18
2,66,1953,2019,0.0094558,0.0084645,22.36
2,67,1953,2020,0.0103010,0.0090507,21.55
2,68,1953,2021,0.0112531,0.0097054,20.74
2,69,1953,2022,0.0123584,0.0104829,19.94
2,70,1953,2023,0.0136702,0.0114342,19.14
2,71,1953,2024,0.0152518,0.0126097,18.36
2,72,1953,2025,0.0170987,0.0139907,17.59
2,73,1953,2026,0.0190837,0.0154530,16.83
2,74,1953,2027,0.0210750,0.0168836,16.08
2,75,1953,2028,0.0231062,0.0183161,15.35
2,76,1953,2029,0.0253497,0.0199018,14.63
2,77,1953,2030,0.0279666,0.0217867,13.92
2,78,1953,2031,0.0310443,0.0240748,13.21
2,79,1953,2032,0.0345982,0.0268026,12.53
2,80,1953,2033,0.0395295,0.0309990,11.86
2,81,1953,2034,0.0438328,0.0343339,11.22
2,82,1953,2035,0.0485928,0.0380053,10.60
2,83,1953,2036,0.0538556,0.0420730,10.00
2,84,1953,2037,0.0596709,0.0466162,9.42
2,85,1953,2038,0.0660929,0.0517104,8.86
2,86,1953,2039,0.0731799,0.0573807,8.31
2,87,1953,2040,0.0809950,0.0636480,7.79
2,88,1953,2041,0.0896059,0.0705968,7.28
2,89,1953,2042,0.0990850,0.0783434,6.80
2,90,1953,2043,0.1095094,0.0870033,6.33
2,91,1953,2044,0.1209607,0.0966237,5.89
2,92,1953,2045,0.1335249,0.1072606,5.47
2,93,1953,2046,0.1472918,0.1190634,5.06
2,94,1953,2047,0.1623547,0.1322201,4.68
2,95,1953,2048,0.1788093,0.1468756,4.32
2,96,1953,2049,0.1967531,0.1630928,3.97
2,97,1953,2050,0.2162837,0.1809682,3.65
2,98,1953,2051,0.2374976,0.2007085,3.35
2,99,1953,2052,0.2604884,0.2225524,3.06
2,100,1953,2053,0.2853445,0.2466730,2.79
2,101,1953,2054,0.3121468,0.2731436,2.55
2,102,1953,2055,0.3409660,0.3020751,2.31
2,103,1953,2056,0.3718598,0.3336802,2.10
2,104,1953,2057,0.4048696,0.3681716,1.90
2,105,1953,2058,0.4400178,0.4056659,1.72
2,106,1953,2059,0.4773042,0.4461677,1.55
2,107,1953,2060,0.5167037,0.4896943,1.39
2,108,1953,2061,0.5581634,0.5363039,1.25
2,109,1953,2062,0.6016004,0.5859870,1.12
2,110,1953,2063,0.6469012,0.6386115,1.01
2,111,1953,2064,0.6939204,0.6939673,0.90
2,112,1953,2065,0.7424819,0.7518335,0.80
2,113,1953,2066,0.7923800,0.8119226,0.71
2,114,1953,2067,0.8433824,0.8738219,0.63
2,115,1953,2068,1.0000000,1.0000000,0.50
2,46,1954,2000,0.0015840,0.0019353,40.06
2,47,1954,2001,0.0017152,0.0020518,39.13
2,48,1954,2002,0.0018531,0.0021769,38.21
2,49,1954,2003,0.0020059,0.0023199,37.29
2,50,1954,2004,0.0021845,0.0024921,36.38
2,51,1954,2005,0.0023896,0.0026894,35.47
2,52,1954,2006,0.0026115,0.0028989,34.56
2,53,1954,2007,0.0028474,0.0031173,33.66
2,54,1954,2008,0.0031082,0.0033537,32.77
2,55,1954,2009,0.0034035,0.0036149,31.88
2,56,1954,2010,0.0037277,0.0038931,30.99
2,57,1954,2011,0.0040692,0.0041797,30.11
2,58,1954,2012,0.0044295,0.0044780,29.23
2,59,1954,2013,0.0048296,0.0048052,28.36
2,60,1954,2014,0.0052973,0.0051772,27.50
2,61,1954,2015,0.0058480,0.0056043,26.64
2,62,1954,2016,0.0064757,0.0060866,25.78
2,63,1954,2017,0.0071641,0.0066178,24.94
2,64,1954,2018,0.0078986,0.0071851,24.10
2,65,1954,2019,0.0086645,0.0077549,23.27
2,66,1954,2020,0.0094558,0.0083083,22.45
2,67,1954,2021,0.0103010,0.0088796,21.63
2,68,1954,2022,0.0112531,0.0095331,20.82
2,69,1954,2023,0.0123584,0.0103116,20.02
2,70,1954,2024,0.0136702,0.0112452,19.22
2,71,1954,2025,0.0152518,0.0123885,18.44
2,72,1954,2026,0.0170987,0.0137482,17.66
2,73,1954,2027,0.0190837,0.0152086,16.90
2,74,1954,2028,0.0210750,0.0166417,16.15
2,75,1954,2029,0.0231062,0.0180514,15.42
2,76,1954,2030,0.0253497,0.0195949,14.69
2,77,1954,2031,0.0279666,0.0214529,13.98
2,78,1954,2032,0.0310443,0.0237415,13.27
2,79,1954,2033,0.0345982,0.0264759,12.58
2,80,1954,2034,0.0395295,0.0306482,11.91
2,81,1954,2035,0.0438328,0.0339283,11.27
2,82,1954,2036,0.0485928,0.0375639,10.65
2,83,1954,2037,0.0538556,0.0416312,10.05
2,84,1954,2038,0.0596709,0.0461808,9.46
2,85,1954,2039,0.0660929,0.0512360,8.89
2,86,1954,2040,0.0731799,0.0568328,8.35
2,87,1954,2041,0.0809950,0.0630543,7.82
2,88,1954,2042,0.0896059,0.0700057,7.31
2,89,1954,2043,0.0990850,0.0777664,6.83
2,90,1954,2044,0.1095094,0.0863821,6.36
2,91,1954,2045,0.1209607,0.0959129,5.91
2,92,1954,2046,0.1335249,0.1064973,5.49
2,93,1954,2047,0.1472918,0.1183112,5.08
2,94,1954,2048,0.1623547,0.1314907,4.70
2,95,1954,2049,0.1788093,0.1460944,4.33
2,96,1954,2050,0.1967531,0.1622127,3.99
2,97,1954,2051,0.2162837,0.1800439,3.66
2,98,1954,2052,0.2374976,0.1998204,3.36
2,99,1954,2053,0.2604884,0.2217149,3.07
2,100,1954,2054,0.2853445,0.2458040,2.80
2,101,1954,2055,0.3121468,0.2722021,2.55
2,102,1954,2056,0.3409660,0.3011315,2.32
2,103,1954,2057,0.3718598,0.3328236,2.10
2,104,1954,2058,0.4048696,0.3674217,1.90
2,105,1954,2059,0.4400178,0.4049571,1.72
2,106,1954,2060,0.4773042,0.4454784,1.55
2,107,1954,2061,0.5167037,0.4890921,1.40
2,108,1954,2062,0.5581634,0.5358523,1.25
2,109,1954,2063,0.6016004,0.5856919,1.12
2,110,1954,2064,0.6469012,0.6384526,1.01
2,111,1954,2065,0.6939204,0.6939684,0.90
2,112,1954,2066,0.7424819,0.7520272,0.80
2,113,1954,2067,0.7923800,0.8122965,0.71
2,114,1954,2068,0.8433824,0.8743505,0.63
2,115,1954,2069,1.0000000,1.0000000,0.50
2,45,1955,2000,0.0014588,0.0017950,41.11
2,46,1955,2001,0.0015840,0.0019015,40.18
2,47,1955,2002,0.0017152,0.0020189,39.25
2,48,1955,2003,0.0018531,0.0021461,38.33
2,49,1955,2004,0.0020059,0.0022886,37.41
2,50,1955,2005,0.0021845,0.0024565,36.50
2,51,1955,2006,0.0023896,0.0026497,35.59
2,52,1955,2007,0.0026115,0.0028579,34.68
2,53,1955,2008,0.0028474,0.0030744,33.78
2,54,1955,2009,0.0031082,0.0033038,32.88
2,55,1955,2010,0.0034035,0.0035559,31.99
2,56,1955,2011,0.0037277,0.0038286,31.10
2,57,1955,2012,0.0040692,0.0041134,30.22
2,58,1955,2013,0.0044295,0.0044072,29.34
2,59,1955,2014,0.0048296,0.0047195,28.47
2,60,1955,2015,0.0052973,0.0050742,27.60
2,61,1955,2016,0.0058480,0.0054914,26.74
2,62,1955,2017,0.0064757,0.0059727,25.88
2,63,1955,2018,0.0071641,0.0065052,25.04
2,64,1955,2019,0.0078986,0.0070620,24.20
2,65,1955,2020,0.0086645,0.0076115,23.37
2,66,1955,2021,0.0094558,0.0081513,22.54
2,67,1955,2022,0.0103010,0.0087214,21.72
2,68,1955,2023,0.0112531,0.0093761,20.91
2,69,1955,2024,0.0123584,0.0101387,20.10
2,70,1955,2025,0.0136702,0.0110427,19.30
2,71,1955,2026,0.0152518,0.0121660,18.51
2,72,1955,2027,0.0170987,0.0135235,17.74
2,73,1955,2028,0.0190837,0.0149857,16.97
2,74,1955,2029,0.0210750,0.0163973,16.22
2,75,1955,2030,0.0231062,0.0177675,15.48
2,76,1955,2031,0.0253497,0.0192855,14.76
2,77,1955,2032,0.0279666,0.0211433,14.04
2,78,1955,2033,0.0310443,0.0234376,13.33
2,79,1955,2034,0.0345982,0.0261464,12.64
2,80,1955,2035,0.0395295,0.0302711,11.96
2,81,1955,2036,0.0438328,0.0335179,11.32
2,82,1955,2037,0.0485928,0.0371528,10.69
2,83,1955,2038,0.0538556,0.0412258,10.09
2,84,1955,2039,0.0596709,0.0457385,9.50
2,85,1955,2040,0.0660929,0.0507240,8.93
2,86,1955,2041,0.0731799,0.0562770,8.38
2,87,1955,2042,0.0809950,0.0625002,7.85
2,88,1955,2043,0.0896059,0.0694641,7.34
2,89,1955,2044,0.0990850,0.0771821,6.85
2,90,1955,2045,0.1095094,0.0857115,6.38
2,91,1955,2046,0.1209607,0.0951903,5.94
2,92,1955,2047,0.1335249,0.1057825,5.51
2,93,1955,2048,0.1472918,0.1176150,5.10
2,94,1955,2049,0.1623547,0.1307416,4.71
2,95,1955,2050,0.1788093,0.1452459,4.35
2,96,1955,2051,0.1967531,0.1613161,4.00
2,97,1955,2052,0.2162837,0.1791762,3.67
2,98,1955,2053,0.2374976,0.1989954,3.37
2,99,1955,2054,0.2604884,0.2208508,3.08
2,100,1955,2055,0.2853445,0.2448573,2.81
2,101,1955,2056,0.3121468,0.2712409,2.56
2,102,1955,2057,0.3409660,0.3002449,2.33
2,103,1955,2058,0.3718598,0.3320321,2.11
2,104,1955,2059,0.4048696,0.3666548,1.91
2,105,1955,2060,0.4400178,0.4041865,1.72
2,106,1955,2061,0.4773042,0.4447734,1.55
2,107,1955,2062,0.5167037,0.4885249,1.40
2,108,1955,2063,0.5581634,0.5354329,1.25
2,109,1955,2064,0.6016004,0.5853883,1.12
2,110,1955,2065,0.6469012,0.6382793,1.01
2,111,1955,2066,0.6939204,0.6939693,0.90
2,112,1955,2067,0.7424819,0.7522095,0.80
2,113,1955,2068,0.7923800,0.8126423,0.71
2,114,1955,2069,0.8433824,0.8748910,0.63
2,115,1955,2070,1.0000000,1.0000000,0.50
2,44,1956,2000,0.0013435,0.0016665,42.16
2,45,1956,2001,0.0014588,0.0017626,41.23
2,46,1956,2002,0.0015840,0.0018704,40.30
2,47,1956,2003,0.0017152,0.0019900,39.38
2,48,1956,2004,0.0018531,0.0021170,38.45
2,49,1956,2005,0.0020059,0.0022559,37.53
2,50,1956,2006,0.0021845,0.0024205,36.62
2,51,1956,2007,0.0023896,0.0026127,35.70
2,52,1956,2008,0.0026115,0.0028188,34.80
2,53,1956,2009,0.0028474,0.0030283,33.89
2,54,1956,2010,0.0031082,0.0032492,33.00
2,55,1956,2011,0.0034035,0.0034964,32.10
2,56,1956,2012,0.0037277,0.0037681,31.21
2,57,1956,2013,0.0040692,0.0040489,30.33
2,58,1956,2014,0.0044295,0.0043288,29.45
2,59,1956,2015,0.0048296,0.0046251,28.58
2,60,1956,2016,0.0052973,0.0049708,27.71
2,61,1956,2017,0.0058480,0.0053871,26.84
2,62,1956,2018,0.0064757,0.0058690,25.98
2,63,1956,2019,0.0071641,0.0063915,25.13
2,64,1956,2020,0.0078986,0.0069302,24.29
2,65,1956,2021,0.0086645,0.0074674,23.46
2,66,1956,2022,0.0094558,0.0080061,22.63
2,67,1956,2023,0.0103010,0.0085773,21.81
2,68,1956,2024,0.0112531,0.0092177,20.99
2,69,1956,2025,0.0123584,0.0099537,20.19
2,70,1956,2026,0.0136702,0.0108392,19.38
2,71,1956,2027,0.0152518,0.0119601,18.59
2,72,1956,2028,0.0170987,0.0133187,17.81
2,73,1956,2029,0.0190837,0.0147604,17.04
2,74,1956,2030,0.0210750,0.0161351,16.29
2,75,1956,2031,0.0231062,0.0174813,15.55
2,76,1956,2032,0.0253497,0.0189986,14.82
2,77,1956,2033,0.0279666,0.0208612,14.09
2,78,1956,2034,0.0310443,0.0231314,13.38
2,79,1956,2035,0.0345982,0.0257926,12.69
2,80,1956,2036,0.0395295,0.0298898,12.01
2,81,1956,2037,0.0438328,0.0331357,11.37
2,82,1956,2038,0.0485928,0.0367759,10.74
2,83,1956,2039,0.0538556,0.0408143,10.13
2,84,1956,2040,0.0596709,0.0452615,9.54
2,85,1956,2041,0.0660929,0.0502049,8.97
2,86,1956,2042,0.0731799,0.0557585,8.42
2,87,1956,2043,0.0809950,0.0619927,7.88
2,88,1956,2044,0.0896059,0.0689158,7.37
2,89,1956,2045,0.0990850,0.0765514,6.88
2,90,1956,2046,0.1095094,0.0850300,6.41
2,91,1956,2047,0.1209607,0.0945139,5.96
2,92,1956,2048,0.1335249,0.1051212,5.53
2,93,1956,2049,0.1472918,0.1169004,5.12
2,94,1956,2050,0.1623547,0.1299283,4.73
2,95,1956,2051,0.1788093,0.1443818,4.36
2,96,1956,2052,0.1967531,0.1604747,4.01
2,97,1956,2053,0.2162837,0.1783706,3.69
2,98,1956,2054,0.2374976,0.1981447,3.38
2,99,1956,2055,0.2604884,0.2199099,3.09
2,100,1956,2056,0.2853445,0.2438913,2.82
2,101,1956,2057,0.3121468,0.2703381,2.57
2,102,1956,2058,0.3409660,0.2994260,2.33
2,103,1956,2059,0.3718598,0.3312230,2.11
2,104,1956,2060,0.4048696,0.3658212,1.91
2,105,1956,2061,0.4400178,0.4033985,1.73
2,106,1956,2062,0.4773042,0.4441098,1.56
2,107,1956,2063,0.5167037,0.4879985,1.40
2,108,1956,2064,0.5581634,0.5350014,1.26
2,109,1956,2065,0.6016004,0.5850573,1.12
2,110,1956,2066,0.6469012,0.6381019,1.01
2,111,1956,2067,0.6939204,0.6939702,0.90
2,112,1956,2068,0.7424819,0.7523782,0.80
2,113,1956,2069,0.7923800,0.8129959,0.71
2,114,1956,2070,0.8433824,0.8754792,0.62
2,115,1956,2071,1.0000000,1.0000000,0.50
2,43,1957,2000,0.0012427,0.0015546,43.22
2,44,1957,2001,0.0013435,0.0016352,42.28
2,45,1957,2002,0.0014588,0.0017327,41.35
2,46,1957,2003,0.0015840,0.0018431,40.42
2,47,1957,2004,0.0017152,0.0019627,39.50
2,48,1957,2005,0.0018531,0.0020864,38.57
2,49,1957,2006,0.0020059,0.0022228,37.65
2,50,1957,2007,0.0021845,0.0023869,36.73
2,51,1957,2008,0.0023896,0.0025772,35.82
2,52,1957,2009,0.0026115,0.0027766,34.91
2,53,1957,2010,0.0028474,0.0029777,34.01
2,54,1957,2011,0.0031082,0.0031942,33.11
2,55,1957,2012,0.0034035,0.0034407,32.21
2,56,1957,2013,0.0037277,0.0037091,31.32
2,57,1957,2014,0.0040692,0.0039775,30.44
2,58,1957,2015,0.0044295,0.0042425,29.56
2,59,1957,2016,0.0048296,0.0045304,28.68
2,60,1957,2017,0.0052973,0.0048753,27.81
2,61,1957,2018,0.0058480,0.0052922,26.94
2,62,1957,2019,0.0064757,0.0057645,26.08
2,63,1957,2020,0.0071641,0.0062700,25.23
2,64,1957,2021,0.0078986,0.0067978,24.39
2,65,1957,2022,0.0086645,0.0073342,23.55
2,66,1957,2023,0.0094558,0.0078738,22.72
2,67,1957,2024,0.0103010,0.0084319,21.90
2,68,1957,2025,0.0112531,0.0090482,21.08
2,69,1957,2026,0.0123584,0.0097677,20.27
2,70,1957,2027,0.0136702,0.0106509,19.46
2,71,1957,2028,0.0152518,0.0117723,18.67
2,72,1957,2029,0.0170987,0.0131119,17.88
2,73,1957,2030,0.0190837,0.0145189,17.11
2,74,1957,2031,0.0210750,0.0158710,16.36
2,75,1957,2032,0.0231062,0.0172160,15.62
2,76,1957,2033,0.0253497,0.0187373,14.88
2,77,1957,2034,0.0279666,0.0205770,14.15
2,78,1957,2035,0.0310443,0.0228027,13.44
2,79,1957,2036,0.0345982,0.0254352,12.74
2,80,1957,2037,0.0395295,0.0295349,12.06
2,81,1957,2038,0.0438328,0.0327854,11.41
2,82,1957,2039,0.0485928,0.0363933,10.78
2,83,1957,2040,0.0538556,0.0403706,10.17
2,84,1957,2041,0.0596709,0.0447780,9.58
2,85,1957,2042,0.0660929,0.0497210,9.01
2,86,1957,2043,0.0731799,0.0552839,8.45
2,87,1957,2044,0.0809950,0.0614792,7.92
2,88,1957,2045,0.0896059,0.0683244,7.40
2,89,1957,2046,0.0990850,0.0759108,6.91
2,90,1957,2047,0.1095094,0.0843922,6.43
2,91,1957,2048,0.1209607,0.0938884,5.98
2,92,1957,2049,0.1335249,0.1044427,5.55
2,93,1957,2050,0.1472918,0.1161249,5.14
2,94,1957,2051,0.1623547,0.1291004,4.75
2,95,1957,2052,0.1788093,0.1435713,4.38
2,96,1957,2053,0.1967531,0.1596938,4.03
2,97,1957,2054,0.2162837,0.1775401,3.70
2,98,1957,2055,0.2374976,0.1972187,3.39
2,99,1957,2056,0.2604884,0.2189502,3.10
2,100,1957,2057,0.2853445,0.2429844,2.83
2,101,1957,2058,0.3121468,0.2695045,2.57
2,102,1957,2059,0.3409660,0.2985892,2.34
2,103,1957,2060,0.3718598,0.3303438,2.12
2,104,1957,2061,0.4048696,0.3649692,1.92
2,105,1957,2062,0.4400178,0.4026569,1.73
2,106,1957,2063,0.4773042,0.4434939,1.56
2,107,1957,2064,0.5167037,0.4874570,1.40
2,108,1957,2065,0.5581634,0.5345311,1.26
2,109,1957,2066,0.6016004,0.5847184,1.13
2,110,1957,2067,0.6469012,0.6379348,1.01
2,111,1957,2068,0.6939204,0.6939711,0.90
2,112,1957,2069,0.7424819,0.7525506,0.80
2,113,1957,2070,0.7923800,0.8133806,0.71
2,114,1957,2071,0.8433824,0.8760815,0.62
2,115,1957,2072,1.0000000,1.0000000,0.50
2,42,1958,2000,0.0011559,0.0014539,44.28
2,43,1958,2001,0.0012427,0.0015243,43.34
2,44,1958,2002,0.0013435,0.0016065,42.41
2,45,1958,2003,0.0014588,0.0017066,41.47
2,46,1958,2004,0.0015840,0.0018173,40.54
2,47,1958,2005,0.0017152,0.0019339,39.62
2,48,1958,2006,0.0018531,0.0020555,38.69
2,49,1958,2007,0.0020059,0.0021919,37.77
2,50,1958,2008,0.0021845,0.0023547,36.85
2,51,1958,2009,0.0023896,0.0025391,35.94
2,52,1958,2010,0.0026115,0.0027305,35.03
2,53,1958,2011,0.0028474,0.0029269,34.12
2,54,1958,2012,0.0031082,0.0031426,33.22
2,55,1958,2013,0.0034035,0.0033864,32.33
2,56,1958,2014,0.0037277,0.0036439,31.43
2,57,1958,2015,0.0040692,0.0038987,30.55
2,58,1958,2016,0.0044295,0.0041559,29.66
2,59,1958,2017,0.0048296,0.0044429,28.79
2,60,1958,2018,0.0052973,0.0047885,27.91
2,61,1958,2019,0.0058480,0.0051965,27.04
2,62,1958,2020,0.0064757,0.0056528,26.18
2,63,1958,2021,0.0071641,0.0061480,25.33
2,64,1958,2022,0.0078986,0.0066754,24.48
2,65,1958,2023,0.0086645,0.0072129,23.64
2,66,1958,2024,0.0094558,0.0077404,22.81
2,67,1958,2025,0.0103010,0.0082763,21.99
2,68,1958,2026,0.0112531,0.0088779,21.16
2,69,1958,2027,0.0123584,0.0095957,20.35
2,70,1958,2028,0.0136702,0.0104793,19.54
2,71,1958,2029,0.0152518,0.0115830,18.74
2,72,1958,2030,0.0170987,0.0128902,17.96
2,73,1958,2031,0.0190837,0.0142757,17.19
2,74,1958,2032,0.0210750,0.0156262,16.43
2,75,1958,2033,0.0231062,0.0169745,15.68
2,76,1958,2034,0.0253497,0.0184742,14.94
2,77,1958,2035,0.0279666,0.0202723,14.21
2,78,1958,2036,0.0310443,0.0224710,13.50
2,79,1958,2037,0.0345982,0.0251031,12.80
2,80,1958,2038,0.0395295,0.0292097,12.11
2,81,1958,2039,0.0438328,0.0324301,11.46
2,82,1958,2040,0.0485928,0.0359809,10.83
2,83,1958,2041,0.0538556,0.0399212,10.22
2,84,1958,2042,0.0596709,0.0443275,9.62
2,85,1958,2043,0.0660929,0.0492781,9.04
2,86,1958,2044,0.0731799,0.0548037,8.49
2,87,1958,2045,0.0809950,0.0609254,7.95
2,88,1958,2046,0.0896059,0.0677239,7.43
2,89,1958,2047,0.0990850,0.0753116,6.94
2,90,1958,2048,0.1095094,0.0838028,6.46
2,91,1958,2049,0.1209607,0.0932468,6.00
2,92,1958,2050,0.1335249,0.1037066,5.57
2,93,1958,2051,0.1472918,0.1153358,5.16
2,94,1958,2052,0.1623547,0.1283241,4.76
2,95,1958,2053,0.1788093,0.1428193,4.39
2,96,1958,2054,0.1967531,0.1588892,4.04
2,97,1958,2055,0.2162837,0.1766365,3.71
2,98,1958,2056,0.2374976,0.1962745,3.40
2,99,1958,2057,0.2604884,0.2180495,3.11
2,100,1958,2058,0.2853445,0.2421473,2.83
2,101,1958,2059,0.3121468,0.2686530,2.58
2,102,1958,2060,0.3409660,0.2976802,2.34
2,103,1958,2061,0.3718598,0.3294455,2.12
2,104,1958,2062,0.4048696,0.3641677,1.92
2,105,1958,2063,0.4400178,0.4019690,1.73
2,106,1958,2064,0.4773042,0.4428605,1.56
2,107,1958,2065,0.5167037,0.4868668,1.40
2,108,1958,2066,0.5581634,0.5340497,1.26
2,109,1958,2067,0.6016004,0.5843994,1.13
2,110,1958,2068,0.6469012,0.6377803,1.01
2,111,1958,2069,0.6939204,0.6939720,0.90
2,112,1958,2070,0.7424819,0.7527382,0.80
2,113,1958,2071,0.7923800,0.8137746,0.71
2,114,1958,2072,0.8433824,0.8766489,0.62
2,115,1958,2073,1.0000000,1.0000000,0.50
2,41,1959,2000,0.0010784,0.0013618,45.34
2,42,1959,2001,0.0011559,0.0014248,44.40
2,43,1959,2002,0.0012427,0.0014965,43.46
2,44,1959,2003,0.0013435,0.0015813,42.53
2,45,1959,2004,0.0014588,0.0016818,41.60
2,46,1959,2005,0.0015840,0.0017902,40.66
2,47,1959,2006,0.0017152,0.0019050,39.74
2,48,1959,2007,0.0018531,0.0020267,38.81
2,49,1959,2008,0.0020059,0.0021624,37.89
2,50,1959,2009,0.0021845,0.0023201,36.97
2,51,1959,2010,0.0023896,0.0024973,36.06
2,52,1959,2011,0.0026115,0.0026841,35.14
2,53,1959,2012,0.0028474,0.0028792,34.24
2,54,1959,2013,0.0031082,0.0030924,33.33
2,55,1959,2014,0.0034035,0.0033263,32.44
2,56,1959,2015,0.0037277,0.0035720,31.54
2,57,1959,2016,0.0040692,0.0038197,30.65
2,58,1959,2017,0.0044295,0.0040759,29.77
2,59,1959,2018,0.0048296,0.0043634,28.89
2,60,1959,2019,0.0052973,0.0047010,28.01
2,61,1959,2020,0.0058480,0.0050943,27.14
2,62,1959,2021,0.0064757,0.0055406,26.28
2,63,1959,2022,0.0071641,0.0060351,25.42
2,64,1959,2023,0.0078986,0.0065639,24.58
2,65,1959,2024,0.0086645,0.0070904,23.73
2,66,1959,2025,0.0094558,0.0075976,22.90
2,67,1959,2026,0.0103010,0.0081200,22.07
2,68,1959,2027,0.0112531,0.0087204,21.25
2,69,1959,2028,0.0123584,0.0094391,20.43
2,70,1959,2029,0.0136702,0.0103063,19.62
2,71,1959,2030,0.0152518,0.0113801,18.82
2,72,1959,2031,0.0170987,0.0126672,18.03
2,73,1959,2032,0.0190837,0.0140505,17.26
2,74,1959,2033,0.0210750,0.0154034,16.50
2,75,1959,2034,0.0231062,0.0167313,15.75
2,76,1959,2035,0.0253497,0.0181921,15.00
2,77,1959,2036,0.0279666,0.0199649,14.27
2,78,1959,2037,0.0310443,0.0221629,13.55
2,79,1959,2038,0.0345982,0.0247991,12.85
2,80,1959,2039,0.0395295,0.0288801,12.16
2,81,1959,2040,0.0438328,0.0320473,11.51
2,82,1959,2041,0.0485928,0.0355635,10.88
2,83,1959,2042,0.0538556,0.0395025,10.26
2,84,1959,2043,0.0596709,0.0439154,9.66
2,85,1959,2044,0.0660929,0.0488303,9.08
2,86,1959,2045,0.0731799,0.0542862,8.52
2,87,1959,2046,0.0809950,0.0603634,7.98
2,88,1959,2047,0.0896059,0.0671624,7.46
2,89,1959,2048,0.0990850,0.0747581,6.96
2,90,1959,2049,0.1095094,0.0831984,6.48
2,91,1959,2050,0.1209607,0.0925511,6.03
2,92,1959,2051,0.1335249,0.1029580,5.59
2,93,1959,2052,0.1472918,0.1145963,5.18
2,94,1959,2053,0.1623547,0.1276043,4.78
2,95,1959,2054,0.1788093,0.1420448,4.41
2,96,1959,2055,0.1967531,0.1580140,4.05
2,97,1959,2056,0.2162837,0.1757156,3.72
2,98,1959,2057,0.2374976,0.1953889,3.41
2,99,1959,2058,0.2604884,0.2172185,3.11
2,100,1959,2059,0.2853445,0.2412925,2.84
2,101,1959,2060,0.3121468,0.2677284,2.58
2,102,1959,2061,0.3409660,0.2967518,2.35
2,103,1959,2062,0.3718598,0.3286007,2.13
2,104,1959,2063,0.4048696,0.3634243,1.92
2,105,1959,2064,0.4400178,0.4012617,1.73
2,106,1959,2065,0.4773042,0.4421705,1.56
2,107,1959,2066,0.5167037,0.4862631,1.40
2,108,1959,2067,0.5581634,0.5335966,1.26
2,109,1959,2068,0.6016004,0.5841045,1.13
2,110,1959,2069,0.6469012,0.6376225,1.01
2,111,1959,2070,0.6939204,0.6939729,0.90
2,112,1959,2071,0.7424819,0.7529304,0.80
2,113,1959,2072,0.7923800,0.8141457,0.71
2,114,1959,2073,0.8433824,0.8771744,0.62
2,115,1959,2074,1.0000000,1.0000000,0.50
2,40,1960,2000,0.0010090,0.0012804,46.41
2,41,1960,2001,0.0010784,0.0013342,45.47
2,42,1960,2002,0.0011559,0.0013982,44.53
2,43,1960,2003,0.0012427,0.0014721,43.59
2,44,1960,2004,0.0013435,0.0015575,42.65
2,45,1960,2005,0.0014588,0.0016559,41.72
2,46,1960,2006,0.0015840,0.0017629,40.79
2,47,1960,2007,0.0017152,0.0018779,39.86
2,48,1960,2008,0.0018531,0.0019991,38.93
2,49,1960,2009,0.0020059,0.0021306,38.01
2,50,1960,2010,0.0021845,0.0022823,37.09
2,51,1960,2011,0.0023896,0.0024553,36.17
2,52,1960,2012,0.0026115,0.0026406,35.26
2,53,1960,2013,0.0028474,0.0028328,34.35
2,54,1960,2014,0.0031082,0.0030369,33.45
2,55,1960,2015,0.0034035,0.0032601,32.55
2,56,1960,2016,0.0037277,0.0034999,31.65
2,57,1960,2017,0.0040692,0.0037468,30.76
2,58,1960,2018,0.0044295,0.0040032,29.88
2,59,1960,2019,0.0048296,0.0042832,28.99
2,60,1960,2020,0.0052973,0.0046074,28.12
2,61,1960,2021,0.0058480,0.0049917,27.24
2,62,1960,2022,0.0064757,0.0054370,26.38
2,63,1960,2023,0.0071641,0.0059324,25.52
2,64,1960,2024,0.0078986,0.0064514,24.67
2,65,1960,2025,0.0086645,0.0069595,23.83
2,66,1960,2026,0.0094558,0.0074541,22.99
2,67,1960,2027,0.0103010,0.0079754,22.16
2,68,1960,2028,0.0112531,0.0085769,21.33
2,69,1960,2029,0.0123584,0.0092811,20.51
2,70,1960,2030,0.0136702,0.0101211,19.70
2,71,1960,2031,0.0152518,0.0111761,18.90
2,72,1960,2032,0.0170987,0.0124607,18.10
2,73,1960,2033,0.0190837,0.0138454,17.33
2,74,1960,2034,0.0210750,0.0151791,16.56
2,75,1960,2035,0.0231062,0.0164708,15.81
2,76,1960,2036,0.0253497,0.0179078,15.07
2,77,1960,2037,0.0279666,0.0196795,14.33
2,78,1960,2038,0.0310443,0.0218811,13.61
2,79,1960,2039,0.0345982,0.0244913,12.90
2,80,1960,2040,0.0395295,0.0285251,12.21
2,81,1960,2041,0.0438328,0.0316600,11.56
2,82,1960,2042,0.0485928,0.0351749,10.92
2,83,1960,2043,0.0538556,0.0391197,10.30
2,84,1960,2044,0.0596709,0.0434988,9.70
2,85,1960,2045,0.0660929,0.0483479,9.12
2,86,1960,2046,0.0731799,0.0537613,8.56
2,87,1960,2047,0.0809950,0.0598382,8.01
2,88,1960,2048,0.0896059,0.0666439,7.49
2,89,1960,2049,0.0990850,0.0741907,6.99
2,90,1960,2050,0.1095094,0.0825433,6.51
2,91,1960,2051,0.1209607,0.0918439,6.05
2,92,1960,2052,0.1335249,0.1022568,5.61
2,93,1960,2053,0.1472918,0.1139108,5.20
2,94,1960,2054,0.1623547,0.1268632,4.80
2,95,1960,2055,0.1788093,0.1412028,4.42
2,96,1960,2056,0.1967531,0.1571225,4.07
2,97,1960,2057,0.2162837,0.1748521,3.73
2,98,1960,2058,0.2374976,0.1945720,3.42
2,99,1960,2059,0.2604884,0.2163703,3.12
2,100,1960,2060,0.2853445,0.2403647,2.85
2,101,1960,2061,0.3121468,0.2667845,2.59
2,102,1960,2062,0.3409660,0.2958791,2.35
2,103,1960,2063,0.3718598,0.3278175,2.13
2,104,1960,2064,0.4048696,0.3626603,1.93
2,105,1960,2065,0.4400178,0.4004914,1.74
2,106,1960,2066,0.4773042,0.4414648,1.56
2,107,1960,2067,0.5167037,0.4856950,1.40
2,108,1960,2068,0.5581634,0.5331779,1.26
2,109,1960,2069,0.6016004,0.5838032,1.13
2,110,1960,2070,0.6469012,0.6374507,1.01
2,111,1960,2071,0.6939204,0.6939740,0.90
2,112,1960,2072,0.7424819,0.7531114,0.80
2,113,1960,2073,0.7923800,0.8144895,0.71
2,114,1960,2074,0.8433824,0.8777127,0.62
2,115,1960,2075,1.0000000,1.0000000,0.50
2,39,1961,2000,0.0009481,0.0012100,47.48
2,40,1961,2001,0.0010090,0.0012539,46.53
2,41,1961,2002,0.0010784,0.0013088,45.59
2,42,1961,2003,0.0011559,0.0013749,44.65
2,43,1961,2004,0.0012427,0.0014490,43.71
2,44,1961,2005,0.0013435,0.0015325,42.77
2,45,1961,2006,0.0014588,0.0016297,41.84
2,46,1961,2007,0.0015840,0.0017373,40.91
2,47,1961,2008,0.0017152,0.0018521,39.98
2,48,1961,2009,0.0018531,0.0019695,39.05
2,49,1961,2010,0.0020059,0.0020958,38.13
2,50,1961,2011,0.0021845,0.0022441,37.20
2,51,1961,2012,0.0023896,0.0024159,36.29
2,52,1961,2013,0.0026115,0.0025982,35.37
2,53,1961,2014,0.0028474,0.0027814,34.46
2,54,1961,2015,0.0031082,0.0029757,33.56
2,55,1961,2016,0.0034035,0.0031937,32.66
2,56,1961,2017,0.0037277,0.0034332,31.76
2,57,1961,2018,0.0040692,0.0036804,30.87
2,58,1961,2019,0.0044295,0.0039299,29.98
2,59,1961,2020,0.0048296,0.0041976,29.10
2,60,1961,2021,0.0052973,0.0045136,28.22
2,61,1961,2022,0.0058480,0.0048969,27.34
2,62,1961,2023,0.0064757,0.0053427,26.48
2,63,1961,2024,0.0071641,0.0058289,25.61
2,64,1961,2025,0.0078986,0.0063311,24.76
2,65,1961,2026,0.0086645,0.0068278,23.92
2,66,1961,2027,0.0094558,0.0073214,23.08
2,67,1961,2028,0.0103010,0.0078437,22.24
2,68,1961,2029,0.0112531,0.0084323,21.42
2,69,1961,2030,0.0123584,0.0091120,20.59
2,70,1961,2031,0.0136702,0.0099349,19.78
2,71,1961,2032,0.0152518,0.0109873,18.97
2,72,1961,2033,0.0170987,0.0122728,18.18
2,73,1961,2034,0.0190837,0.0136392,17.40
2,74,1961,2035,0.0210750,0.0149389,16.63
2,75,1961,2036,0.0231062,0.0162082,15.88
2,76,1961,2037,0.0253497,0.0176440,15.13
2,77,1961,2038,0.0279666,0.0194187,14.39
2,78,1961,2039,0.0310443,0.0215959,13.67
2,79,1961,2040,0.0345982,0.0241602,12.96
2,80,1961,2041,0.0395295,0.0281661,12.27
2,81,1961,2042,0.0438328,0.0312996,11.61
2,82,1961,2043,0.0485928,0.0348197,10.97
2,83,1961,2044,0.0538556,0.0387330,10.34
2,84,1961,2045,0.0596709,0.0430503,9.74
2,85,1961,2046,0.0660929,0.0478587,9.16
2,86,1961,2047,0.0731799,0.0532710,8.59
2,87,1961,2048,0.0809950,0.0593534,8.05
2,88,1961,2049,0.0896059,0.0661127,7.52
2,89,1961,2050,0.0990850,0.0735760,7.02
2,90,1961,2051,0.1095094,0.0818777,6.54
2,91,1961,2052,0.1209607,0.0911817,6.07
2,92,1961,2053,0.1335249,0.1016070,5.63
2,93,1961,2054,0.1472918,0.1132053,5.21
2,94,1961,2055,0.1623547,0.1260578,4.82
2,95,1961,2056,0.1788093,0.1403455,4.44
2,96,1961,2057,0.1967531,0.1562870,4.08
2,97,1961,2058,0.2162837,0.1740561,3.75
2,98,1961,2059,0.2374976,0.1937386,3.43
2,99,1961,2060,0.2604884,0.2154500,3.13
2,100,1961,2061,0.2853445,0.2394180,2.86
2,101,1961,2062,0.3121468,0.2658975,2.60
2,102,1961,2063,0.3409660,0.2950703,2.36
2,103,1961,2064,0.3718598,0.3270129,2.14
2,104,1961,2065,0.4048696,0.3618285,1.93
2,105,1961,2066,0.4400178,0.3997038,1.74
2,106,1961,2067,0.4773042,0.4408009,1.57
2,107,1961,2068,0.5167037,0.4851700,1.41
2,108,1961,2069,0.5581634,0.5327501,1.26
2,109,1961,2070,0.6016004,0.5834754,1.13
2,110,1961,2071,0.6469012,0.6372749,1.01
2,111,1961,2072,0.6939204,0.6939749,0.90
2,112,1961,2073,0.7424819,0.7532790,0.80
2,113,1961,2074,0.7923800,0.8148417,0.71
2,114,1961,2075,0.8433824,0.8782991,0.62
2,115,1961,2076,1.0000000,1.0000000,0.50
2,38,1962,2000,0.0008908,0.0011422,48.55
2,39,1962,2001,0.0009481,0.0011843,47.60
2,40,1962,2002,0.0010090,0.0012295,46.66
2,41,1962,2003,0.0010784,0.0012866,45.71
2,42,1962,2004,0.0011559,0.0013529,44.77
2,43,1962,2005,0.0012427,0.0014249,43.83
2,44,1962,2006,0.0013435,0.0015074,42.89
2,45,1962,2007,0.0014588,0.0016053,41.96
2,46,1962,2008,0.0015840,0.0017129,41.03
2,47,1962,2009,0.0017152,0.0018242,40.09
2,48,1962,2010,0.0018531,0.0019370,39.17
2,49,1962,2011,0.0020059,0.0020607,38.24
2,50,1962,2012,0.0021845,0.0022083,37.32
2,51,1962,2013,0.0023896,0.0023775,36.40
2,52,1962,2014,0.0026115,0.0025513,35.49
2,53,1962,2015,0.0028474,0.0027249,34.58
2,54,1962,2016,0.0031082,0.0029143,33.67
2,55,1962,2017,0.0034035,0.0031324,32.77
2,56,1962,2018,0.0037277,0.0033726,31.87
2,57,1962,2019,0.0040692,0.0036135,30.97
2,58,1962,2020,0.0044295,0.0038516,30.08
2,59,1962,2021,0.0048296,0.0041117,29.20
2,60,1962,2022,0.0052973,0.0044270,28.32
2,61,1962,2023,0.0058480,0.0048107,27.44
2,62,1962,2024,0.0064757,0.0052476,26.57
2,63,1962,2025,0.0071641,0.0057181,25.71
2,64,1962,2026,0.0078986,0.0062103,24.85
2,65,1962,2027,0.0086645,0.0067061,24.01
2,66,1962,2028,0.0094558,0.0072006,23.17
2,67,1962,2029,0.0103010,0.0077110,22.33
2,68,1962,2030,0.0112531,0.0082775,21.50
2,69,1962,2031,0.0123584,0.0089421,20.67
2,70,1962,2032,0.0136702,0.0097627,19.86
2,71,1962,2033,0.0152518,0.0108157,19.05
2,72,1962,2034,0.0170987,0.0120840,18.25
2,73,1962,2035,0.0190837,0.0134183,17.47
2,74,1962,2036,0.0210750,0.0146969,16.70
2,75,1962,2037,0.0231062,0.0159646,15.94
2,76,1962,2038,0.0253497,0.0174030,15.19
2,77,1962,2039,0.0279666,0.0191549,14.45
2,78,1962,2040,0.0310443,0.0212895,13.72
2,79,1962,2041,0.0345982,0.0238258,13.01
2,80,1962,2042,0.0395295,0.0278322,12.32
2,81,1962,2043,0.0438328,0.0309704,11.65
2,82,1962,2044,0.0485928,0.0344609,11.01
2,83,1962,2045,0.0538556,0.0383168,10.39
2,84,1962,2046,0.0596709,0.0425957,9.78
2,85,1962,2047,0.0660929,0.0474020,9.19
2,86,1962,2048,0.0731799,0.0528185,8.62
2,87,1962,2049,0.0809950,0.0588569,8.08
2,88,1962,2050,0.0896059,0.0655374,7.55
2,89,1962,2051,0.0990850,0.0729517,7.05
2,90,1962,2052,0.1095094,0.0812547,6.56
2,91,1962,2053,0.1209607,0.0905683,6.10
2,92,1962,2054,0.1335249,0.1009385,5.66
2,93,1962,2055,0.1472918,0.1124389,5.23
2,94,1962,2056,0.1623547,0.1252381,4.83
2,95,1962,2057,0.1788093,0.1395424,4.45
2,96,1962,2058,0.1967531,0.1555171,4.10
2,97,1962,2059,0.2162837,0.1732442,3.76
2,98,1962,2060,0.2374976,0.1928348,3.44
2,99,1962,2061,0.2604884,0.2145113,3.14
2,100,1962,2062,0.2853445,0.2385287,2.86
2,101,1962,2063,0.3121468,0.2650757,2.60
2,102,1962,2064,0.3409660,0.2942396,2.36
2,103,1962,2065,0.3718598,0.3261371,2.14
2,104,1962,2066,0.4048696,0.3609783,1.93
2,105,1962,2067,0.4400178,0.3989632,1.74
2,106,1962,2068,0.4773042,0.4401876,1.57
2,107,1962,2069,0.5167037,0.4846338,1.41
2,108,1962,2070,0.5581634,0.5322849,1.26
2,109,1962,2071,0.6016004,0.5831398,1.13
2,110,1962,2072,0.6469012,0.6371092,1.01
2,111,1962,2073,0.6939204,0.6939757,0.90
2,112,1962,2074,0.7424819,0.7534507,0.80
2,113,1962,2075,0.7923800,0.8152252,0.71
2,114,1962,2076,0.8433824,0.8788995,0.62
2,115,1962,2077,1.0000000,1.0000000,0.50
2,37,1963,2000,0.0008314,0.0010683,49.62
2,38,1963,2001,0.0008908,0.0011175,48.67
2,39,1963,2002,0.0009481,0.0011608,47.73
2,40,1963,2003,0.0010090,0.0012082,46.78
2,41,1963,2004,0.0010784,0.0012656,45.84
2,42,1963,2005,0.0011559,0.0013298,44.90
2,43,1963,2006,0.0012427,0.0014006,43.95
2,44,1963,2007,0.0013435,0.0014839,43.02
2,45,1963,2008,0.0014588,0.0015819,42.08
2,46,1963,2009,0.0015840,0.0016867,41.14
2,47,1963,2010,0.0017152,0.0017938,40.21
2,48,1963,2011,0.0018531,0.0019042,39.28
2,49,1963,2012,0.0020059,0.0020278,38.36
2,50,1963,2013,0.0021845,0.0021735,37.44
2,51,1963,2014,0.0023896,0.0023350,36.52
2,52,1963,2015,0.0026115,0.0024997,35.60
2,53,1963,2016,0.0028474,0.0026681,34.69
2,54,1963,2017,0.0031082,0.0028577,33.78
2,55,1963,2018,0.0034035,0.0030766,32.88
2,56,1963,2019,0.0037277,0.0033115,31.98
2,57,1963,2020,0.0040692,0.0035420,31.08
2,58,1963,2021,0.0044295,0.0037730,30.19
2,59,1963,2022,0.0048296,0.0040324,29.30
2,60,1963,2023,0.0052973,0.0043482,28.42
2,61,1963,2024,0.0058480,0.0047238,27.54
2,62,1963,2025,0.0064757,0.0051460,26.67
2,63,1963,2026,0.0071641,0.0056069,25.80
2,64,1963,2027,0.0078986,0.0060985,24.95
2,65,1963,2028,0.0086645,0.0065953,24.10
2,66,1963,2029,0.0094558,0.0070788,23.25
2,67,1963,2030,0.0103010,0.0075690,22.41
2,68,1963,2031,0.0112531,0.0081220,21.58
2,69,1963,2032,0.0123584,0.0087850,20.75
2,70,1963,2033,0.0136702,0.0096062,19.93
2,71,1963,2034,0.0152518,0.0106433,19.12
2,72,1963,2035,0.0170987,0.0118818,18.32
2,73,1963,2036,0.0190837,0.0131959,17.54
2,74,1963,2037,0.0210750,0.0144724,16.76
2,75,1963,2038,0.0231062,0.0157422,16.00
2,76,1963,2039,0.0253497,0.0171593,15.25
2,77,1963,2040,0.0279666,0.0188716,14.51
2,78,1963,2041,0.0310443,0.0209801,13.78
2,79,1963,2042,0.0345982,0.0235152,13.06
2,80,1963,2043,0.0395295,0.0275273,12.37
2,81,1963,2044,0.0438328,0.0306380,11.70
2,82,1963,2045,0.0485928,0.0340750,11.06
2,83,1963,2046,0.0538556,0.0378951,10.43
2,84,1963,2047,0.0596709,0.0421714,9.82
2,85,1963,2048,0.0660929,0.0469808,9.23
2,86,1963,2049,0.0731799,0.0523554,8.66
2,87,1963,2050,0.0809950,0.0583194,8.11
2,88,1963,2051,0.0896059,0.0649533,7.58
2,89,1963,2052,0.0990850,0.0723676,7.07
2,90,1963,2053,0.1095094,0.0806780,6.59
2,91,1963,2054,0.1209607,0.0899376,6.12
2,92,1963,2055,0.1335249,0.1002127,5.68
2,93,1963,2056,0.1472918,0.1116594,5.25
2,94,1963,2057,0.1623547,0.1244706,4.85
2,95,1963,2058,0.1788093,0.1388026,4.47
2,96,1963,2059,0.1967531,0.1547321,4.11
2,97,1963,2060,0.2162837,0.1723641,3.77
2,98,1963,2061,0.2374976,0.1919132,3.45
2,99,1963,2062,0.2604884,0.2136300,3.15
2,100,1963,2063,0.2853445,0.2377052,2.87
2,101,1963,2064,0.3121468,0.2642322,2.61
2,102,1963,2065,0.3409660,0.2933358,2.37
2,103,1963,2066,0.3718598,0.3252423,2.14
2,104,1963,2067,0.4048696,0.3601791,1.94
2,105,1963,2068,0.4400178,0.3982792,1.75
2,106,1963,2069,0.4773042,0.4395614,1.57
2,107,1963,2070,0.5167037,0.4840508,1.41
2,108,1963,2071,0.5581634,0.5318088,1.26
2,109,1963,2072,0.6016004,0.5828239,1.13
2,110,1963,2073,0.6469012,0.6369559,1.01
2,111,1963,2074,0.6939204,0.6939766,0.90
2,112,1963,2075,0.7424819,0.7536377,0.80
2,113,1963,2076,0.7923800,0.8156180,0.71
2,114,1963,2077,0.8433824,0.8794650,0.62
2,115,1963,2078,1.0000000,1.0000000,0.50
2,36,1964,2000,0.0007710,0.0009909,50.70
2,37,1964,2001,0.0008314,0.0010450,49.75
2,38,1964,2002,0.0008908,0.0010949,48.80
2,39,1964,2003,0.0009481,0.0011402,47.85
2,40,1964,2004,0.0010090,0.0011881,46.91
2,41,1964,2005,0.0010784,0.0012437,45.96
2,42,1964,2006,0.0011559,0.0013066,45.02
2,43,1964,2007,0.0012427,0.0013779,44.08
2,44,1964,2008,0.0013435,0.0014615,43.14
2,45,1964,2009,0.0014588,0.0015569,42.20
2,46,1964,2010,0.0015840,0.0016580,41.26
2,47,1964,2011,0.0017152,0.0017631,40.33
2,48,1964,2012,0.0018531,0.0018736,39.40
2,49,1964,2013,0.0020059,0.0019958,38.47
2,50,1964,2014,0.0021845,0.0021350,37.55
2,51,1964,2015,0.0023896,0.0022883,36.63
2,52,1964,2016,0.0026115,0.0024479,35.71
2,53,1964,2017,0.0028474,0.0026158,34.80
2,54,1964,2018,0.0031082,0.0028061,33.89
2,55,1964,2019,0.0034035,0.0030204,32.98
2,56,1964,2020,0.0037277,0.0032462,32.08
2,57,1964,2021,0.0040692,0.0034703,31.18
2,58,1964,2022,0.0044295,0.0037004,30.29
2,59,1964,2023,0.0048296,0.0039602,29.40
2,60,1964,2024,0.0052973,0.0042688,28.52
2,61,1964,2025,0.0058480,0.0046310,27.64
2,62,1964,2026,0.0064757,0.0050440,26.76
2,63,1964,2027,0.0071641,0.0055041,25.90
2,64,1964,2028,0.0078986,0.0059968,25.04
2,65,1964,2029,0.0086645,0.0064835,24.19
2,66,1964,2030,0.0094558,0.0069484,23.34
2,67,1964,2031,0.0103010,0.0074263,22.50
2,68,1964,2032,0.0112531,0.0079782,21.66
2,69,1964,2033,0.0123584,0.0086423,20.83
2,70,1964,2034,0.0136702,0.0094491,20.01
2,71,1964,2035,0.0152518,0.0104588,19.20
2,72,1964,2036,0.0170987,0.0116783,18.40
2,73,1964,2037,0.0190837,0.0129897,17.61
2,74,1964,2038,0.0210750,0.0142675,16.83
2,75,1964,2039,0.0231062,0.0155174,16.07
2,76,1964,2040,0.0253497,0.0168976,15.31
2,77,1964,2041,0.0279666,0.0185858,14.57
2,78,1964,2042,0.0310443,0.0206929,13.83
2,79,1964,2043,0.0345982,0.0232319,13.12
2,80,1964,2044,0.0395295,0.0272197,12.42
2,81,1964,2045,0.0438328,0.0302806,11.75
2,82,1964,2046,0.0485928,0.0336843,11.10
2,83,1964,2047,0.0538556,0.0375018,10.47
2,84,1964,2048,0.0596709,0.0417803,9.86
2,85,1964,2049,0.0660929,0.0465498,9.27
2,86,1964,2050,0.0731799,0.0518542,8.70
2,87,1964,2051,0.0809950,0.0577740,8.14
2,88,1964,2052,0.0896059,0.0644072,7.61
2,89,1964,2053,0.0990850,0.0718270,7.10
2,90,1964,2054,0.1095094,0.0800851,6.61
2,91,1964,2055,0.1209607,0.0892531,6.14
2,92,1964,2056,0.1335249,0.0994747,5.70
2,93,1964,2057,0.1472918,0.1109297,5.27
2,94,1964,2058,0.1623547,0.1237639,4.87
2,95,1964,2059,0.1788093,0.1380486,4.48
2,96,1964,2060,0.1967531,0.1538815,4.12
2,97,1964,2061,0.2162837,0.1714672,3.78
2,98,1964,2062,0.2374976,0.1910484,3.46
2,99,1964,2063,0.2604884,0.2128141,3.16
2,100,1964,2064,0.2853445,0.2368600,2.88
2,101,1964,2065,0.3121468,0.2633146,2.62
2,102,1964,2066,0.3409660,0.2924128,2.37
2,103,1964,2067,0.3718598,0.3244014,2.15
2,104,1964,2068,0.4048696,0.3594413,1.94
2,105,1964,2069,0.4400178,0.3975810,1.75
2,106,1964,2070,0.4773042,0.4388807,1.57
2,107,1964,2071,0.5167037,0.4834544,1.41
2,108,1964,2072,0.5581634,0.5313606,1.26
2,109,1964,2073,0.6016004,0.5825314,1.13
2,110,1964,2074,0.6469012,0.6367989,1.01
2,111,1964,2075,0.6939204,0.6939775,0.90
2,112,1964,2076,0.7424819,0.7538292,0.80
2,113,1964,2077,0.7923800,0.8159879,0.71
2,114,1964,2078,0.8433824,0.8799887,0.62
2,115,1964,2079,1.0000000,1.0000000,0.50
2,35,1965,2000,0.0007153,0.0009200,51.78
2,36,1965,2001,0.0007710,0.0009693,50.82
2,37,1965,2002,0.0008314,0.0010236,49.87
2,38,1965,2003,0.0008908,0.0010751,48.92
2,39,1965,2004,0.0009481,0.0011208,47.98
2,40,1965,2005,0.0010090,0.0011671,47.03
2,41,1965,2006,0.0010784,0.0012216,46.08
2,42,1965,2007,0.0011559,0.0012849,45.14
2,43,1965,2008,0.0012427,0.0013563,44.20
2,44,1965,2009,0.0013435,0.0014374,43.26
2,45,1965,2010,0.0014588,0.0015294,42.32
2,46,1965,2011,0.0015840,0.0016291,41.38
2,47,1965,2012,0.0017152,0.0017344,40.45
2,48,1965,2013,0.0018531,0.0018437,39.52
2,49,1965,2014,0.0020059,0.0019604,38.59
2,50,1965,2015,0.0021845,0.0020925,37.67
2,51,1965,2016,0.0023896,0.0022413,36.74
2,52,1965,2017,0.0026115,0.0024001,35.82
2,53,1965,2018,0.0028474,0.0025682,34.91
2,54,1965,2019,0.0031082,0.0027542,34.00
2,55,1965,2020,0.0034035,0.0029603,33.09
2,56,1965,2021,0.0037277,0.0031807,32.19
2,57,1965,2022,0.0040692,0.0034041,31.29
2,58,1965,2023,0.0044295,0.0036344,30.39
2,59,1965,2024,0.0048296,0.0038875,29.50
2,60,1965,2025,0.0052973,0.0041839,28.62
2,61,1965,2026,0.0058480,0.0045378,27.73
2,62,1965,2027,0.0064757,0.0049497,26.86
2,63,1965,2028,0.0071641,0.0054106,25.99
2,64,1965,2029,0.0078986,0.0058942,25.13
2,65,1965,2030,0.0086645,0.0063640,24.27
2,66,1965,2031,0.0094558,0.0068175,23.43
2,67,1965,2032,0.0103010,0.0072944,22.58
2,68,1965,2033,0.0112531,0.0078476,21.75
2,69,1965,2034,0.0123584,0.0084990,20.91
2,70,1965,2035,0.0136702,0.0092810,20.09
2,71,1965,2036,0.0152518,0.0102733,19.27
2,72,1965,2037,0.0170987,0.0114898,18.47
2,73,1965,2038,0.0190837,0.0128015,17.68
2,74,1965,2039,0.0210750,0.0140604,16.90
2,75,1965,2040,0.0231062,0.0152760,16.13
2,76,1965,2041,0.0253497,0.0166339,15.38
2,77,1965,2042,0.0279666,0.0183206,14.63
2,78,1965,2043,0.0310443,0.0204312,13.89
2,79,1965,2044,0.0345982,0.0229464,13.17
2,80,1965,2045,0.0395295,0.0268891,12.47
2,81,1965,2046,0.0438328,0.0299189,11.80
2,82,1965,2047,0.0485928,0.0333199,11.15
2,83,1965,2048,0.0538556,0.0371393,10.51
2,84,1965,2049,0.0596709,0.0413803,9.90
2,85,1965,2050,0.0660929,0.0460836,9.31
2,86,1965,2051,0.0731799,0.0513459,8.73
2,87,1965,2052,0.0809950,0.0572642,8.18
2,88,1965,2053,0.0896059,0.0639019,7.64
2,89,1965,2054,0.0990850,0.0712716,7.13
2,90,1965,2055,0.1095094,0.0794419,6.64
2,91,1965,2056,0.1209607,0.0885573,6.17
2,92,1965,2057,0.1335249,0.0987843,5.72
2,93,1965,2058,0.1472918,0.1102582,5.29
2,94,1965,2059,0.1623547,0.1230440,4.88
2,95,1965,2060,0.1788093,0.1372320,4.50
2,96,1965,2061,0.1967531,0.1530150,4.14
2,97,1965,2062,0.2162837,0.1706257,3.79
2,98,1965,2063,0.2374976,0.1902480,3.47
2,99,1965,2064,0.2604884,0.2119771,3.17
2,100,1965,2065,0.2853445,0.2359411,2.89
2,101,1965,2066,0.3121468,0.2623779,2.62
2,102,1965,2067,0.3409660,0.2915458,2.38
2,103,1965,2068,0.3718598,0.3236255,2.15
2,104,1965,2069,0.4048696,0.3586883,1.94
2,105,1965,2070,0.4400178,0.3968222,1.75
2,106,1965,2071,0.4773042,0.4381845,1.57
2,107,1965,2072,0.5167037,0.4828931,1.41
2,108,1965,2073,0.5581634,0.5309458,1.26
2,109,1965,2074,0.6016004,0.5822319,1.13
2,110,1965,2075,0.6469012,0.6366279,1.01
2,111,1965,2076,0.6939204,0.6939785,0.90
2,112,1965,2077,0.7424819,0.7540095,0.80
2,113,1965,2078,0.7923800,0.8163305,0.71
2,114,1965,2079,0.8433824,0.8805249,0.62
2,115,1965,2080,1.0000000,1.0000000,0.50
2,34,1966,2000,0.0006665,0.0008550,52.86
2,35,1966,2001,0.0007153,0.0008998,51.90
2,36,1966,2002,0.0007710,0.0009495,50.95
2,37,1966,2003,0.0008314,0.0010050,50.00
2,38,1966,2004,0.0008908,0.0010564,49.05
2,39,1966,2005,0.0009481,0.0011005,48.10
2,40,1966,2006,0.0010090,0.0011459,47.15
2,41,1966,2007,0.0010784,0.0012010,46.21
2,42,1966,2008,0.0011559,0.0012643,45.26
2,43,1966,2009,0.0012427,0.0013331,44.32
2,44,1966,2010,0.0013435,0.0014111,43.38
2,45,1966,2011,0.0014588,0.0015018,42.44
2,46,1966,2012,0.0015840,0.0016020,41.50
2,47,1966,2013,0.0017152,0.0017064,40.57
2,48,1966,2014,0.0018531,0.0018107,39.63
2,49,1966,2015,0.0020059,0.0019214,38.70
2,50,1966,2016,0.0021845,0.0020499,37.78
2,51,1966,2017,0.0023896,0.0021980,36.85
2,52,1966,2018,0.0026115,0.0023566,35.94
2,53,1966,2019,0.0028474,0.0025202,35.02
2,54,1966,2020,0.0031082,0.0026988,34.11
2,55,1966,2021,0.0034035,0.0029000,33.20
2,56,1966,2022,0.0037277,0.0031201,32.29
2,57,1966,2023,0.0040692,0.0033438,31.39
2,58,1966,2024,0.0044295,0.0035679,30.50
2,59,1966,2025,0.0048296,0.0038099,29.60
2,60,1966,2026,0.0052973,0.0040988,28.71
2,61,1966,2027,0.0058480,0.0044517,27.83
2,62,1966,2028,0.0064757,0.0048639,26.95
2,63,1966,2029,0.0071641,0.0053163,26.08
2,64,1966,2030,0.0078986,0.0057846,25.22
2,65,1966,2031,0.0086645,0.0062439,24.36
2,66,1966,2032,0.0094558,0.0066964,23.51
2,67,1966,2033,0.0103010,0.0071746,22.67
2,68,1966,2034,0.0112531,0.0077165,21.83
2,69,1966,2035,0.0123584,0.0083458,20.99
2,70,1966,2036,0.0136702,0.0091120,20.17
2,71,1966,2037,0.0152518,0.0101015,19.35
2,72,1966,2038,0.0170987,0.0113178,18.54
2,73,1966,2039,0.0190837,0.0126113,17.75
2,74,1966,2040,0.0210750,0.0138382,16.97
2,75,1966,2041,0.0231062,0.0150328,16.20
2,76,1966,2042,0.0253497,0.0163893,15.44
2,77,1966,2043,0.0279666,0.0180790,14.69
2,78,1966,2044,0.0310443,0.0201676,13.95
2,79,1966,2045,0.0345982,0.0226398,13.22
2,80,1966,2046,0.0395295,0.0265546,12.52
2,81,1966,2047,0.0438328,0.0295818,11.85
2,82,1966,2048,0.0485928,0.0329843,11.19
2,83,1966,2049,0.0538556,0.0367687,10.56
2,84,1966,2050,0.0596709,0.0409478,9.94
2,85,1966,2051,0.0660929,0.0456110,9.34
2,86,1966,2052,0.0731799,0.0508710,8.77
2,87,1966,2053,0.0809950,0.0567928,8.21
2,88,1966,2054,0.0896059,0.0633830,7.67
2,89,1966,2055,0.0990850,0.0706693,7.16
2,90,1966,2056,0.1095094,0.0787885,6.66
2,91,1966,2057,0.1209607,0.0879067,6.19
2,92,1966,2058,0.1335249,0.0981491,5.74
2,93,1966,2059,0.1472918,0.1095743,5.31
2,94,1966,2060,0.1623547,0.1222646,4.90
2,95,1966,2061,0.1788093,0.1364005,4.52
2,96,1966,2062,0.1967531,0.1522026,4.15
2,97,1966,2063,0.2162837,0.1698474,3.81
2,98,1966,2064,0.2374976,0.1894274,3.48
2,99,1966,2065,0.2604884,0.2110675,3.18
2,100,1966,2066,0.2853445,0.2350035,2.89
2,101,1966,2067,0.3121468,0.2614985,2.63
2,102,1966,2068,0.3409660,0.2907459,2.38
2,103,1966,2069,0.3718598,0.3228338,2.16
2,104,1966,2070,0.4048696,0.3578704,1.95
2,105,1966,2071,0.4400178,0.3960465,1.75
2,106,1966,2072,0.4773042,0.4375295,1.58
2,107,1966,2073,0.5167037,0.4823737,1.41
2,108,1966,2074,0.5581634,0.5305211,1.27
2,109,1966,2075,0.6016004,0.5819059,1.13
2,110,1966,2076,0.6469012,0.6364529,1.01
2,111,1966,2077,0.6939204,0.6939794,0.90
2,112,1966,2078,0.7424819,0.7541765,0.80
2,113,1966,2079,0.7923800,0.8166813,0.71
2,114,1966,2080,0.8433824,0.8811088,0.62
2,115,1966,2081,1.0000000,1.0000000,0.50
2,33,1967,2000,0.0006220,0.0007962,53.94
2,34,1967,2001,0.0006665,0.0008365,52.99
2,35,1967,2002,0.0007153,0.0008814,52.03
2,36,1967,2003,0.0007710,0.0009321,51.08
2,37,1967,2004,0.0008314,0.0009874,50.12
2,38,1967,2005,0.0008908,0.0010369,49.17
2,39,1967,2006,0.0009481,0.0010801,48.22
2,40,1967,2007,0.0010090,0.0011262,47.27
2,41,1967,2008,0.0010784,0.0011814,46.33
2,42,1967,2009,0.0011559,0.0012422,45.38
2,43,1967,2010,0.0012427,0.0013078,44.44
2,44,1967,2011,0.0013435,0.0013847,43.49
2,45,1967,2012,0.0014588,0.0014760,42.55
2,46,1967,2013,0.0015840,0.0015757,41.62
2,47,1967,2014,0.0017152,0.0016754,40.68
2,48,1967,2015,0.0018531,0.0017743,39.75
2,49,1967,2016,0.0020059,0.0018822,38.82
2,50,1967,2017,0.0021845,0.0020105,37.89
2,51,1967,2018,0.0023896,0.0021586,36.97
2,52,1967,2019,0.0026115,0.0023128,36.05
2,53,1967,2020,0.0028474,0.0024690,35.13
2,54,1967,2021,0.0031082,0.0026432,34.21
2,55,1967,2022,0.0034035,0.0028443,33.30
2,56,1967,2023,0.0037277,0.0030651,32.40
2,57,1967,2024,0.0040692,0.0032831,31.49
2,58,1967,2025,0.0044295,0.0034969,30.60
2,59,1967,2026,0.0048296,0.0037320,29.70
2,60,1967,2027,0.0052973,0.0040202,28.81
2,61,1967,2028,0.0058480,0.0043734,27.93
2,62,1967,2029,0.0064757,0.0047776,27.05
2,63,1967,2030,0.0071641,0.0052155,26.17
2,64,1967,2031,0.0078986,0.0056743,25.31
2,65,1967,2032,0.0086645,0.0061328,24.45
2,66,1967,2033,0.0094558,0.0065865,23.60
2,67,1967,2034,0.0103010,0.0070543,22.75
2,68,1967,2035,0.0112531,0.0075763,21.91
2,69,1967,2036,0.0123584,0.0081918,21.07
2,70,1967,2037,0.0136702,0.0089557,20.24
2,71,1967,2038,0.0152518,0.0099448,19.42
2,72,1967,2039,0.0170987,0.0111442,18.61
2,73,1967,2040,0.0190837,0.0124074,17.81
2,74,1967,2041,0.0210750,0.0136143,17.03
2,75,1967,2042,0.0231062,0.0148074,16.26
2,76,1967,2043,0.0253497,0.0161665,15.50
2,77,1967,2044,0.0279666,0.0178359,14.74
2,78,1967,2045,0.0310443,0.0198847,14.00
2,79,1967,2046,0.0345982,0.0223302,13.28
2,80,1967,2047,0.0395295,0.0262431,12.57
2,81,1967,2048,0.0438328,0.0292715,11.89
2,82,1967,2049,0.0485928,0.0326414,11.24
2,83,1967,2050,0.0538556,0.0363682,10.60
2,84,1967,2051,0.0596709,0.0405095,9.98
2,85,1967,2052,0.0660929,0.0451697,9.38
2,86,1967,2053,0.0731799,0.0504321,8.80
2,87,1967,2054,0.0809950,0.0563089,8.24
2,88,1967,2055,0.0896059,0.0628205,7.70
2,89,1967,2056,0.0990850,0.0700577,7.19
2,90,1967,2057,0.1095094,0.0781777,6.69
2,91,1967,2058,0.1209607,0.0873084,6.21
2,92,1967,2059,0.1335249,0.0975025,5.76
2,93,1967,2060,0.1472918,0.1088342,5.33
2,94,1967,2061,0.1623547,0.1214713,4.92
2,95,1967,2062,0.1788093,0.1356211,4.53
2,96,1967,2063,0.1967531,0.1514513,4.16
2,97,1967,2064,0.2162837,0.1690497,3.82
2,98,1967,2065,0.2374976,0.1885359,3.49
2,99,1967,2066,0.2604884,0.2101397,3.19
2,100,1967,2067,0.2853445,0.2341235,2.90
2,101,1967,2068,0.3121468,0.2606874,2.64
2,102,1967,2069,0.3409660,0.2899302,2.39
2,103,1967,2070,0.3718598,0.3219742,2.16
2,104,1967,2071,0.4048696,0.3570344,1.95
2,105,1967,2072,0.4400178,0.3953169,1.76
2,106,1967,2073,0.4773042,0.4369235,1.58
2,107,1967,2074,0.5167037,0.4818420,1.42
2,108,1967,2075,0.5581634,0.5300589,1.27
2,109,1967,2076,0.6016004,0.5815722,1.13
2,110,1967,2077,0.6469012,0.6362880,1.01
2,111,1967,2078,0.6939204,0.6939803,0.90
2,112,1967,2079,0.7424819,0.7543475,0.80
2,113,1967,2080,0.7923800,0.8170632,0.70
2,114,1967,2081,0.8433824,0.8817067,0.62
2,115,1967,2082,1.0000000,1.0000000,0.50
2,32,1968,2000,0.0005796,0.0007410,55.03
2,33,1968,2001,0.0006220,0.0007791,54.07
2,34,1968,2002,0.0006665,0.0008195,53.11
2,35,1968,2003,0.0007153,0.0008653,52.16
2,36,1968,2004,0.0007710,0.0009158,51.20
2,37,1968,2005,0.0008314,0.0009690,50.25
2,38,1968,2006,0.0008908,0.0010173,49.30
2,39,1968,2007,0.0009481,0.0010610,48.35
2,40,1968,2008,0.0010090,0.0011074,47.40
2,41,1968,2009,0.0010784,0.0011603,46.45
2,42,1968,2010,0.0011559,0.0012180,45.50
2,43,1968,2011,0.0012427,0.0012823,44.56
2,44,1968,2012,0.0013435,0.0013599,43.61
2,45,1968,2013,0.0014588,0.0014509,42.67
2,46,1968,2014,0.0015840,0.0015465,41.73
2,47,1968,2015,0.0017152,0.0016413,40.80
2,48,1968,2016,0.0018531,0.0017378,39.86
2,49,1968,2017,0.0020059,0.0018460,38.93
2,50,1968,2018,0.0021845,0.0019747,38.00
2,51,1968,2019,0.0023896,0.0021189,37.08
2,52,1968,2020,0.0026115,0.0022660,36.15
2,53,1968,2021,0.0028474,0.0024177,35.24
2,54,1968,2022,0.0031082,0.0025918,34.32
2,55,1968,2023,0.0034035,0.0027937,33.41
2,56,1968,2024,0.0037277,0.0030096,32.50
2,57,1968,2025,0.0040692,0.0032182,31.60
2,58,1968,2026,0.0044295,0.0034256,30.70
2,59,1968,2027,0.0048296,0.0036600,29.80
2,60,1968,2028,0.0052973,0.0039487,28.91
2,61,1968,2029,0.0058480,0.0042946,28.02
2,62,1968,2030,0.0064757,0.0046852,27.14
2,63,1968,2031,0.0071641,0.0051142,26.26
2,64,1968,2032,0.0078986,0.0055725,25.40
2,65,1968,2033,0.0086645,0.0060320,24.54
2,66,1968,2034,0.0094558,0.0064761,23.68
2,67,1968,2035,0.0103010,0.0069258,22.83
2,68,1968,2036,0.0112531,0.0074355,21.99
2,69,1968,2037,0.0123584,0.0080493,21.15
2,70,1968,2038,0.0136702,0.0088132,20.32
2,71,1968,2039,0.0152518,0.0097867,19.49
2,72,1968,2040,0.0170987,0.0109580,18.68
2,73,1968,2041,0.0190837,0.0122020,17.88
2,74,1968,2042,0.0210750,0.0134068,17.10
2,75,1968,2043,0.0231062,0.0146021,16.32
2,76,1968,2044,0.0253497,0.0159424,15.56
2,77,1968,2045,0.0279666,0.0175752,14.80
2,78,1968,2046,0.0310443,0.0195992,14.06
2,79,1968,2047,0.0345982,0.0220421,13.33
2,80,1968,2048,0.0395295,0.0259564,12.62
2,81,1968,2049,0.0438328,0.0289544,11.94
2,82,1968,2050,0.0485928,0.0322709,11.28
2,83,1968,2051,0.0538556,0.0359626,10.64
2,84,1968,2052,0.0596709,0.0401005,10.02
2,85,1968,2053,0.0660929,0.0447620,9.42
2,86,1968,2054,0.0731799,0.0499817,8.84
2,87,1968,2055,0.0809950,0.0557845,8.27
2,88,1968,2056,0.0896059,0.0622497,7.73
2,89,1968,2057,0.0990850,0.0694863,7.21
2,90,1968,2058,0.1095094,0.0776163,6.72
2,91,1968,2059,0.1209607,0.0866997,6.24
2,92,1968,2060,0.1335249,0.0968031,5.78
2,93,1968,2061,0.1472918,0.1080814,5.35
2,94,1968,2062,0.1623547,0.1207281,4.94
2,95,1968,2063,0.1788093,0.1349008,4.55
2,96,1968,2064,0.1967531,0.1506816,4.18
2,97,1968,2065,0.2162837,0.1681834,3.83
2,98,1968,2066,0.2374976,0.1876269,3.50
2,99,1968,2067,0.2604884,0.2092693,3.20
2,100,1968,2068,0.2853445,0.2333123,2.91
2,101,1968,2069,0.3121468,0.2598605,2.64
2,102,1968,2070,0.3409660,0.2890447,2.40
2,103,1968,2071,0.3718598,0.3210959,2.17
2,104,1968,2072,0.4048696,0.3562484,1.95
2,105,1968,2073,0.4400178,0.3946422,1.76
2,106,1968,2074,0.4773042,0.4363035,1.58
2,107,1968,2075,0.5167037,0.4812636,1.42
2,108,1968,2076,0.5581634,0.5295859,1.27
2,109,1968,2077,0.6016004,0.5812580,1.13
2,110,1968,2078,0.6469012,0.6361354,1.01
2,111,1968,2079,0.6939204,0.6939812,0.90
2,112,1968,2080,0.7424819,0.7545336,0.80
2,113,1968,2081,0.7923800,0.8174544,0.70
2,114,1968,2082,0.8433824,0.8822700,0.62
2,115,1968,2083,1.0000000,1.0000000,0.50
2,31,1969,2000,0.0005408,0.0006917,56.12
2,32,1969,2001,0.0005796,0.0007251,55.16
2,33,1969,2002,0.0006220,0.0007634,54.20
2,34,1969,2003,0.0006665,0.0008047,53.24
2,35,1969,2004,0.0007153,0.0008501,52.28
2,36,1969,2005,0.0007710,0.0008987,51.33
2,37,1969,2006,0.0008314,0.0009505,50.37
2,38,1969,2007,0.0008908,0.0009991,49.42
2,39,1969,2008,0.0009481,0.0010429,48.47
2,40,1969,2009,0.0010090,0.0010873,47.52
2,41,1969,2010,0.0010784,0.0011373,46.57
2,42,1969,2011,0.0011559,0.0011937,45.62
2,43,1969,2012,0.0012427,0.0012585,44.67
2,44,1969,2013,0.0013435,0.0013359,43.73
2,45,1969,2014,0.0014588,0.0014231,42.79
2,46,1969,2015,0.0015840,0.0015145,41.85
2,47,1969,2016,0.0017152,0.0016071,40.91
2,48,1969,2017,0.0018531,0.0017041,39.98
2,49,1969,2018,0.0020059,0.0018131,39.04
2,50,1969,2019,0.0021845,0.0019387,38.11
2,51,1969,2020,0.0023896,0.0020764,37.19
2,52,1969,2021,0.0026115,0.0022191,36.26
2,53,1969,2022,0.0028474,0.0023703,35.34
2,54,1969,2023,0.0031082,0.0025451,34.43
2,55,1969,2024,0.0034035,0.0027427,33.51
2,56,1969,2025,0.0037277,0.0029503,32.60
2,57,1969,2026,0.0040692,0.0031531,31.70
2,58,1969,2027,0.0044295,0.0033598,30.80
2,59,1969,2028,0.0048296,0.0035946,29.90
2,60,1969,2029,0.0052973,0.0038767,29.00
2,61,1969,2030,0.0058480,0.0042103,28.12
2,62,1969,2031,0.0064757,0.0045925,27.23
2,63,1969,2032,0.0071641,0.0050207,26.36
2,64,1969,2033,0.0078986,0.0054800,25.49
2,65,1969,2034,0.0086645,0.0059307,24.62
2,66,1969,2035,0.0094558,0.0063581,23.77
2,67,1969,2036,0.0103010,0.0067965,22.92
2,68,1969,2037,0.0112531,0.0073052,22.07
2,69,1969,2038,0.0123584,0.0079195,21.23
2,70,1969,2039,0.0136702,0.0086694,20.39
2,71,1969,2040,0.0152518,0.0096174,19.57
2,72,1969,2041,0.0170987,0.0107706,18.75
2,73,1969,2042,0.0190837,0.0120117,17.95
2,74,1969,2043,0.0210750,0.0132179,17.16
2,75,1969,2044,0.0231062,0.0143957,16.39
2,76,1969,2045,0.0253497,0.0157023,15.62
2,77,1969,2046,0.0279666,0.0173121,14.86
2,78,1969,2047,0.0310443,0.0193337,14.11
2,79,1969,2048,0.0345982,0.0217773,13.38
2,80,1969,2049,0.0395295,0.0256637,12.67
2,81,1969,2050,0.0438328,0.0286122,11.99
2,82,1969,2051,0.0485928,0.0318959,11.33
2,83,1969,2052,0.0538556,0.0355842,10.68
2,84,1969,2053,0.0596709,0.0397227,10.06
2,85,1969,2054,0.0660929,0.0443437,9.46
2,86,1969,2055,0.0731799,0.0494939,8.87
2,87,1969,2056,0.0809950,0.0552526,8.31
2,88,1969,2057,0.0896059,0.0617165,7.76
2,89,1969,2058,0.0990850,0.0689613,7.24
2,90,1969,2059,0.1095094,0.0770453,6.74
2,91,1969,2060,0.1209607,0.0860415,6.26
2,92,1969,2061,0.1335249,0.0960919,5.80
2,93,1969,2062,0.1472918,0.1073764,5.37
2,94,1969,2063,0.1623547,0.1200415,4.95
2,95,1969,2064,0.1788093,0.1341631,4.56
2,96,1969,2065,0.1967531,0.1498462,4.19
2,97,1969,2066,0.2162837,0.1673005,3.84
2,98,1969,2067,0.2374976,0.1867746,3.51
2,99,1969,2068,0.2604884,0.2084673,3.21
2,100,1969,2069,0.2853445,0.2324855,2.92
2,101,1969,2070,0.3121468,0.2589633,2.65
2,102,1969,2071,0.3409660,0.2881404,2.40
2,103,1969,2072,0.3718598,0.3202704,2.17
2,104,1969,2073,0.4048696,0.3555218,1.96
2,105,1969,2074,0.4400178,0.3939519,1.76
2,106,1969,2075,0.4773042,0.4356291,1.58
2,107,1969,2076,0.5167037,0.4806718,1.42
2,108,1969,2077,0.5581634,0.5291407,1.27
2,109,1969,2078,0.6016004,0.5809672,1.13
2,110,1969,2079,0.6469012,0.6359792,1.01
2,111,1969,2080,0.6939204,0.6939821,0.90
2,112,1969,2081,0.7424819,0.7547243,0.80
2,113,1969,2082,0.7923800,0.8178229,0.70
2,114,1969,2083,0.8433824,0.8827919,0.62
2,115,1969,2084,1.0000000,1.0000000,0.50
2,30,1970,2000,0.0005091,0.0006518,57.21
2,31,1970,2001,0.0005408,0.0006769,56.25
2,32,1970,2002,0.0005796,0.0007106,55.28
2,33,1970,2003,0.0006220,0.0007497,54.32
2,34,1970,2004,0.0006665,0.0007907,53.36
2,35,1970,2005,0.0007153,0.0008342,52.41
2,36,1970,2006,0.0007710,0.0008816,51.45
2,37,1970,2007,0.0008314,0.0009333,50.49
2,38,1970,2008,0.0008908,0.0009817,49.54
2,39,1970,2009,0.0009481,0.0010235,48.59
2,40,1970,2010,0.0010090,0.0010653,47.64
2,41,1970,2011,0.0010784,0.0011143,46.69
2,42,1970,2012,0.0011559,0.0011710,45.74
2,43,1970,2013,0.0012427,0.0012354,44.79
2,44,1970,2014,0.0013435,0.0013093,43.85
2,45,1970,2015,0.0014588,0.0013926,42.90
2,46,1970,2016,0.0015840,0.0014823,41.96
2,47,1970,2017,0.0017152,0.0015756,41.02
2,48,1970,2018,0.0018531,0.0016734,40.09
2,49,1970,2019,0.0020059,0.0017800,39.16
2,50,1970,2020,0.0021845,0.0019001,38.22
2,51,1970,2021,0.0023896,0.0020339,37.30
2,52,1970,2022,0.0026115,0.0021758,36.37
2,53,1970,2023,0.0028474,0.0023272,35.45
2,54,1970,2024,0.0031082,0.0024981,34.53
2,55,1970,2025,0.0034035,0.0026882,33.62
2,56,1970,2026,0.0037277,0.0028908,32.71
2,57,1970,2027,0.0040692,0.0030929,31.80
2,58,1970,2028,0.0044295,0.0032999,30.90
2,59,1970,2029,0.0048296,0.0035288,30.00
2,60,1970,2030,0.0052973,0.0037998,29.10
2,61,1970,2031,0.0058480,0.0041258,28.21
2,62,1970,2032,0.0064757,0.0045069,27.32
2,63,1970,2033,0.0071641,0.0049358,26.45
2,64,1970,2034,0.0078986,0.0053872,25.57
2,65,1970,2035,0.0086645,0.0058225,24.71
2,66,1970,2036,0.0094558,0.0062395,23.85
2,67,1970,2037,0.0103010,0.0066770,23.00
2,68,1970,2038,0.0112531,0.0071864,22.15
2,69,1970,2039,0.0123584,0.0077886,21.31
2,70,1970,2040,0.0136702,0.0085155,20.47
2,71,1970,2041,0.0152518,0.0094470,19.64
2,72,1970,2042,0.0170987,0.0105971,18.82
2,73,1970,2043,0.0190837,0.0118386,18.02
2,74,1970,2044,0.0210750,0.0130280,17.23
2,75,1970,2045,0.0231062,0.0141745,16.45
2,76,1970,2046,0.0253497,0.0154600,15.68
2,77,1970,2047,0.0279666,0.0170678,14.92
2,78,1970,2048,0.0310443,0.0190899,14.17
2,79,1970,2049,0.0345982,0.0215072,13.44
2,80,1970,2050,0.0395295,0.0253478,12.72
2,81,1970,2051,0.0438328,0.0282658,12.04
2,82,1970,2052,0.0485928,0.0315462,11.37
2,83,1970,2053,0.0538556,0.0352349,10.73
2,84,1970,2054,0.0596709,0.0393354,10.10
2,85,1970,2055,0.0660929,0.0438910,9.49
2,86,1970,2056,0.0731799,0.0489992,8.91
2,87,1970,2057,0.0809950,0.0547561,8.34
2,88,1970,2058,0.0896059,0.0612268,7.79
2,89,1970,2059,0.0990850,0.0684275,7.27
2,90,1970,2060,0.1095094,0.0764282,6.77
2,91,1970,2061,0.1209607,0.0853724,6.29
2,92,1970,2062,0.1335249,0.0954262,5.83
2,93,1970,2063,0.1472918,0.1067253,5.39
2,94,1970,2064,0.1623547,0.1193386,4.97
2,95,1970,2065,0.1788093,0.1333627,4.58
2,96,1970,2066,0.1967531,0.1489952,4.20
2,97,1970,2067,0.2162837,0.1664730,3.85
2,98,1970,2068,0.2374976,0.1859895,3.52
2,99,1970,2069,0.2604884,0.2076502,3.21
2,100,1970,2070,0.2853445,0.2315889,2.93
2,101,1970,2071,0.3121468,0.2580475,2.66
2,102,1970,2072,0.3409660,0.2872908,2.41
2,103,1970,2073,0.3718598,0.3195076,2.18
2,104,1970,2074,0.4048696,0.3547787,1.96
2,105,1970,2075,0.4400178,0.3932014,1.77
2,106,1970,2076,0.4773042,0.4349393,1.58
2,107,1970,2077,0.5167037,0.4801149,1.42
2,108,1970,2078,0.5581634,0.5287287,1.27
2,109,1970,2079,0.6016004,0.5806696,1.13
2,110,1970,2080,0.6469012,0.6358091,1.01
2,111,1970,2081,0.6939204,0.6939831,0.90
2,112,1970,2082,0.7424819,0.7549040,0.79
2,113,1970,2083,0.7923800,0.8181643,0.70
2,114,1970,2084,0.8433824,0.8833268,0.62
2,115,1970,2085,1.0000000,1.0000000,0.50
2,29,1971,2000,0.0004856,0.0006228,58.30
2,30,1971,2001,0.0005091,0.0006378,57.34
2,31,1971,2002,0.0005408,0.0006633,56.37
2,32,1971,2003,0.0005796,0.0006979,55.41
2,33,1971,2004,0.0006220,0.0007368,54.45
2,34,1971,2005,0.0006665,0.0007760,53.49
2,35,1971,2006,0.0007153,0.0008182,52.53
2,36,1971,2007,0.0007710,0.0008656,51.57
2,37,1971,2008,0.0008314,0.0009169,50.62
2,38,1971,2009,0.0008908,0.0009631,49.66
2,39,1971,2010,0.0009481,0.0010023,48.71
2,40,1971,2011,0.0010090,0.0010433,47.76
2,41,1971,2012,0.0010784,0.0010928,46.81
2,42,1971,2013,0.0011559,0.0011490,45.86
2,43,1971,2014,0.0012427,0.0012099,44.91
2,44,1971,2015,0.0013435,0.0012802,43.96
2,45,1971,2016,0.0014588,0.0013620,43.02
2,46,1971,2017,0.0015840,0.0014526,42.08
2,47,1971,2018,0.0017152,0.0015469,41.14
2,48,1971,2019,0.0018531,0.0016426,40.20
2,49,1971,2020,0.0020059,0.0017446,39.27
2,50,1971,2021,0.0021845,0.0018614,38.33
2,51,1971,2022,0.0023896,0.0019946,37.40
2,52,1971,2023,0.0026115,0.0021364,36.48
2,53,1971,2024,0.0028474,0.0022837,35.55
2,54,1971,2025,0.0031082,0.0024478,34.64
2,55,1971,2026,0.0034035,0.0026335,33.72
2,56,1971,2027,0.0037277,0.0028358,32.81
2,57,1971,2028,0.0040692,0.0030382,31.90
2,58,1971,2029,0.0044295,0.0032397,30.99
2,59,1971,2030,0.0048296,0.0034585,30.09
2,60,1971,2031,0.0052973,0.0037227,29.20
2,61,1971,2032,0.0058480,0.0040477,28.30
2,62,1971,2033,0.0064757,0.0044292,27.42
2,63,1971,2034,0.0071641,0.0048506,26.54
2,64,1971,2035,0.0078986,0.0052880,25.66
2,65,1971,2036,0.0086645,0.0057138,24.80
2,66,1971,2037,0.0094558,0.0061298,23.94
2,67,1971,2038,0.0103010,0.0065682,23.08
2,68,1971,2039,0.0112531,0.0070667,22.23
2,69,1971,2040,0.0123584,0.0076484,21.38
2,70,1971,2041,0.0136702,0.0083607,20.55
2,71,1971,2042,0.0152518,0.0092893,19.71
2,72,1971,2043,0.0170987,0.0104393,18.89
2,73,1971,2044,0.0190837,0.0116646,18.09
2,74,1971,2045,0.0210750,0.0128246,17.30
2,75,1971,2046,0.0231062,0.0139515,16.51
2,76,1971,2047,0.0253497,0.0152351,15.74
2,77,1971,2048,0.0279666,0.0168434,14.98
2,78,1971,2049,0.0310443,0.0188413,14.23
2,79,1971,2050,0.0345982,0.0212161,13.49
2,80,1971,2051,0.0395295,0.0250284,12.77
2,81,1971,2052,0.0438328,0.0279431,12.09
2,82,1971,2053,0.0485928,0.0312235,11.42
2,83,1971,2054,0.0538556,0.0348768,10.77
2,84,1971,2055,0.0596709,0.0389163,10.14
2,85,1971,2056,0.0660929,0.0434321,9.53
2,86,1971,2057,0.0731799,0.0485377,8.94
2,87,1971,2058,0.0809950,0.0543002,8.37
2,88,1971,2059,0.0896059,0.0607292,7.82
2,89,1971,2060,0.0990850,0.0678509,7.30
2,90,1971,2061,0.1095094,0.0758012,6.79
2,91,1971,2062,0.1209607,0.0847465,6.31
2,92,1971,2063,0.1335249,0.0948118,5.85
2,93,1971,2064,0.1472918,0.1060591,5.41
2,94,1971,2065,0.1623547,0.1185763,4.99
2,95,1971,2066,0.1788093,0.1325478,4.59
2,96,1971,2067,0.1967531,0.1481978,4.22
2,97,1971,2068,0.2162837,0.1657111,3.87
2,98,1971,2069,0.2374976,0.1851900,3.53
2,99,1971,2070,0.2604884,0.2067644,3.22
2,100,1971,2071,0.2853445,0.2306739,2.93
2,101,1971,2072,0.3121468,0.2571873,2.66
2,102,1971,2073,0.3409660,0.2865060,2.41
2,103,1971,2074,0.3718598,0.3187277,2.18
2,104,1971,2075,0.4048696,0.3539709,1.97
2,105,1971,2076,0.4400178,0.3924340,1.77
2,106,1971,2077,0.4773042,0.4342903,1.59
2,107,1971,2078,0.5167037,0.4795997,1.42
2,108,1971,2079,0.5581634,0.5283071,1.27
2,109,1971,2080,0.6016004,0.5803456,1.13
2,110,1971,2081,0.6469012,0.6356350,1.01
2,111,1971,2082,0.6939204,0.6939840,0.90
2,112,1971,2083,0.7424819,0.7550703,0.79
2,113,1971,2084,0.7923800,0.8185142,0.70
2,114,1971,2085,0.8433824,0.8839095,0.62
2,115,1971,2086,1.0000000,1.0000000,0.50
2,28,1972,2000,0.0004684,0.0006014,59.39
2,29,1972,2001,0.0004856,0.0006093,58.43
2,30,1972,2002,0.0005091,0.0006250,57.46
2,31,1972,2003,0.0005408,0.0006514,56.50
2,32,1972,2004,0.0005796,0.0006859,55.53
2,33,1972,2005,0.0006220,0.0007233,54.57
2,34,1972,2006,0.0006665,0.0007614,53.61
2,35,1972,2007,0.0007153,0.0008033,52.65
2,36,1972,2008,0.0007710,0.0008504,51.69
2,37,1972,2009,0.0008314,0.0008994,50.74
2,38,1972,2010,0.0008908,0.0009428,49.78
2,39,1972,2011,0.0009481,0.0009811,48.83
2,40,1972,2012,0.0010090,0.0010227,47.88
2,41,1972,2013,0.0010784,0.0010719,46.92
2,42,1972,2014,0.0011559,0.0011247,45.97
2,43,1972,2015,0.0012427,0.0011819,45.03
2,44,1972,2016,0.0013435,0.0012510,44.08
2,45,1972,2017,0.0014588,0.0013337,43.13
2,46,1972,2018,0.0015840,0.0014257,42.19
2,47,1972,2019,0.0017152,0.0015180,41.25
2,48,1972,2020,0.0018531,0.0016096,40.31
2,49,1972,2021,0.0020059,0.0017090,39.38
2,50,1972,2022,0.0021845,0.0018257,38.44
2,51,1972,2023,0.0023896,0.0019588,37.51
2,52,1972,2024,0.0026115,0.0020967,36.58
2,53,1972,2025,0.0028474,0.0022374,35.66
2,54,1972,2026,0.0031082,0.0023974,34.74
2,55,1972,2027,0.0034035,0.0025830,33.82
2,56,1972,2028,0.0037277,0.0027859,32.91
2,57,1972,2029,0.0040692,0.0029832,32.00
2,58,1972,2030,0.0044295,0.0031753,31.09
2,59,1972,2031,0.0048296,0.0033879,30.19
2,60,1972,2032,0.0052973,0.0036515,29.29
2,61,1972,2033,0.0058480,0.0039769,28.40
2,62,1972,2034,0.0064757,0.0043513,27.51
2,63,1972,2035,0.0071641,0.0047596,26.63
2,64,1972,2036,0.0078986,0.0051883,25.75
2,65,1972,2037,0.0086645,0.0056132,24.88
2,66,1972,2038,0.0094558,0.0060299,24.02
2,67,1972,2039,0.0103010,0.0064584,23.16
2,68,1972,2040,0.0112531,0.0069386,22.31
2,69,1972,2041,0.0123584,0.0075075,21.46
2,70,1972,2042,0.0136702,0.0082175,20.62
2,71,1972,2043,0.0152518,0.0091461,19.79
2,72,1972,2044,0.0170987,0.0102808,18.97
2,73,1972,2045,0.0190837,0.0114782,18.16
2,74,1972,2046,0.0210750,0.0126196,17.36
2,75,1972,2047,0.0231062,0.0137445,16.58
2,76,1972,2048,0.0253497,0.0150287,15.80
2,77,1972,2049,0.0279666,0.0166148,15.04
2,78,1972,2050,0.0310443,0.0185736,14.28
2,79,1972,2051,0.0345982,0.0209221,13.54
2,80,1972,2052,0.0395295,0.0247308,12.82
2,81,1972,2053,0.0438328,0.0276454,12.13
2,82,1972,2054,0.0485928,0.0308930,11.46
2,83,1972,2055,0.0538556,0.0344897,10.81
2,84,1972,2056,0.0596709,0.0384917,10.18
2,85,1972,2057,0.0660929,0.0430042,9.57
2,86,1972,2058,0.0731799,0.0481142,8.98
2,87,1972,2059,0.0809950,0.0538371,8.41
2,88,1972,2060,0.0896059,0.0601918,7.86
2,89,1972,2061,0.0990850,0.0672653,7.33
2,90,1972,2062,0.1095094,0.0752148,6.82
2,91,1972,2063,0.1209607,0.0841690,6.33
2,92,1972,2064,0.1335249,0.0941832,5.87
2,93,1972,2065,0.1472918,0.1053368,5.43
2,94,1972,2066,0.1623547,0.1178005,5.01
2,95,1972,2067,0.1788093,0.1317846,4.61
2,96,1972,2068,0.1967531,0.1474640,4.23
2,97,1972,2069,0.2162837,0.1649356,3.88
2,98,1972,2070,0.2374976,0.1843236,3.54
2,99,1972,2071,0.2604884,0.2058609,3.23
2,100,1972,2072,0.2853445,0.2298149,2.94
2,101,1972,2073,0.3121468,0.2563930,2.67
2,102,1972,2074,0.3409660,0.2857038,2.42
2,103,1972,2075,0.3718598,0.3178802,2.18
2,104,1972,2076,0.4048696,0.3531453,1.97
2,105,1972,2077,0.4400178,0.3917122,1.77
2,106,1972,2078,0.4773042,0.4336902,1.59
2,107,1972,2079,0.5167037,0.4790726,1.42
2,108,1972,2080,0.5581634,0.5278484,1.27
2,109,1972,2081,0.6016004,0.5800141,1.13
2,110,1972,2082,0.6469012,0.6354711,1.01
2,111,1972,2083,0.6939204,0.6939849,0.90
2,112,1972,2084,0.7424819,0.7552409,0.79
2,113,1972,2085,0.7923800,0.8188954,0.70
2,114,1972,2086,0.8433824,0.8845061,0.62
2,115,1972,2087,1.0000000,1.0000000,0.50
2,27,1973,2000,0.0004528,0.0005823,60.48
2,28,1973,2001,0.0004684,0.0005884,59.52
2,29,1973,2002,0.0004856,0.0005969,58.55
2,30,1973,2003,0.0005091,0.0006137,57.59
2,31,1973,2004,0.0005408,0.0006402,56.62
2,32,1973,2005,0.0005796,0.0006734,55.66
2,33,1973,2006,0.0006220,0.0007097,54.70
2,34,1973,2007,0.0006665,0.0007477,53.73
2,35,1973,2008,0.0007153,0.0007892,52.77
2,36,1973,2009,0.0007710,0.0008341,51.82
2,37,1973,2010,0.0008314,0.0008803,50.86
2,38,1973,2011,0.0008908,0.0009224,49.90
2,39,1973,2012,0.0009481,0.0009613,48.95
2,40,1973,2013,0.0010090,0.0010027,47.99
2,41,1973,2014,0.0010784,0.0010488,47.04
2,42,1973,2015,0.0011559,0.0010981,46.09
2,43,1973,2016,0.0012427,0.0011539,45.14
2,44,1973,2017,0.0013435,0.0012240,44.19
2,45,1973,2018,0.0014588,0.0013081,43.25
2,46,1973,2019,0.0015840,0.0013985,42.30
2,47,1973,2020,0.0017152,0.0014871,41.36
2,48,1973,2021,0.0018531,0.0015765,40.42
2,49,1973,2022,0.0020059,0.0016762,39.48
2,50,1973,2023,0.0021845,0.0017932,38.55
2,51,1973,2024,0.0023896,0.0019228,37.62
2,52,1973,2025,0.0026115,0.0020544,36.69
2,53,1973,2026,0.0028474,0.0021909,35.76
2,54,1973,2027,0.0031082,0.0023509,34.84
2,55,1973,2028,0.0034035,0.0025371,33.92
2,56,1973,2029,0.0037277,0.0027355,33.01
2,57,1973,2030,0.0040692,0.0029244,32.10
2,58,1973,2031,0.0044295,0.0031107,31.19
2,59,1973,2032,0.0048296,0.0033227,30.29
2,60,1973,2033,0.0052973,0.0035869,29.38
2,61,1973,2034,0.0058480,0.0039059,28.49
2,62,1973,2035,0.0064757,0.0042681,27.60
2,63,1973,2036,0.0071641,0.0046682,26.71
2,64,1973,2037,0.0078986,0.0050961,25.84
2,65,1973,2038,0.0086645,0.0055216,24.97
2,66,1973,2039,0.0094558,0.0059292,24.10
2,67,1973,2040,0.0103010,0.0063409,23.24
2,68,1973,2041,0.0112531,0.0068098,22.39
2,69,1973,2042,0.0123584,0.0073772,21.54
2,70,1973,2043,0.0136702,0.0080874,20.70
2,71,1973,2044,0.0152518,0.0090022,19.86
2,72,1973,2045,0.0170987,0.0101111,19.04
2,73,1973,2046,0.0190837,0.0112905,18.23
2,74,1973,2047,0.0210750,0.0124293,17.43
2,75,1973,2048,0.0231062,0.0135545,16.64
2,76,1973,2049,0.0253497,0.0148185,15.86
2,77,1973,2050,0.0279666,0.0163688,15.09
2,78,1973,2051,0.0310443,0.0183034,14.34
2,79,1973,2052,0.0345982,0.0206485,13.59
2,80,1973,2053,0.0395295,0.0244564,12.87
2,81,1973,2054,0.0438328,0.0273405,12.18
2,82,1973,2055,0.0485928,0.0305356,11.51
2,83,1973,2056,0.0538556,0.0340976,10.86
2,84,1973,2057,0.0596709,0.0380960,10.22
2,85,1973,2058,0.0660929,0.0426117,9.61
2,86,1973,2059,0.0731799,0.0476842,9.01
2,87,1973,2060,0.0809950,0.0533373,8.44
2,88,1973,2061,0.0896059,0.0596463,7.89
2,89,1973,2062,0.0990850,0.0667178,7.35
2,90,1973,2063,0.1095094,0.0746741,6.84
2,91,1973,2064,0.1209607,0.0835784,6.36
2,92,1973,2065,0.1335249,0.0935021,5.89
2,93,1973,2066,0.1472918,0.1046021,5.45
2,94,1973,2067,0.1623547,0.1170743,5.02
2,95,1973,2068,0.1788093,0.1310825,4.62
2,96,1973,2069,0.1967531,0.1467173,4.25
2,97,1973,2070,0.2162837,0.1640954,3.89
2,98,1973,2071,0.2374976,0.1834402,3.56
2,99,1973,2072,0.2604884,0.2050130,3.24
2,100,1973,2073,0.2853445,0.2290220,2.95
2,101,1973,2074,0.3121468,0.2555815,2.68
2,102,1973,2075,0.3409660,0.2848325,2.42
2,103,1973,2076,0.3718598,0.3170144,2.19
2,104,1973,2077,0.4048696,0.3523691,1.97
2,105,1973,2078,0.4400178,0.3910449,1.77
2,106,1973,2079,0.4773042,0.4330763,1.59
2,107,1973,2080,0.5167037,0.4784992,1.42
2,108,1973,2081,0.5581634,0.5273789,1.27
2,109,1973,2082,0.6016004,0.5797018,1.13
2,110,1973,2083,0.6469012,0.6353192,1.01
2,111,1973,2084,0.6939204,0.6939858,0.90
2,112,1973,2085,0.7424819,0.7554266,0.79
2,113,1973,2086,0.7923800,0.8192858,0.70
2,114,1973,2087,0.8433824,0.8850684,0.61
2,115,1973,2088,1.0000000,1.0000000,0.50
2,26,1974,2000,0.0004348,0.0005592,61.58
2,27,1974,2001,0.0004528,0.0005696,60.61
2,28,1974,2002,0.0004684,0.0005764,59.64
2,29,1974,2003,0.0004856,0.0005861,58.68
2,30,1974,2004,0.0005091,0.0006031,57.71
2,31,1974,2005,0.0005408,0.0006285,56.75
2,32,1974,2006,0.0005796,0.0006608,55.78
2,33,1974,2007,0.0006220,0.0006971,54.82
2,34,1974,2008,0.0006665,0.0007346,53.86
2,35,1974,2009,0.0007153,0.0007741,52.90
2,36,1974,2010,0.0007710,0.0008164,51.94
2,37,1974,2011,0.0008314,0.0008611,50.98
2,38,1974,2012,0.0008908,0.0009034,50.02
2,39,1974,2013,0.0009481,0.0009421,49.07
2,40,1974,2014,0.0010090,0.0009807,48.11
2,41,1974,2015,0.0010784,0.0010235,47.16
2,42,1974,2016,0.0011559,0.0010714,46.21
2,43,1974,2017,0.0012427,0.0011281,45.26
2,44,1974,2018,0.0013435,0.0011996,44.31
2,45,1974,2019,0.0014588,0.0012823,43.36
2,46,1974,2020,0.0015840,0.0013695,42.41
2,47,1974,2021,0.0017152,0.0014562,41.47
2,48,1974,2022,0.0018531,0.0015459,40.53
2,49,1974,2023,0.0020059,0.0016464,39.59
2,50,1974,2024,0.0021845,0.0017605,38.66
2,51,1974,2025,0.0023896,0.0018844,37.72
2,52,1974,2026,0.0026115,0.0020119,36.80
2,53,1974,2027,0.0028474,0.0021480,35.87
2,54,1974,2028,0.0031082,0.0023086,34.94
2,55,1974,2029,0.0034035,0.0024909,34.02
2,56,1974,2030,0.0037277,0.0026818,33.11
2,57,1974,2031,0.0040692,0.0028653,32.20
2,58,1974,2032,0.0044295,0.0030511,31.29
2,59,1974,2033,0.0048296,0.0032637,30.38
2,60,1974,2034,0.0052973,0.0035221,29.48
2,61,1974,2035,0.0058480,0.0038301,28.58
2,62,1974,2036,0.0064757,0.0041846,27.69
2,63,1974,2037,0.0071641,0.0045837,26.80
2,64,1974,2038,0.0078986,0.0050121,25.92
2,65,1974,2039,0.0086645,0.0054292,25.05
2,66,1974,2040,0.0094558,0.0058213,24.19
2,67,1974,2041,0.0103010,0.0062228,23.33
2,68,1974,2042,0.0112531,0.0066907,22.47
2,69,1974,2043,0.0123584,0.0072588,21.62
2,70,1974,2044,0.0136702,0.0079569,20.77
2,71,1974,2045,0.0152518,0.0088483,19.93
2,72,1974,2046,0.0170987,0.0099403,19.11
2,73,1974,2047,0.0190837,0.0111163,18.29
2,74,1974,2048,0.0210750,0.0122547,17.49
2,75,1974,2049,0.0231062,0.0133612,16.70
2,76,1974,2050,0.0253497,0.0145924,15.92
2,77,1974,2051,0.0279666,0.0161206,15.15
2,78,1974,2052,0.0310443,0.0180522,14.39
2,79,1974,2053,0.0345982,0.0203966,13.65
2,80,1974,2054,0.0395295,0.0241756,12.92
2,81,1974,2055,0.0438328,0.0270111,12.23
2,82,1974,2056,0.0485928,0.0301740,11.55
2,83,1974,2057,0.0538556,0.0337323,10.90
2,84,1974,2058,0.0596709,0.0377331,10.26
2,85,1974,2059,0.0660929,0.0422133,9.64
2,86,1974,2060,0.0731799,0.0472202,9.05
2,87,1974,2061,0.0809950,0.0528302,8.47
2,88,1974,2062,0.0896059,0.0591367,7.92
2,89,1974,2063,0.0990850,0.0662132,7.38
2,90,1974,2064,0.1095094,0.0741213,6.87
2,91,1974,2065,0.1209607,0.0829388,6.38
2,92,1974,2066,0.1335249,0.0928096,5.91
2,93,1974,2067,0.1472918,0.1039147,5.47
2,94,1974,2068,0.1623547,0.1164065,5.04
2,95,1974,2069,0.1788093,0.1303684,4.64
2,96,1974,2070,0.1967531,0.1459088,4.26
2,97,1974,2071,0.2162837,0.1632393,3.90
2,98,1974,2072,0.2374976,0.1826117,3.57
2,99,1974,2073,0.2604884,0.2042307,3.25
2,100,1974,2074,0.2853445,0.2282122,2.96
2,101,1974,2075,0.3121468,0.2547004,2.68
2,102,1974,2076,0.3409660,0.2839427,2.43
2,103,1974,2077,0.3718598,0.3162006,2.19
2,104,1974,2078,0.4048696,0.3516517,1.98
2,105,1974,2079,0.4400178,0.3903627,1.78
2,106,1974,2080,0.4773042,0.4324087,1.59
2,107,1974,2081,0.5167037,0.4779126,1.43
2,108,1974,2082,0.5581634,0.5269369,1.27
2,109,1974,2083,0.6016004,0.5794127,1.13
2,110,1974,2084,0.6469012,0.6351636,1.01
2,111,1974,2085,0.6939204,0.6939867,0.90
2,112,1974,2086,0.7424819,0.7556168,0.79
2,113,1974,2087,0.7923800,0.8196536,0.70
2,114,1974,2088,0.8433824,0.8855904,0.61
2,115,1974,2089,1.0000000,1.0000000,0.50
2,25,1975,2000,0.0004147,0.0005349,62.67
2,26,1975,2001,0.0004348,0.0005470,61.70
2,27,1975,2002,0.0004528,0.0005579,60.73
2,28,1975,2003,0.0004684,0.0005659,59.77
2,29,1975,2004,0.0004856,0.0005759,58.80
2,30,1975,2005,0.0005091,0.0005921,57.84
2,31,1975,2006,0.0005408,0.0006168,56.87
2,32,1975,2007,0.0005796,0.0006491,55.90
2,33,1975,2008,0.0006220,0.0006850,54.94
2,34,1975,2009,0.0006665,0.0007207,53.98
2,35,1975,2010,0.0007153,0.0007575,53.02
2,36,1975,2011,0.0007710,0.0007986,52.06
2,37,1975,2012,0.0008314,0.0008432,51.10
2,38,1975,2013,0.0008908,0.0008850,50.14
2,39,1975,2014,0.0009481,0.0009209,49.18
2,40,1975,2015,0.0010090,0.0009566,48.23
2,41,1975,2016,0.0010784,0.0009982,47.27
2,42,1975,2017,0.0011559,0.0010469,46.32
2,43,1975,2018,0.0012427,0.0011047,45.37
2,44,1975,2019,0.0013435,0.0011751,44.42
2,45,1975,2020,0.0014588,0.0012548,43.47
2,46,1975,2021,0.0015840,0.0013405,42.52
2,47,1975,2022,0.0017152,0.0014276,41.58
2,48,1975,2023,0.0018531,0.0015181,40.64
2,49,1975,2024,0.0020059,0.0016163,39.70
2,50,1975,2025,0.0021845,0.0017256,38.76
2,51,1975,2026,0.0023896,0.0018458,37.83
2,52,1975,2027,0.0026115,0.0019726,36.90
2,53,1975,2028,0.0028474,0.0021089,35.97
2,54,1975,2029,0.0031082,0.0022660,35.05
2,55,1975,2030,0.0034035,0.0024415,34.12
2,56,1975,2031,0.0037277,0.0026278,33.21
2,57,1975,2032,0.0040692,0.0028108,32.29
2,58,1975,2033,0.0044295,0.0029970,31.38
2,59,1975,2034,0.0048296,0.0032045,30.48
2,60,1975,2035,0.0052973,0.0034530,29.57
2,61,1975,2036,0.0058480,0.0037540,28.67
2,62,1975,2037,0.0064757,0.0041073,27.78
2,63,1975,2038,0.0071641,0.0045067,26.89
2,64,1975,2039,0.0078986,0.0049275,26.01
2,65,1975,2040,0.0086645,0.0053303,25.14
2,66,1975,2041,0.0094558,0.0057130,24.27
2,67,1975,2042,0.0103010,0.0061136,23.41
2,68,1975,2043,0.0112531,0.0065826,22.55
2,69,1975,2044,0.0123584,0.0071401,21.69
2,70,1975,2045,0.0136702,0.0078173,20.85
2,71,1975,2046,0.0152518,0.0086934,20.01
2,72,1975,2047,0.0170987,0.0097819,19.18
2,73,1975,2048,0.0190837,0.0109566,18.36
2,74,1975,2049,0.0210750,0.0120771,17.56
2,75,1975,2050,0.0231062,0.0131532,16.77
2,76,1975,2051,0.0253497,0.0143643,15.98
2,77,1975,2052,0.0279666,0.0158900,15.21
2,78,1975,2053,0.0310443,0.0178210,14.45
2,79,1975,2054,0.0345982,0.0201391,13.70
2,80,1975,2055,0.0395295,0.0238724,12.97
2,81,1975,2056,0.0438328,0.0266779,12.28
2,82,1975,2057,0.0485928,0.0298372,11.60
2,83,1975,2058,0.0538556,0.0333975,10.94
2,84,1975,2059,0.0596709,0.0373650,10.30
2,85,1975,2060,0.0660929,0.0417837,9.68
2,86,1975,2061,0.0731799,0.0467497,9.08
2,87,1975,2062,0.0809950,0.0523565,8.50
2,88,1975,2063,0.0896059,0.0586670,7.95
2,89,1975,2064,0.0990850,0.0656976,7.41
2,90,1975,2065,0.1095094,0.0735229,6.90
2,91,1975,2066,0.1209607,0.0822887,6.40
2,92,1975,2067,0.1335249,0.0921619,5.93
2,93,1975,2068,0.1472918,0.1032828,5.48
2,94,1975,2069,0.1623547,0.1157276,5.06
2,95,1975,2070,0.1788093,0.1295955,4.65
2,96,1975,2071,0.1967531,0.1450853,4.27
2,97,1975,2072,0.2162837,0.1624366,3.91
2,98,1975,2073,0.2374976,0.1818474,3.58
2,99,1975,2074,0.2604884,0.2034321,3.26
2,100,1975,2075,0.2853445,0.2273333,2.96
2,101,1975,2076,0.3121468,0.2538008,2.69
2,102,1975,2077,0.3409660,0.2831067,2.43
2,103,1975,2078,0.3718598,0.3154488,2.20
2,104,1975,2079,0.4048696,0.3509184,1.98
2,105,1975,2080,0.4400178,0.3896208,1.78
2,106,1975,2081,0.4773042,0.4317259,1.60
2,107,1975,2082,0.5167037,0.4773605,1.43
2,108,1975,2083,0.5581634,0.5265278,1.27
2,109,1975,2084,0.6016004,0.5791165,1.14
2,110,1975,2085,0.6469012,0.6349941,1.01
2,111,1975,2086,0.6939204,0.6939877,0.90
2,112,1975,2087,0.7424819,0.7557961,0.79
2,113,1975,2088,0.7923800,0.8199950,0.70
2,114,1975,2089,0.8433824,0.8861269,0.61
2,115,1975,2090,1.0000000,1.0000000,0.50
2,24,1976,2000,0.0003983,0.0005144,63.76
2,25,1976,2001,0.0004147,0.0005230,62.79
2,26,1976,2002,0.0004348,0.0005357,61.83
2,27,1976,2003,0.0004528,0.0005477,60.86
2,28,1976,2004,0.0004684,0.0005560,59.89
2,29,1976,2005,0.0004856,0.0005653,58.93
2,30,1976,2006,0.0005091,0.0005809,57.96
2,31,1976,2007,0.0005408,0.0006058,56.99
2,32,1976,2008,0.0005796,0.0006380,56.03
2,33,1976,2009,0.0006220,0.0006721,55.06
2,34,1976,2010,0.0006665,0.0007055,54.10
2,35,1976,2011,0.0007153,0.0007410,53.14
2,36,1976,2012,0.0007710,0.0007820,52.18
2,37,1976,2013,0.0008314,0.0008259,51.22
2,38,1976,2014,0.0008908,0.0008648,50.26
2,39,1976,2015,0.0009481,0.0008977,49.30
2,40,1976,2016,0.0010090,0.0009325,48.34
2,41,1976,2017,0.0010784,0.0009750,47.39
2,42,1976,2018,0.0011559,0.0010247,46.44
2,43,1976,2019,0.0012427,0.0010812,45.48
2,44,1976,2020,0.0013435,0.0011489,44.53
2,45,1976,2021,0.0014588,0.0012273,43.58
2,46,1976,2022,0.0015840,0.0013137,42.63
2,47,1976,2023,0.0017152,0.0014016,41.69
2,48,1976,2024,0.0018531,0.0014902,40.75
2,49,1976,2025,0.0020059,0.0015842,39.81
2,50,1976,2026,0.0021845,0.0016905,38.87
2,51,1976,2027,0.0023896,0.0018101,37.94
2,52,1976,2028,0.0026115,0.0019370,37.00
2,53,1976,2029,0.0028474,0.0020697,36.07
2,54,1976,2030,0.0031082,0.0022205,35.15
2,55,1976,2031,0.0034035,0.0023919,34.22
2,56,1976,2032,0.0037277,0.0025780,33.31
2,57,1976,2033,0.0040692,0.0027614,32.39
2,58,1976,2034,0.0044295,0.0029428,31.48
2,59,1976,2035,0.0048296,0.0031413,30.57
2,60,1976,2036,0.0052973,0.0033836,29.66
2,61,1976,2037,0.0058480,0.0036837,28.76
2,62,1976,2038,0.0064757,0.0040371,27.87
2,63,1976,2039,0.0071641,0.0044292,26.98
2,64,1976,2040,0.0078986,0.0048369,26.10
2,65,1976,2041,0.0086645,0.0052309,25.22
2,66,1976,2042,0.0094558,0.0056127,24.35
2,67,1976,2043,0.0103010,0.0060145,23.49
2,68,1976,2044,0.0112531,0.0064741,22.63
2,69,1976,2045,0.0123584,0.0070131,21.77
2,70,1976,2046,0.0136702,0.0076769,20.92
2,71,1976,2047,0.0152518,0.0085499,20.08
2,72,1976,2048,0.0170987,0.0096367,19.25
2,73,1976,2049,0.0190837,0.0107941,18.43
2,74,1976,2050,0.0210750,0.0118861,17.62
2,75,1976,2051,0.0231062,0.0129436,16.83
2,76,1976,2052,0.0253497,0.0141526,16.04
2,77,1976,2053,0.0279666,0.0156779,15.27
2,78,1976,2054,0.0310443,0.0175848,14.50
2,79,1976,2055,0.0345982,0.0198614,13.75
2,80,1976,2056,0.0395295,0.0235658,13.02
2,81,1976,2057,0.0438328,0.0263678,12.32
2,82,1976,2058,0.0485928,0.0295286,11.64
2,83,1976,2059,0.0538556,0.0330580,10.98
2,84,1976,2060,0.0596709,0.0369682,10.34
2,85,1976,2061,0.0660929,0.0413482,9.72
2,86,1976,2062,0.0731799,0.0463105,9.12
2,87,1976,2063,0.0809950,0.0519203,8.54
2,88,1976,2064,0.0896059,0.0581873,7.98
2,89,1976,2065,0.0990850,0.0651396,7.44
2,90,1976,2066,0.1095094,0.0729150,6.92
2,91,1976,2067,0.1209607,0.0816810,6.43
2,92,1976,2068,0.1335249,0.0915668,5.95
2,93,1976,2069,0.1472918,0.1026407,5.50
2,94,1976,2070,0.1623547,0.1149930,5.08
2,95,1976,2071,0.1788093,0.1288086,4.67
2,96,1976,2072,0.1967531,0.1443134,4.29
2,97,1976,2073,0.2162837,0.1616965,3.93
2,98,1976,2074,0.2374976,0.1810676,3.59
2,99,1976,2075,0.2604884,0.2025656,3.27
2,100,1976,2076,0.2853445,0.2264365,2.97
2,101,1976,2077,0.3121468,0.2529561,2.70
2,102,1976,2078,0.3409660,0.2823346,2.44
2,103,1976,2079,0.3718598,0.3146805,2.20
2,104,1976,2080,0.4048696,0.3501213,1.98
2,105,1976,2081,0.4400178,0.3888624,1.78
2,106,1976,2082,0.4773042,0.4310834,1.60
2,107,1976,2083,0.5167037,0.4768494,1.43
2,108,1976,2084,0.5581634,0.5261086,1.28
2,109,1976,2085,0.6016004,0.5787939,1.14
2,110,1976,2086,0.6469012,0.6348207,1.01
2,111,1976,2087,0.6939204,0.6939885,0.90
2,112,1976,2088,0.7424819,0.7559625,0.79
2,113,1976,2089,0.7923800,0.8203461,0.70
2,114,1976,2090,0.8433824,0.8867120,0.61
2,115,1976,2091,1.0000000,1.0000000,0.50
2,23,1977,2000,0.0003908,0.0005024,64.85
2,24,1977,2001,0.0003983,0.0005030,63.89
2,25,1977,2002,0.0004147,0.0005122,62.92
2,26,1977,2003,0.0004348,0.0005259,61.95
2,27,1977,2004,0.0004528,0.0005381,60.98
2,28,1977,2005,0.0004684,0.0005457,60.02
2,29,1977,2006,0.0004856,0.0005546,59.05
2,30,1977,2007,0.0005091,0.0005705,58.08
2,31,1977,2008,0.0005408,0.0005954,57.11
2,32,1977,2009,0.0005796,0.0006260,56.15
2,33,1977,2010,0.0006220,0.0006580,55.18
2,34,1977,2011,0.0006665,0.0006902,54.22
2,35,1977,2012,0.0007153,0.0007256,53.26
2,36,1977,2013,0.0007710,0.0007659,52.29
2,37,1977,2014,0.0008314,0.0008068,51.33
2,38,1977,2015,0.0008908,0.0008426,50.37
2,39,1977,2016,0.0009481,0.0008746,49.42
2,40,1977,2017,0.0010090,0.0009103,48.46
2,41,1977,2018,0.0010784,0.0009540,47.50
2,42,1977,2019,0.0011559,0.0010024,46.55
2,43,1977,2020,0.0012427,0.0010562,45.59
2,44,1977,2021,0.0013435,0.0011227,44.64
2,45,1977,2022,0.0014588,0.0012019,43.69
2,46,1977,2023,0.0015840,0.0012893,42.74
2,47,1977,2024,0.0017152,0.0013755,41.80
2,48,1977,2025,0.0018531,0.0014603,40.85
2,49,1977,2026,0.0020059,0.0015519,39.91
2,50,1977,2027,0.0021845,0.0016581,38.98
2,51,1977,2028,0.0023896,0.0017777,38.04
2,52,1977,2029,0.0026115,0.0019011,37.11
2,53,1977,2030,0.0028474,0.0020278,36.18
2,54,1977,2031,0.0031082,0.0021749,35.25
2,55,1977,2032,0.0034035,0.0023462,34.32
2,56,1977,2033,0.0037277,0.0025328,33.40
2,57,1977,2034,0.0040692,0.0027118,32.49
2,58,1977,2035,0.0044295,0.0028849,31.57
2,59,1977,2036,0.0048296,0.0030778,30.66
2,60,1977,2037,0.0052973,0.0033196,29.76
2,61,1977,2038,0.0058480,0.0036197,28.85
2,62,1977,2039,0.0064757,0.0039663,27.96
2,63,1977,2040,0.0071641,0.0043462,27.07
2,64,1977,2041,0.0078986,0.0047459,26.18
2,65,1977,2042,0.0086645,0.0051390,25.31
2,66,1977,2043,0.0094558,0.0055218,24.43
2,67,1977,2044,0.0103010,0.0059150,23.57
2,68,1977,2045,0.0112531,0.0063581,22.70
2,69,1977,2046,0.0123584,0.0068855,21.85
2,70,1977,2047,0.0136702,0.0075469,20.99
2,71,1977,2048,0.0152518,0.0084184,20.15
2,72,1977,2049,0.0170987,0.0094891,19.32
2,73,1977,2050,0.0190837,0.0106194,18.50
2,74,1977,2051,0.0210750,0.0116936,17.69
2,75,1977,2052,0.0231062,0.0127490,16.89
2,76,1977,2053,0.0253497,0.0139579,16.10
2,77,1977,2054,0.0279666,0.0154614,15.33
2,78,1977,2055,0.0310443,0.0173303,14.56
2,79,1977,2056,0.0345982,0.0195809,13.81
2,80,1977,2057,0.0395295,0.0232806,13.07
2,81,1977,2058,0.0438328,0.0260838,12.37
2,82,1977,2059,0.0485928,0.0292159,11.69
2,83,1977,2060,0.0538556,0.0326922,11.03
2,84,1977,2061,0.0596709,0.0365662,10.38
2,85,1977,2062,0.0660929,0.0409419,9.76
2,86,1977,2063,0.0731799,0.0459061,9.15
2,87,1977,2064,0.0809950,0.0514749,8.57
2,88,1977,2065,0.0896059,0.0576685,8.01
2,89,1977,2066,0.0990850,0.0645730,7.47
2,90,1977,2067,0.1095094,0.0723469,6.95
2,91,1977,2068,0.1209607,0.0811229,6.45
2,92,1977,2069,0.1335249,0.0909622,5.98
2,93,1977,2070,0.1472918,0.1019462,5.52
2,94,1977,2071,0.1623547,0.1142455,5.09
2,95,1977,2072,0.1788093,0.1280714,4.69
2,96,1977,2073,0.1967531,0.1436021,4.30
2,97,1977,2074,0.2162837,0.1609416,3.94
2,98,1977,2075,0.2374976,0.1802218,3.60
2,99,1977,2076,0.2604884,0.2016817,3.28
2,100,1977,2077,0.2853445,0.2255946,2.98
2,101,1977,2078,0.3121468,0.2521762,2.70
2,102,1977,2079,0.3409660,0.2815459,2.44
2,103,1977,2080,0.3718598,0.3138458,2.21
2,104,1977,2081,0.4048696,0.3493067,1.99
2,105,1977,2082,0.4400178,0.3881490,1.78
2,106,1977,2083,0.4773042,0.4304889,1.60
2,107,1977,2084,0.5167037,0.4763260,1.43
2,108,1977,2085,0.5581634,0.5256523,1.28
2,109,1977,2086,0.6016004,0.5784638,1.14
2,110,1977,2087,0.6469012,0.6346572,1.01
2,111,1977,2088,0.6939204,0.6939894,0.90
2,112,1977,2089,0.7424819,0.7561336,0.79
2,113,1977,2090,0.7923800,0.8207288,0.70
2,114,1977,2091,0.8433824,0.8873112,0.61
2,115,1977,2092,1.0000000,1.0000000,0.50
2,22,1978,2000,0.0003897,0.0004958,65.95
2,23,1978,2001,0.0003908,0.0004914,64.98
2,24,1978,2002,0.0003983,0.0004925,64.01
2,25,1978,2003,0.0004147,0.0005027,63.04
2,26,1978,2004,0.0004348,0.0005167,62.07
2,27,1978,2005,0.0004528,0.0005280,61.11
2,28,1978,2006,0.0004684,0.0005353,60.14
2,29,1978,2007,0.0004856,0.0005446,59.17
2,30,1978,2008,0.0005091,0.0005607,58.20
2,31,1978,2009,0.0005408,0.0005842,57.23
2,32,1978,2010,0.0005796,0.0006129,56.27
2,33,1978,2011,0.0006220,0.0006439,55.30
2,34,1978,2012,0.0006665,0.0006760,54.34
2,35,1978,2013,0.0007153,0.0007106,53.37
2,36,1978,2014,0.0007710,0.0007482,52.41
2,37,1978,2015,0.0008314,0.0007860,51.45
2,38,1978,2016,0.0008908,0.0008204,50.49
2,39,1978,2017,0.0009481,0.0008533,49.53
2,40,1978,2018,0.0010090,0.0008903,48.57
2,41,1978,2019,0.0010784,0.0009328,47.62
2,42,1978,2020,0.0011559,0.0009786,46.66
2,43,1978,2021,0.0012427,0.0010312,45.71
2,44,1978,2022,0.0013435,0.0010986,44.75
2,45,1978,2023,0.0014588,0.0011788,43.80
2,46,1978,2024,0.0015840,0.0012648,42.85
2,47,1978,2025,0.0017152,0.0013475,41.91
2,48,1978,2026,0.0018531,0.0014303,40.96
2,49,1978,2027,0.0020059,0.0015222,40.02
2,50,1978,2028,0.0021845,0.0016286,39.08
2,51,1978,2029,0.0023896,0.0017451,38.14
2,52,1978,2030,0.0026115,0.0018628,37.21
2,53,1978,2031,0.0028474,0.0019857,36.28
2,54,1978,2032,0.0031082,0.0021328,35.35
2,55,1978,2033,0.0034035,0.0023047,34.42
2,56,1978,2034,0.0037277,0.0024874,33.50
2,57,1978,2035,0.0040692,0.0026589,32.58
2,58,1978,2036,0.0044295,0.0028269,31.67
2,59,1978,2037,0.0048296,0.0030193,30.76
2,60,1978,2038,0.0052973,0.0032613,29.85
2,61,1978,2039,0.0058480,0.0035553,28.94
2,62,1978,2040,0.0064757,0.0038905,28.05
2,63,1978,2041,0.0071641,0.0042629,27.15
2,64,1978,2042,0.0078986,0.0046618,26.27
2,65,1978,2043,0.0086645,0.0050556,25.39
2,66,1978,2044,0.0094558,0.0054305,24.51
2,67,1978,2045,0.0103010,0.0058087,23.65
2,68,1978,2046,0.0112531,0.0062415,22.78
2,69,1978,2047,0.0123584,0.0067673,21.92
2,70,1978,2048,0.0136702,0.0074278,21.07
2,71,1978,2049,0.0152518,0.0082849,20.22
2,72,1978,2050,0.0170987,0.0093305,19.39
2,73,1978,2051,0.0190837,0.0104435,18.56
2,74,1978,2052,0.0210750,0.0115149,17.75
2,75,1978,2053,0.0231062,0.0125702,16.96
2,76,1978,2054,0.0253497,0.0137592,16.16
2,77,1978,2055,0.0279666,0.0152281,15.38
2,78,1978,2056,0.0310443,0.0170734,14.61
2,79,1978,2057,0.0345982,0.0193203,13.86
2,80,1978,2058,0.0395295,0.0230196,13.12
2,81,1978,2059,0.0438328,0.0257961,12.42
2,82,1978,2060,0.0485928,0.0288791,11.73
2,83,1978,2061,0.0538556,0.0323218,11.07
2,84,1978,2062,0.0596709,0.0361912,10.42
2,85,1978,2063,0.0660929,0.0405679,9.79
2,86,1978,2064,0.0731799,0.0454934,9.19
2,87,1978,2065,0.0809950,0.0509933,8.60
2,88,1978,2066,0.0896059,0.0571418,8.04
2,89,1978,2067,0.0990850,0.0640438,7.49
2,90,1978,2068,0.1095094,0.0718254,6.97
2,91,1978,2069,0.1209607,0.0805561,6.47
2,92,1978,2070,0.1335249,0.0903087,6.00
2,93,1978,2071,0.1472918,0.1012398,5.54
2,94,1978,2072,0.1623547,0.1135455,5.11
2,95,1978,2073,0.1788093,0.1273923,4.70
2,96,1978,2074,0.1967531,0.1428769,4.31
2,97,1978,2075,0.2162837,0.1601232,3.95
2,98,1978,2076,0.2374976,0.1793596,3.61
2,99,1978,2077,0.2604884,0.2008524,3.29
2,100,1978,2078,0.2853445,0.2248176,2.99
2,101,1978,2079,0.3121468,0.2513799,2.71
2,102,1978,2080,0.3409660,0.2806894,2.45
2,103,1978,2081,0.3718598,0.3129930,2.21
2,104,1978,2082,0.4048696,0.3485407,1.99
2,105,1978,2083,0.4400178,0.3874890,1.79
2,106,1978,2084,0.4773042,0.4298803,1.60
2,107,1978,2085,0.5167037,0.4757565,1.43
2,108,1978,2086,0.5581634,0.5251854,1.28
2,109,1978,2087,0.6016004,0.5781528,1.14
2,110,1978,2088,0.6469012,0.6345055,1.01
2,111,1978,2089,0.6939204,0.6939902,0.90
2,112,1978,2090,0.7424819,0.7563201,0.79
2,113,1978,2091,0.7923800,0.8211208,0.70
2,114,1978,2092,0.8433824,0.8878759,0.61
2,115,1978,2093,1.0000000,1.0000000,0.50
2,21,1979,2000,0.0003859,0.0004866,67.04
2,22,1979,2001,0.0003897,0.0004854,66.07
2,23,1979,2002,0.0003908,0.0004814,65.10
2,24,1979,2003,0.0003983,0.0004834,64.14
2,25,1979,2004,0.0004147,0.0004938,63.17
2,26,1979,2005,0.0004348,0.0005070,62.20
2,27,1979,2006,0.0004528,0.0005179,61.23
2,28,1979,2007,0.0004684,0.0005256,60.26
2,29,1979,2008,0.0004856,0.0005351,59.29
2,30,1979,2009,0.0005091,0.0005501,58.32
2,31,1979,2010,0.0005408,0.0005720,57.35
2,32,1979,2011,0.0005796,0.0005999,56.39
2,33,1979,2012,0.0006220,0.0006308,55.42
2,34,1979,2013,0.0006665,0.0006622,54.46
2,35,1979,2014,0.0007153,0.0006941,53.49
2,36,1979,2015,0.0007710,0.0007288,52.53
2,37,1979,2016,0.0008314,0.0007651,51.57
2,38,1979,2017,0.0008908,0.0008001,50.61
2,39,1979,2018,0.0009481,0.0008340,49.65
2,40,1979,2019,0.0010090,0.0008702,48.69
2,41,1979,2020,0.0010784,0.0009104,47.73
2,42,1979,2021,0.0011559,0.0009549,46.77
2,43,1979,2022,0.0012427,0.0010081,45.82
2,44,1979,2023,0.0013435,0.0010767,44.86
2,45,1979,2024,0.0014588,0.0011556,43.91
2,46,1979,2025,0.0015840,0.0012386,42.96
2,47,1979,2026,0.0017152,0.0013195,42.01
2,48,1979,2027,0.0018531,0.0014026,41.07
2,49,1979,2028,0.0020059,0.0014951,40.12
2,50,1979,2029,0.0021845,0.0015990,39.18
2,51,1979,2030,0.0023896,0.0017103,38.25
2,52,1979,2031,0.0026115,0.0018243,37.31
2,53,1979,2032,0.0028474,0.0019469,36.38
2,54,1979,2033,0.0031082,0.0020946,35.45
2,55,1979,2034,0.0034035,0.0022631,34.52
2,56,1979,2035,0.0037277,0.0024390,33.60
2,57,1979,2036,0.0040692,0.0026058,32.68
2,58,1979,2037,0.0044295,0.0027732,31.76
2,59,1979,2038,0.0048296,0.0029660,30.85
2,60,1979,2039,0.0052973,0.0032026,29.94
2,61,1979,2040,0.0058480,0.0034864,29.03
2,62,1979,2041,0.0064757,0.0038145,28.13
2,63,1979,2042,0.0071641,0.0041859,27.24
2,64,1979,2043,0.0078986,0.0045854,26.35
2,65,1979,2044,0.0086645,0.0049719,25.47
2,66,1979,2045,0.0094558,0.0053329,24.60
2,67,1979,2046,0.0103010,0.0057018,23.73
2,68,1979,2047,0.0112531,0.0061335,22.86
2,69,1979,2048,0.0123584,0.0066591,22.00
2,70,1979,2049,0.0136702,0.0073069,21.14
2,71,1979,2050,0.0152518,0.0081414,20.29
2,72,1979,2051,0.0170987,0.0091708,19.46
2,73,1979,2052,0.0190837,0.0102802,18.63
2,74,1979,2053,0.0210750,0.0113508,17.82
2,75,1979,2054,0.0231062,0.0123877,17.02
2,76,1979,2055,0.0253497,0.0135453,16.23
2,77,1979,2056,0.0279666,0.0149929,15.44
2,78,1979,2057,0.0310443,0.0168349,14.67
2,79,1979,2058,0.0345982,0.0190821,13.91
2,80,1979,2059,0.0395295,0.0227552,13.17
2,81,1979,2060,0.0438328,0.0254864,12.47
2,82,1979,2061,0.0485928,0.0285382,11.78
2,83,1979,2062,0.0538556,0.0319765,11.11
2,84,1979,2063,0.0596709,0.0358463,10.46
2,85,1979,2064,0.0660929,0.0401865,9.83
2,86,1979,2065,0.0731799,0.0450474,9.22
2,87,1979,2066,0.0809950,0.0505048,8.63
2,88,1979,2067,0.0896059,0.0566502,8.07
2,89,1979,2068,0.0990850,0.0635582,7.52
2,90,1979,2069,0.1095094,0.0712961,7.00
2,91,1979,2070,0.1209607,0.0799437,6.50
2,92,1979,2071,0.1335249,0.0896442,6.02
2,93,1979,2072,0.1472918,0.1005786,5.56
2,94,1979,2073,0.1623547,0.1129009,5.13
2,95,1979,2074,0.1788093,0.1267001,4.72
2,96,1979,2075,0.1967531,0.1420909,4.33
2,97,1979,2076,0.2162837,0.1592892,3.96
2,98,1979,2077,0.2374976,0.1785508,3.62
2,99,1979,2078,0.2604884,0.2000874,3.30
2,100,1979,2079,0.2853445,0.2240246,2.99
2,101,1979,2080,0.3121468,0.2505153,2.71
2,102,1979,2081,0.3409660,0.2798146,2.46
2,103,1979,2082,0.3718598,0.3121915,2.21
2,104,1979,2083,0.4048696,0.3478324,1.99
2,105,1979,2084,0.4400178,0.3868136,1.79
2,106,1979,2085,0.4773042,0.4292181,1.60
2,107,1979,2086,0.5167037,0.4751738,1.43
2,108,1979,2087,0.5581634,0.5247457,1.28
2,109,1979,2088,0.6016004,0.5778643,1.14
2,110,1979,2089,0.6469012,0.6343496,1.01
2,111,1979,2090,0.6939204,0.6939912,0.90
2,112,1979,2091,0.7424819,0.7565110,0.79
2,113,1979,2092,0.7923800,0.8214902,0.70
2,114,1979,2093,0.8433824,0.8884005,0.61
2,115,1979,2094,1.0000000,1.0000000,0.50
2,20,1980,2000,0.0003732,0.0004689,68.13
2,21,1980,2001,0.0003859,0.0004767,67.16
2,22,1980,2002,0.0003897,0.0004758,66.20
2,23,1980,2003,0.0003908,0.0004726,65.23
2,24,1980,2004,0.0003983,0.0004747,64.26
2,25,1980,2005,0.0004147,0.0004845,63.29
2,26,1980,2006,0.0004348,0.0004973,62.32
2,27,1980,2007,0.0004528,0.0005085,61.35
2,28,1980,2008,0.0004684,0.0005165,60.38
2,29,1980,2009,0.0004856,0.0005250,59.41
2,30,1980,2010,0.0005091,0.0005386,58.44
2,31,1980,2011,0.0005408,0.0005598,57.47
2,32,1980,2012,0.0005796,0.0005877,56.51
2,33,1980,2013,0.0006220,0.0006180,55.54
2,34,1980,2014,0.0006665,0.0006470,54.57
2,35,1980,2015,0.0007153,0.0006761,53.61
2,36,1980,2016,0.0007710,0.0007095,52.64
2,37,1980,2017,0.0008314,0.0007460,51.68
2,38,1980,2018,0.0008908,0.0007817,50.72
2,39,1980,2019,0.0009481,0.0008148,49.76
2,40,1980,2020,0.0010090,0.0008488,48.80
2,41,1980,2021,0.0010784,0.0008879,47.84
2,42,1980,2022,0.0011559,0.0009331,46.88
2,43,1980,2023,0.0012427,0.0009872,45.93
2,44,1980,2024,0.0013435,0.0010546,44.97
2,45,1980,2025,0.0014588,0.0011308,44.02
2,46,1980,2026,0.0015840,0.0012123,43.07
2,47,1980,2027,0.0017152,0.0012936,42.12
2,48,1980,2028,0.0018531,0.0013774,41.17
2,49,1980,2029,0.0020059,0.0014678,40.23
2,50,1980,2030,0.0021845,0.0015673,39.29
2,51,1980,2031,0.0023896,0.0016754,38.35
2,52,1980,2032,0.0026115,0.0017888,37.41
2,53,1980,2033,0.0028474,0.0019117,36.48
2,54,1980,2034,0.0031082,0.0020563,35.55
2,55,1980,2035,0.0034035,0.0022187,34.62
2,56,1980,2036,0.0037277,0.0023905,33.69
2,57,1980,2037,0.0040692,0.0025567,32.77
2,58,1980,2038,0.0044295,0.0027245,31.86
2,59,1980,2039,0.0048296,0.0029123,30.94
2,60,1980,2040,0.0052973,0.0031398,30.03
2,61,1980,2041,0.0058480,0.0034172,29.12
2,62,1980,2042,0.0064757,0.0037443,28.22
2,63,1980,2043,0.0071641,0.0041160,27.33
2,64,1980,2044,0.0078986,0.0045088,26.44
2,65,1980,2045,0.0086645,0.0048825,25.55
2,66,1980,2046,0.0094558,0.0052348,24.68
2,67,1980,2047,0.0103010,0.0056029,23.80
2,68,1980,2048,0.0112531,0.0060347,22.94
2,69,1980,2049,0.0123584,0.0065492,22.07
2,70,1980,2050,0.0136702,0.0071771,21.21
2,71,1980,2051,0.0152518,0.0079971,20.36
2,72,1980,2052,0.0170987,0.0090228,19.52
2,73,1980,2053,0.0190837,0.0101303,18.70
2,74,1980,2054,0.0210750,0.0111833,17.88
2,75,1980,2055,0.0231062,0.0121912,17.08
2,76,1980,2056,0.0253497,0.0133296,16.28
2,77,1980,2057,0.0279666,0.0147746,15.50
2,78,1980,2058,0.0310443,0.0166170,14.72
2,79,1980,2059,0.0345982,0.0188412,13.96
2,80,1980,2060,0.0395295,0.0224708,13.22
2,81,1980,2061,0.0438328,0.0251731,12.51
2,82,1980,2062,0.0485928,0.0282205,11.82
2,83,1980,2063,0.0538556,0.0316589,11.15
2,84,1980,2064,0.0596709,0.0354946,10.50
2,85,1980,2065,0.0660929,0.0397744,9.87
2,86,1980,2066,0.0731799,0.0445952,9.26
2,87,1980,2067,0.0809950,0.0500489,8.67
2,88,1980,2068,0.0896059,0.0561992,8.10
2,89,1980,2069,0.0990850,0.0630654,7.55
2,90,1980,2070,0.1095094,0.0707243,7.02
2,91,1980,2071,0.1209607,0.0793213,6.52
2,92,1980,2072,0.1335249,0.0890226,6.04
2,93,1980,2073,0.1472918,0.0999700,5.58
2,94,1980,2074,0.1623547,0.1122442,5.14
2,95,1980,2075,0.1788093,0.1259504,4.73
2,96,1980,2076,0.1967531,0.1412904,4.34
2,97,1980,2077,0.2162837,0.1585073,3.97
2,98,1980,2078,0.2374976,0.1778051,3.63
2,99,1980,2079,0.2604884,0.1993068,3.30
2,100,1980,2080,0.2853445,0.2231639,3.00
2,101,1980,2081,0.3121468,0.2496327,2.72
2,102,1980,2082,0.3409660,0.2789926,2.46
2,103,1980,2083,0.3718598,0.3114505,2.22
2,104,1980,2084,0.4048696,0.3471076,2.00
2,105,1980,2085,0.4400178,0.3860789,1.79
2,106,1980,2086,0.4773042,0.4285408,1.61
2,107,1980,2087,0.5167037,0.4746251,1.43
2,108,1980,2088,0.5581634,0.5243378,1.28
2,109,1980,2089,0.6016004,0.5775678,1.14
2,110,1980,2090,0.6469012,0.6341797,1.01
2,111,1980,2091,0.6939204,0.6939922,0.90
2,112,1980,2092,0.7424819,0.7566910,0.79
2,113,1980,2093,0.7923800,0.8218335,0.70
2,114,1980,2094,0.8433824,0.8889406,0.61
2,115,1980,2095,1.0000000,1.0000000,0.50
2,19,1981,2000,0.0003539,0.0004445,69.23
2,20,1981,2001,0.0003732,0.0004596,68.26
2,21,1981,2002,0.0003859,0.0004677,67.29
2,22,1981,2003,0.0003897,0.0004675,66.32
2,23,1981,2004,0.0003908,0.0004643,65.35
2,24,1981,2005,0.0003983,0.0004657,64.38
2,25,1981,2006,0.0004147,0.0004751,63.41
2,26,1981,2007,0.0004348,0.0004883,62.44
2,27,1981,2008,0.0004528,0.0004996,61.47
2,28,1981,2009,0.0004684,0.0005066,60.50
2,29,1981,2010,0.0004856,0.0005139,59.53
2,30,1981,2011,0.0005091,0.0005270,58.56
2,31,1981,2012,0.0005408,0.0005484,57.59
2,32,1981,2013,0.0005796,0.0005758,56.62
2,33,1981,2014,0.0006220,0.0006040,55.66
2,34,1981,2015,0.0006665,0.0006304,54.69
2,35,1981,2016,0.0007153,0.0006581,53.72
2,36,1981,2017,0.0007710,0.0006918,52.76
2,37,1981,2018,0.0008314,0.0007287,51.79
2,38,1981,2019,0.0008908,0.0007633,50.83
2,39,1981,2020,0.0009481,0.0007942,49.87
2,40,1981,2021,0.0010090,0.0008274,48.91
2,41,1981,2022,0.0010784,0.0008673,47.95
2,42,1981,2023,0.0011559,0.0009133,46.99
2,43,1981,2024,0.0012427,0.0009663,46.03
2,44,1981,2025,0.0013435,0.0010312,45.08
2,45,1981,2026,0.0014588,0.0011060,44.12
2,46,1981,2027,0.0015840,0.0011881,43.17
2,47,1981,2028,0.0017152,0.0012701,42.22
2,48,1981,2029,0.0018531,0.0013521,41.28
2,49,1981,2030,0.0020059,0.0014387,40.33
2,50,1981,2031,0.0021845,0.0015355,39.39
2,51,1981,2032,0.0023896,0.0016431,38.45
2,52,1981,2033,0.0026115,0.0017567,37.51
2,53,1981,2034,0.0028474,0.0018765,36.58
2,54,1981,2035,0.0031082,0.0020155,35.64
2,55,1981,2036,0.0034035,0.0021741,34.71
2,56,1981,2037,0.0037277,0.0023456,33.79
2,57,1981,2038,0.0040692,0.0025121,32.87
2,58,1981,2039,0.0044295,0.0026753,31.95
2,59,1981,2040,0.0048296,0.0028550,31.03
2,60,1981,2041,0.0052973,0.0030769,30.12
2,61,1981,2042,0.0058480,0.0033534,29.21
2,62,1981,2043,0.0064757,0.0036806,28.31
2,63,1981,2044,0.0071641,0.0040460,27.41
2,64,1981,2045,0.0078986,0.0044269,26.52
2,65,1981,2046,0.0086645,0.0047925,25.64
2,66,1981,2047,0.0094558,0.0051440,24.76
2,67,1981,2048,0.0103010,0.0055123,23.88
2,68,1981,2049,0.0112531,0.0059344,23.01
2,69,1981,2050,0.0123584,0.0064313,22.15
2,70,1981,2051,0.0136702,0.0070465,21.29
2,71,1981,2052,0.0152518,0.0078633,20.43
2,72,1981,2053,0.0170987,0.0088868,19.59
2,73,1981,2054,0.0190837,0.0099774,18.76
2,74,1981,2055,0.0210750,0.0110032,17.95
2,75,1981,2056,0.0231062,0.0119933,17.14
2,76,1981,2057,0.0253497,0.0131297,16.34
2,77,1981,2058,0.0279666,0.0145753,15.56
2,78,1981,2059,0.0310443,0.0163968,14.78
2,79,1981,2060,0.0345982,0.0185822,14.02
2,80,1981,2061,0.0395295,0.0221832,13.27
2,81,1981,2062,0.0438328,0.0248813,12.56
2,82,1981,2063,0.0485928,0.0279286,11.87
2,83,1981,2064,0.0538556,0.0313353,11.20
2,84,1981,2065,0.0596709,0.0351149,10.54
2,85,1981,2066,0.0660929,0.0393568,9.91
2,86,1981,2067,0.0731799,0.0441734,9.29
2,87,1981,2068,0.0809950,0.0496310,8.70
2,88,1981,2069,0.0896059,0.0557418,8.13
2,89,1981,2070,0.0990850,0.0625335,7.58
2,90,1981,2071,0.1095094,0.0701435,7.05
2,91,1981,2072,0.1209607,0.0787393,6.54
2,92,1981,2073,0.1335249,0.0884507,6.06
2,93,1981,2074,0.1472918,0.0993502,5.60
2,94,1981,2075,0.1623547,0.1115332,5.16
2,95,1981,2076,0.1788093,0.1251871,4.75
2,96,1981,2077,0.1967531,0.1405402,4.36
2,97,1981,2078,0.2162837,0.1577866,3.99
2,98,1981,2079,0.2374976,0.1770444,3.64
2,99,1981,2080,0.2604884,0.1984600,3.31
2,100,1981,2081,0.2853445,0.2222857,3.01
2,101,1981,2082,0.3121468,0.2488037,2.73
2,102,1981,2083,0.3409660,0.2782331,2.47
2,103,1981,2084,0.3718598,0.3106925,2.22
2,104,1981,2085,0.4048696,0.3463196,2.00
2,105,1981,2086,0.4400178,0.3853278,1.80
2,106,1981,2087,0.4773042,0.4279033,1.61
2,107,1981,2088,0.5167037,0.4741163,1.44
2,108,1981,2089,0.5581634,0.5239187,1.28
2,109,1981,2090,0.6016004,0.5772447,1.14
2,110,1981,2091,0.6469012,0.6340057,1.01
2,111,1981,2092,0.6939204,0.6939931,0.90
2,112,1981,2093,0.7424819,0.7568582,0.79
2,113,1981,2094,0.7923800,0.8221868,0.70
2,114,1981,2095,0.8433824,0.8895297,0.61
2,115,1981,2096,1.0000000,1.0000000,0.50
2,18,1982,2000,0.0003342,0.0004187,70.32
2,19,1982,2001,0.0003539,0.0004357,69.35
2,20,1982,2002,0.0003732,0.0004510,68.38
2,21,1982,2003,0.0003859,0.0004598,67.41
2,22,1982,2004,0.0003897,0.0004596,66.44
2,23,1982,2005,0.0003908,0.0004556,65.47
2,24,1982,2006,0.0003983,0.0004566,64.50
2,25,1982,2007,0.0004147,0.0004663,63.53
2,26,1982,2008,0.0004348,0.0004797,62.56
2,27,1982,2009,0.0004528,0.0004900,61.59
2,28,1982,2010,0.0004684,0.0004958,60.62
2,29,1982,2011,0.0004856,0.0005028,59.65
2,30,1982,2012,0.0005091,0.0005162,58.68
2,31,1982,2013,0.0005408,0.0005374,57.71
2,32,1982,2014,0.0005796,0.0005628,56.74
2,33,1982,2015,0.0006220,0.0005886,55.77
2,34,1982,2016,0.0006665,0.0006138,54.80
2,35,1982,2017,0.0007153,0.0006416,53.84
2,36,1982,2018,0.0007710,0.0006757,52.87
2,37,1982,2019,0.0008314,0.0007114,51.91
2,38,1982,2020,0.0008908,0.0007437,50.94
2,39,1982,2021,0.0009481,0.0007738,49.98
2,40,1982,2022,0.0010090,0.0008078,49.02
2,41,1982,2023,0.0010784,0.0008486,48.06
2,42,1982,2024,0.0011559,0.0008934,47.10
2,43,1982,2025,0.0012427,0.0009439,46.14
2,44,1982,2026,0.0013435,0.0010077,45.18
2,45,1982,2027,0.0014588,0.0010831,44.23
2,46,1982,2028,0.0015840,0.0011661,43.28
2,47,1982,2029,0.0017152,0.0012465,42.33
2,48,1982,2030,0.0018531,0.0013250,41.38
2,49,1982,2031,0.0020059,0.0014095,40.43
2,50,1982,2032,0.0021845,0.0015061,39.49
2,51,1982,2033,0.0023896,0.0016138,38.55
2,52,1982,2034,0.0026115,0.0017244,37.61
2,53,1982,2035,0.0028474,0.0018389,36.67
2,54,1982,2036,0.0031082,0.0019745,35.74
2,55,1982,2037,0.0034035,0.0021330,34.81
2,56,1982,2038,0.0037277,0.0023048,33.88
2,57,1982,2039,0.0040692,0.0024671,32.96
2,58,1982,2040,0.0044295,0.0026228,32.04
2,59,1982,2041,0.0048296,0.0027975,31.12
2,60,1982,2042,0.0052973,0.0030187,30.21
2,61,1982,2043,0.0058480,0.0032955,29.30
2,62,1982,2044,0.0064757,0.0036167,28.40
2,63,1982,2045,0.0071641,0.0039711,27.50
2,64,1982,2046,0.0078986,0.0043446,26.60
2,65,1982,2047,0.0086645,0.0047093,25.72
2,66,1982,2048,0.0094558,0.0050609,24.84
2,67,1982,2049,0.0103010,0.0054203,23.96
2,68,1982,2050,0.0112531,0.0058267,23.09
2,69,1982,2051,0.0123584,0.0063127,22.22
2,70,1982,2052,0.0136702,0.0069256,21.36
2,71,1982,2053,0.0152518,0.0077406,20.51
2,72,1982,2054,0.0170987,0.0087483,19.66
2,73,1982,2055,0.0190837,0.0098130,18.83
2,74,1982,2056,0.0210750,0.0108216,18.01
2,75,1982,2057,0.0231062,0.0118098,17.20
2,76,1982,2058,0.0253497,0.0129472,16.40
2,77,1982,2059,0.0279666,0.0143740,15.61
2,78,1982,2060,0.0310443,0.0161602,14.83
2,79,1982,2061,0.0345982,0.0183207,14.07
2,80,1982,2062,0.0395295,0.0219155,13.32
2,81,1982,2063,0.0438328,0.0246132,12.61
2,82,1982,2064,0.0485928,0.0276312,11.91
2,83,1982,2065,0.0538556,0.0309860,11.24
2,84,1982,2066,0.0596709,0.0347302,10.58
2,85,1982,2067,0.0660929,0.0389675,9.94
2,86,1982,2068,0.0731799,0.0437868,9.33
2,87,1982,2069,0.0809950,0.0492072,8.73
2,88,1982,2070,0.0896059,0.0552482,8.16
2,89,1982,2071,0.0990850,0.0619933,7.61
2,90,1982,2072,0.1095094,0.0696007,7.07
2,91,1982,2073,0.1209607,0.0782041,6.57
2,92,1982,2074,0.1335249,0.0878684,6.08
2,93,1982,2075,0.1472918,0.0986795,5.62
2,94,1982,2076,0.1623547,0.1108096,5.18
2,95,1982,2077,0.1788093,0.1244720,4.76
2,96,1982,2078,0.1967531,0.1398490,4.37
2,97,1982,2079,0.2162837,0.1570518,4.00
2,98,1982,2080,0.2374976,0.1762196,3.65
2,99,1982,2081,0.2604884,0.1975963,3.32
2,100,1982,2082,0.2853445,0.2214611,3.02
2,101,1982,2083,0.3121468,0.2480380,2.73
2,102,1982,2084,0.3409660,0.2774564,2.47
2,103,1982,2085,0.3718598,0.3098687,2.23
2,104,1982,2086,0.4048696,0.3455142,2.00
2,105,1982,2087,0.4400178,0.3846210,1.80
2,106,1982,2088,0.4773042,0.4273123,1.61
2,107,1982,2089,0.5167037,0.4735938,1.44
2,108,1982,2090,0.5581634,0.5234621,1.28
2,109,1982,2091,0.6016004,0.5769140,1.14
2,110,1982,2092,0.6469012,0.6338418,1.01
2,111,1982,2093,0.6939204,0.6939940,0.89
2,112,1982,2094,0.7424819,0.7570303,0.79
2,113,1982,2095,0.7923800,0.8225722,0.70
2,114,1982,2096,0.8433824,0.8901330,0.61
2,115,1982,2097,1.0000000,1.0000000,0.50
2,17,1983,2000,0.0003175,0.0003948,71.42
2,18,1983,2001,0.0003342,0.0004105,70.44
2,19,1983,2002,0.0003539,0.0004276,69.47
2,20,1983,2003,0.0003732,0.0004435,68.50
2,21,1983,2004,0.0003859,0.0004524,67.53
2,22,1983,2005,0.0003897,0.0004514,66.56
2,23,1983,2006,0.0003908,0.0004469,65.59
2,24,1983,2007,0.0003983,0.0004482,64.62
2,25,1983,2008,0.0004147,0.0004580,63.65
2,26,1983,2009,0.0004348,0.0004705,62.68
2,27,1983,2010,0.0004528,0.0004795,61.71
2,28,1983,2011,0.0004684,0.0004851,60.74
2,29,1983,2012,0.0004856,0.0004924,59.77
2,30,1983,2013,0.0005091,0.0005058,58.80
2,31,1983,2014,0.0005408,0.0005252,57.83
2,32,1983,2015,0.0005796,0.0005485,56.86
2,33,1983,2016,0.0006220,0.0005732,55.89
2,34,1983,2017,0.0006665,0.0005986,54.92
2,35,1983,2018,0.0007153,0.0006267,53.95
2,36,1983,2019,0.0007710,0.0006596,52.99
2,37,1983,2020,0.0008314,0.0006930,52.02
2,38,1983,2021,0.0008908,0.0007242,51.06
2,39,1983,2022,0.0009481,0.0007550,50.09
2,40,1983,2023,0.0010090,0.0007900,49.13
2,41,1983,2024,0.0010784,0.0008298,48.17
2,42,1983,2025,0.0011559,0.0008723,47.21
2,43,1983,2026,0.0012427,0.0009216,46.25
2,44,1983,2027,0.0013435,0.0009860,45.29
2,45,1983,2028,0.0014588,0.0010624,44.34
2,46,1983,2029,0.0015840,0.0011440,43.38
2,47,1983,2030,0.0017152,0.0012212,42.43
2,48,1983,2031,0.0018531,0.0012978,41.48
2,49,1983,2032,0.0020059,0.0013825,40.54
2,50,1983,2033,0.0021845,0.0014795,39.59
2,51,1983,2034,0.0023896,0.0015845,38.65
2,52,1983,2035,0.0026115,0.0016900,37.71
2,53,1983,2036,0.0028474,0.0018011,36.77
2,54,1983,2037,0.0031082,0.0019367,35.84
2,55,1983,2038,0.0034035,0.0020956,34.91
2,56,1983,2039,0.0037277,0.0022637,33.98
2,57,1983,2040,0.0040692,0.0024191,33.05
2,58,1983,2041,0.0044295,0.0025701,32.13
2,59,1983,2042,0.0048296,0.0027444,31.22
2,60,1983,2043,0.0052973,0.0029660,30.30
2,61,1983,2044,0.0058480,0.0032374,29.39
2,62,1983,2045,0.0064757,0.0035485,28.48
2,63,1983,2046,0.0071641,0.0038959,27.58
2,64,1983,2047,0.0078986,0.0042684,26.69
2,65,1983,2048,0.0086645,0.0046331,25.80
2,66,1983,2049,0.0094558,0.0049765,24.92
2,67,1983,2050,0.0103010,0.0053217,24.04
2,68,1983,2051,0.0112531,0.0057185,23.17
2,69,1983,2052,0.0123584,0.0062029,22.30
2,70,1983,2053,0.0136702,0.0068147,21.43
2,71,1983,2054,0.0152518,0.0076156,20.58
2,72,1983,2055,0.0170987,0.0085993,19.73
2,73,1983,2056,0.0190837,0.0096474,18.90
2,74,1983,2057,0.0210750,0.0106534,18.08
2,75,1983,2058,0.0231062,0.0116424,17.27
2,76,1983,2059,0.0253497,0.0127629,16.46
2,77,1983,2060,0.0279666,0.0141579,15.67
2,78,1983,2061,0.0310443,0.0159215,14.89
2,79,1983,2062,0.0345982,0.0180777,14.12
2,80,1983,2063,0.0395295,0.0216697,13.37
2,81,1983,2064,0.0438328,0.0243403,12.66
2,82,1983,2065,0.0485928,0.0273103,11.96
2,83,1983,2066,0.0538556,0.0306324,11.28
2,84,1983,2067,0.0596709,0.0343717,10.62
2,85,1983,2068,0.0660929,0.0386108,9.98
2,86,1983,2069,0.0731799,0.0433951,9.36
2,87,1983,2070,0.0809950,0.0487501,8.76
2,88,1983,2071,0.0896059,0.0547472,8.19
2,89,1983,2072,0.0990850,0.0614887,7.63
2,90,1983,2073,0.1095094,0.0691016,7.10
2,91,1983,2074,0.1209607,0.0776594,6.59
2,92,1983,2075,0.1335249,0.0872386,6.10
2,93,1983,2076,0.1472918,0.0979971,5.64
2,94,1983,2077,0.1623547,0.1101322,5.20
2,95,1983,2078,0.1788093,0.1238135,4.78
2,96,1983,2079,0.1967531,0.1391445,4.38
2,97,1983,2080,0.2162837,0.1562553,4.01
2,98,1983,2081,0.2374976,0.1753786,3.66
2,99,1983,2082,0.2604884,0.1967858,3.33
2,100,1983,2083,0.2853445,0.2206998,3.03
2,101,1983,2084,0.3121468,0.2472553,2.74
2,102,1983,2085,0.3409660,0.2766126,2.48
2,103,1983,2086,0.3718598,0.3090271,2.23
2,104,1983,2087,0.4048696,0.3447567,2.01
2,105,1983,2088,0.4400178,0.3839660,1.80
2,106,1983,2089,0.4773042,0.4267054,1.61
2,107,1983,2090,0.5167037,0.4730244,1.44
2,108,1983,2091,0.5581634,0.5229948,1.28
2,109,1983,2092,0.6016004,0.5766023,1.14
2,110,1983,2093,0.6469012,0.6336895,1.01
2,111,1983,2094,0.6939204,0.6939948,0.89
2,112,1983,2095,0.7424819,0.7572181,0.79
2,113,1983,2096,0.7923800,0.8229669,0.70
2,114,1983,2097,0.8433824,0.8907015,0.61
2,115,1983,2098,1.0000000,1.0000000,0.50
2,16,1984,2000,0.0003003,0.0003709,72.51
2,17,1984,2001,0.0003175,0.0003873,71.54
2,18,1984,2002,0.0003342,0.0004030,70.57
2,19,1984,2003,0.0003539,0.0004205,69.60
2,20,1984,2004,0.0003732,0.0004365,68.62
2,21,1984,2005,0.0003859,0.0004446,67.65
2,22,1984,2006,0.0003897,0.0004431,66.68
2,23,1984,2007,0.0003908,0.0004388,65.71
2,24,1984,2008,0.0003983,0.0004402,64.74
2,25,1984,2009,0.0004147,0.0004491,63.77
2,26,1984,2010,0.0004348,0.0004604,62.80
2,27,1984,2011,0.0004528,0.0004691,61.83
2,28,1984,2012,0.0004684,0.0004750,60.86
2,29,1984,2013,0.0004856,0.0004824,59.88
2,30,1984,2014,0.0005091,0.0004942,58.91
2,31,1984,2015,0.0005408,0.0005118,57.94
2,32,1984,2016,0.0005796,0.0005343,56.97
2,33,1984,2017,0.0006220,0.0005591,56.00
2,34,1984,2018,0.0006665,0.0005848,55.03
2,35,1984,2019,0.0007153,0.0006118,54.06
2,36,1984,2020,0.0007710,0.0006426,53.10
2,37,1984,2021,0.0008314,0.0006746,52.13
2,38,1984,2022,0.0008908,0.0007062,51.17
2,39,1984,2023,0.0009481,0.0007379,50.20
2,40,1984,2024,0.0010090,0.0007721,49.24
2,41,1984,2025,0.0010784,0.0008098,48.28
2,42,1984,2026,0.0011559,0.0008511,47.32
2,43,1984,2027,0.0012427,0.0009010,46.35
2,44,1984,2028,0.0013435,0.0009664,45.40
2,45,1984,2029,0.0014588,0.0010415,44.44
2,46,1984,2030,0.0015840,0.0011203,43.49
2,47,1984,2031,0.0017152,0.0011959,42.53
2,48,1984,2032,0.0018531,0.0012728,41.58
2,49,1984,2033,0.0020059,0.0013581,40.64
2,50,1984,2034,0.0021845,0.0014528,39.69
2,51,1984,2035,0.0023896,0.0015532,38.75
2,52,1984,2036,0.0026115,0.0016555,37.81
2,53,1984,2037,0.0028474,0.0017663,36.87
2,54,1984,2038,0.0031082,0.0019023,35.93
2,55,1984,2039,0.0034035,0.0020578,35.00
2,56,1984,2040,0.0037277,0.0022197,34.07
2,57,1984,2041,0.0040692,0.0023708,33.15
2,58,1984,2042,0.0044295,0.0025215,32.22
2,59,1984,2043,0.0048296,0.0026962,31.30
2,60,1984,2044,0.0052973,0.0029132,30.39
2,61,1984,2045,0.0058480,0.0031755,29.48
2,62,1984,2046,0.0064757,0.0034800,28.57
2,63,1984,2047,0.0071641,0.0038263,27.67
2,64,1984,2048,0.0078986,0.0041987,26.77
2,65,1984,2049,0.0086645,0.0045557,25.88
2,66,1984,2050,0.0094558,0.0048860,25.00
2,67,1984,2051,0.0103010,0.0052225,24.12
2,68,1984,2052,0.0112531,0.0056183,23.24
2,69,1984,2053,0.0123584,0.0061023,22.37
2,70,1984,2054,0.0136702,0.0067018,21.50
2,71,1984,2055,0.0152518,0.0074813,20.65
2,72,1984,2056,0.0170987,0.0084495,19.80
2,73,1984,2057,0.0190837,0.0094939,18.96
2,74,1984,2058,0.0210750,0.0105000,18.14
2,75,1984,2059,0.0231062,0.0114734,17.33
2,76,1984,2060,0.0253497,0.0125651,16.52
2,77,1984,2061,0.0279666,0.0139400,15.73
2,78,1984,2062,0.0310443,0.0156998,14.94
2,79,1984,2063,0.0345982,0.0178547,14.17
2,80,1984,2064,0.0395295,0.0214195,13.42
2,81,1984,2065,0.0438328,0.0240460,12.70
2,82,1984,2066,0.0485928,0.0269856,12.00
2,83,1984,2067,0.0538556,0.0303030,11.32
2,84,1984,2068,0.0596709,0.0340435,10.66
2,85,1984,2069,0.0660929,0.0382495,10.02
2,86,1984,2070,0.0731799,0.0429727,9.40
2,87,1984,2071,0.0809950,0.0482864,8.80
2,88,1984,2072,0.0896059,0.0542794,8.22
2,89,1984,2073,0.0990850,0.0610249,7.66
2,90,1984,2074,0.1095094,0.0685939,7.13
2,91,1984,2075,0.1209607,0.0770704,6.61
2,92,1984,2076,0.1335249,0.0865982,6.12
2,93,1984,2077,0.1472918,0.0973585,5.66
2,94,1984,2078,0.1623547,0.1095085,5.21
2,95,1984,2079,0.1788093,0.1231426,4.79
2,96,1984,2080,0.1967531,0.1383813,4.40
2,97,1984,2081,0.2162837,0.1554437,4.02
2,98,1984,2082,0.2374976,0.1745898,3.67
2,99,1984,2083,0.2604884,0.1960376,3.34
2,100,1984,2084,0.2853445,0.2199219,3.03
2,101,1984,2085,0.3121468,0.2464052,2.75
2,102,1984,2086,0.3409660,0.2757508,2.48
2,103,1984,2087,0.3718598,0.3082357,2.24
2,104,1984,2088,0.4048696,0.3440548,2.01
2,105,1984,2089,0.4400178,0.3832935,1.80
2,106,1984,2090,0.4773042,0.4260445,1.61
2,107,1984,2091,0.5167037,0.4724420,1.44
2,108,1984,2092,0.5581634,0.5225547,1.28
2,109,1984,2093,0.6016004,0.5763130,1.14
2,110,1984,2094,0.6469012,0.6335329,1.01
2,111,1984,2095,0.6939204,0.6939958,0.89
2,112,1984,2096,0.7424819,0.7574103,0.79
2,113,1984,2097,0.7923800,0.8233389,0.70
2,114,1984,2098,0.8433824,0.8912292,0.61
2,115,1984,2099,1.0000000,1.0000000,0.50
2,15,1985,2000,0.0002756,0.0003410,73.61
2,16,1985,2001,0.0003003,0.0003640,72.63
2,17,1985,2002,0.0003175,0.0003804,71.66
2,18,1985,2003,0.0003342,0.0003964,70.69
2,19,1985,2004,0.0003539,0.0004138,69.72
2,20,1985,2005,0.0003732,0.0004291,68.74
2,21,1985,2006,0.0003859,0.0004367,67.77
2,22,1985,2007,0.0003897,0.0004354,66.80
2,23,1985,2008,0.0003908,0.0004311,65.83
2,24,1985,2009,0.0003983,0.0004316,64.86
2,25,1985,2010,0.0004147,0.0004394,63.89
2,26,1985,2011,0.0004348,0.0004504,62.92
2,27,1985,2012,0.0004528,0.0004593,61.94
2,28,1985,2013,0.0004684,0.0004653,60.97
2,29,1985,2014,0.0004856,0.0004714,60.00
2,30,1985,2015,0.0005091,0.0004816,59.03
2,31,1985,2016,0.0005408,0.0004985,58.06
2,32,1985,2017,0.0005796,0.0005212,57.09
2,33,1985,2018,0.0006220,0.0005463,56.11
2,34,1985,2019,0.0006665,0.0005710,55.15
2,35,1985,2020,0.0007153,0.0005959,54.18
2,36,1985,2021,0.0007710,0.0006255,53.21
2,37,1985,2022,0.0008314,0.0006578,52.24
2,38,1985,2023,0.0008908,0.0006900,51.28
2,39,1985,2024,0.0009481,0.0007209,50.31
2,40,1985,2025,0.0010090,0.0007532,49.35
2,41,1985,2026,0.0010784,0.0007898,48.38
2,42,1985,2027,0.0011559,0.0008317,47.42
2,43,1985,2028,0.0012427,0.0008824,46.46
2,44,1985,2029,0.0013435,0.0009467,45.50
2,45,1985,2030,0.0014588,0.0010192,44.54
2,46,1985,2031,0.0015840,0.0010966,43.59
2,47,1985,2032,0.0017152,0.0011725,42.64
2,48,1985,2033,0.0018531,0.0012500,41.69
2,49,1985,2034,0.0020059,0.0013336,40.74
2,50,1985,2035,0.0021845,0.0014243,39.79
2,51,1985,2036,0.0023896,0.0015218,38.85
2,52,1985,2037,0.0026115,0.0016237,37.91
2,53,1985,2038,0.0028474,0.0017346,36.97
2,54,1985,2039,0.0031082,0.0018677,36.03
2,55,1985,2040,0.0034035,0.0020176,35.10
2,56,1985,2041,0.0037277,0.0021756,34.17
2,57,1985,2042,0.0040692,0.0023263,33.24
2,58,1985,2043,0.0044295,0.0024774,32.32
2,59,1985,2044,0.0048296,0.0026480,31.39
2,60,1985,2045,0.0052973,0.0028568,30.48
2,61,1985,2046,0.0058480,0.0031132,29.56
2,62,1985,2047,0.0064757,0.0034167,28.65
2,63,1985,2048,0.0071641,0.0037626,27.75
2,64,1985,2049,0.0078986,0.0041280,26.85
2,65,1985,2050,0.0086645,0.0044727,25.96
2,66,1985,2051,0.0094558,0.0047950,25.08
2,67,1985,2052,0.0103010,0.0051307,24.19
2,68,1985,2053,0.0112531,0.0055265,23.32
2,69,1985,2054,0.0123584,0.0059998,22.44
2,70,1985,2055,0.0136702,0.0065805,21.58
2,71,1985,2056,0.0152518,0.0073462,20.72
2,72,1985,2057,0.0170987,0.0083106,19.87
2,73,1985,2058,0.0190837,0.0093540,19.03
2,74,1985,2059,0.0210750,0.0103451,18.20
2,75,1985,2060,0.0231062,0.0112921,17.39
2,76,1985,2061,0.0253497,0.0123659,16.58
2,77,1985,2062,0.0279666,0.0137377,15.78
2,78,1985,2063,0.0310443,0.0154966,14.99
2,79,1985,2064,0.0345982,0.0176281,14.22
2,80,1985,2065,0.0395295,0.0211499,13.47
2,81,1985,2066,0.0438328,0.0237483,12.75
2,82,1985,2067,0.0485928,0.0266834,12.05
2,83,1985,2068,0.0538556,0.0300015,11.36
2,84,1985,2069,0.0596709,0.0337112,10.70
2,85,1985,2070,0.0660929,0.0378601,10.06
2,86,1985,2071,0.0731799,0.0425444,9.43
2,87,1985,2072,0.0809950,0.0478535,8.83
2,88,1985,2073,0.0896059,0.0538496,8.25
2,89,1985,2074,0.0990850,0.0605534,7.69
2,90,1985,2075,0.1095094,0.0680452,7.15
2,91,1985,2076,0.1209607,0.0764718,6.64
2,92,1985,2077,0.1335249,0.0859991,6.15
2,93,1985,2078,0.1472918,0.0967709,5.68
2,94,1985,2079,0.1623547,0.1088733,5.23
2,95,1985,2080,0.1788093,0.1224161,4.81
2,96,1985,2081,0.1967531,0.1376038,4.41
2,97,1985,2082,0.2162837,0.1546826,4.03
2,98,1985,2083,0.2374976,0.1738620,3.68
2,99,1985,2084,0.2604884,0.1952735,3.35
2,100,1985,2085,0.2853445,0.2190773,3.04
2,101,1985,2086,0.3121468,0.2455375,2.75
2,102,1985,2087,0.3409660,0.2749409,2.49
2,103,1985,2088,0.3718598,0.3075027,2.24
2,104,1985,2089,0.4048696,0.3433345,2.01
2,105,1985,2090,0.4400178,0.3825614,1.81
2,106,1985,2091,0.4773042,0.4253685,1.62
2,107,1985,2092,0.5167037,0.4718936,1.44
2,108,1985,2093,0.5581634,0.5221461,1.28
2,109,1985,2094,0.6016004,0.5760152,1.14
2,110,1985,2095,0.6469012,0.6333620,1.01
2,111,1985,2096,0.6939204,0.6939968,0.89
2,112,1985,2097,0.7424819,0.7575915,0.79
2,113,1985,2098,0.7923800,0.8236841,0.70
2,114,1985,2099,0.8433824,0.8917714,0.61
2,115,1985,2100,1.0000000,1.0000000,0.50
2,14,1986,2000,0.0002415,0.0003027,74.71
2,15,1986,2001,0.0002756,0.0003347,73.73
2,16,1986,2002,0.0003003,0.0003578,72.76
2,17,1986,2003,0.0003175,0.0003744,71.78
2,18,1986,2004,0.0003342,0.0003901,70.81
2,19,1986,2005,0.0003539,0.0004068,69.84
2,20,1986,2006,0.0003732,0.0004216,68.86
2,21,1986,2007,0.0003859,0.0004294,67.89
2,22,1986,2008,0.0003897,0.0004281,66.92
2,23,1986,2009,0.0003908,0.0004229,65.95
2,24,1986,2010,0.0003983,0.0004223,64.98
2,25,1986,2011,0.0004147,0.0004297,64.01
2,26,1986,2012,0.0004348,0.0004410,63.03
2,27,1986,2013,0.0004528,0.0004498,62.06
2,28,1986,2014,0.0004684,0.0004546,61.09
2,29,1986,2015,0.0004856,0.0004592,60.12
2,30,1986,2016,0.0005091,0.0004690,59.14
2,31,1986,2017,0.0005408,0.0004863,58.17
2,32,1986,2018,0.0005796,0.0005094,57.20
2,33,1986,2019,0.0006220,0.0005335,56.23
2,34,1986,2020,0.0006665,0.0005563,55.26
2,35,1986,2021,0.0007153,0.0005800,54.29
2,36,1986,2022,0.0007710,0.0006099,53.32
2,37,1986,2023,0.0008314,0.0006426,52.35
2,38,1986,2024,0.0008908,0.0006738,51.38
2,39,1986,2025,0.0009481,0.0007028,50.42
2,40,1986,2026,0.0010090,0.0007342,49.45
2,41,1986,2027,0.0010784,0.0007715,48.49
2,42,1986,2028,0.0011559,0.0008141,47.53
2,43,1986,2029,0.0012427,0.0008637,46.56
2,44,1986,2030,0.0013435,0.0009257,45.60
2,45,1986,2031,0.0014588,0.0009969,44.65
2,46,1986,2032,0.0015840,0.0010748,43.69
2,47,1986,2033,0.0017152,0.0011513,42.74
2,48,1986,2034,0.0018531,0.0012273,41.79
2,49,1986,2035,0.0020059,0.0013074,40.84
2,50,1986,2036,0.0021845,0.0013957,39.89
2,51,1986,2037,0.0023896,0.0014928,38.94
2,52,1986,2038,0.0026115,0.0015947,38.00
2,53,1986,2039,0.0028474,0.0017028,37.06
2,54,1986,2040,0.0031082,0.0018306,36.12
2,55,1986,2041,0.0034035,0.0019771,35.19
2,56,1986,2042,0.0037277,0.0021349,34.26
2,57,1986,2043,0.0040692,0.0022859,33.33
2,58,1986,2044,0.0044295,0.0024332,32.41
2,59,1986,2045,0.0048296,0.0025965,31.48
2,60,1986,2046,0.0052973,0.0028003,30.56
2,61,1986,2047,0.0058480,0.0030557,29.65
2,62,1986,2048,0.0064757,0.0033587,28.74
2,63,1986,2049,0.0071641,0.0036980,27.83
2,64,1986,2050,0.0078986,0.0040521,26.93
2,65,1986,2051,0.0086645,0.0043893,26.04
2,66,1986,2052,0.0094558,0.0047107,25.15
2,67,1986,2053,0.0103010,0.0050466,24.27
2,68,1986,2054,0.0112531,0.0054330,23.39
2,69,1986,2055,0.0123584,0.0058898,22.52
2,70,1986,2056,0.0136702,0.0064586,21.65
2,71,1986,2057,0.0152518,0.0072212,20.78
2,72,1986,2058,0.0170987,0.0081842,19.93
2,73,1986,2059,0.0190837,0.0092129,19.09
2,74,1986,2060,0.0210750,0.0101790,18.27
2,75,1986,2061,0.0231062,0.0111095,17.45
2,76,1986,2062,0.0253497,0.0121809,16.64
2,77,1986,2063,0.0279666,0.0135524,15.84
2,78,1986,2064,0.0310443,0.0152901,15.05
2,79,1986,2065,0.0345982,0.0173841,14.27
2,80,1986,2066,0.0395295,0.0208773,13.52
2,81,1986,2067,0.0438328,0.0234712,12.80
2,82,1986,2068,0.0485928,0.0264068,12.09
2,83,1986,2069,0.0538556,0.0296964,11.41
2,84,1986,2070,0.0596709,0.0333531,10.74
2,85,1986,2071,0.0660929,0.0374655,10.09
2,86,1986,2072,0.0731799,0.0421448,9.47
2,87,1986,2073,0.0809950,0.0474561,8.86
2,88,1986,2074,0.0896059,0.0534128,8.28
2,89,1986,2075,0.0990850,0.0600439,7.72
2,90,1986,2076,0.1095094,0.0674878,7.18
2,91,1986,2077,0.1209607,0.0759121,6.66
2,92,1986,2078,0.1335249,0.0854480,6.17
2,93,1986,2079,0.1472918,0.0961728,5.70
2,94,1986,2080,0.1623547,0.1081858,5.25
2,95,1986,2081,0.1788093,0.1216763,4.82
2,96,1986,2082,0.1967531,0.1368752,4.42
2,97,1986,2083,0.2162837,0.1539807,4.05
2,98,1986,2084,0.2374976,0.1731189,3.69
2,99,1986,2085,0.2604884,0.1944442,3.36
2,100,1986,2086,0.2853445,0.2182156,3.05
2,101,1986,2087,0.3121468,0.2447222,2.76
2,102,1986,2088,0.3409660,0.2741910,2.49
2,103,1986,2089,0.3718598,0.3067508,2.25
2,104,1986,2090,0.4048696,0.3425505,2.02
2,105,1986,2091,0.4400178,0.3818129,1.81
2,106,1986,2092,0.4773042,0.4247322,1.62
2,107,1986,2093,0.5167037,0.4713846,1.44
2,108,1986,2094,0.5581634,0.5217257,1.29
2,109,1986,2095,0.6016004,0.5756906,1.14
2,110,1986,2096,0.6469012,0.6331871,1.01
2,111,1986,2097,0.6939204,0.6939977,0.89
2,112,1986,2098,0.7424819,0.7577596,0.79
2,113,1986,2099,0.7923800,0.8240389,0.69
2,114,1986,2100,0.8433824,0.8923627,0.61
2,115,1986,2101,1.0000000,1.0000000,0.50
2,13,1987,2000,0.0002061,0.0002641,75.81
2,14,1987,2001,0.0002415,0.0002968,74.83
2,15,1987,2002,0.0002756,0.0003289,73.85
2,16,1987,2003,0.0003003,0.0003523,72.88
2,17,1987,2004,0.0003175,0.0003687,71.90
2,18,1987,2005,0.0003342,0.0003836,70.93
2,19,1987,2006,0.0003539,0.0003997,69.95
2,20,1987,2007,0.0003732,0.0004147,68.98
2,21,1987,2008,0.0003859,0.0004225,68.01
2,22,1987,2009,0.0003897,0.0004202,67.04
2,23,1987,2010,0.0003908,0.0004139,66.07
2,24,1987,2011,0.0003983,0.0004129,65.09
2,25,1987,2012,0.0004147,0.0004207,64.12
2,26,1987,2013,0.0004348,0.0004319,63.15
2,27,1987,2014,0.0004528,0.0004394,62.18
2,28,1987,2015,0.0004684,0.0004429,61.20
2,29,1987,2016,0.0004856,0.0004472,60.23
2,30,1987,2017,0.0005091,0.0004575,59.26
2,31,1987,2018,0.0005408,0.0004752,58.28
2,32,1987,2019,0.0005796,0.0004975,57.31
2,33,1987,2020,0.0006220,0.0005199,56.34
2,34,1987,2021,0.0006665,0.0005417,55.37
2,35,1987,2022,0.0007153,0.0005655,54.40
2,36,1987,2023,0.0007710,0.0005958,53.43
2,37,1987,2024,0.0008314,0.0006273,52.46
2,38,1987,2025,0.0008908,0.0006565,51.49
2,39,1987,2026,0.0009481,0.0006847,50.53
2,40,1987,2027,0.0010090,0.0007168,49.56
2,41,1987,2028,0.0010784,0.0007549,48.59
2,42,1987,2029,0.0011559,0.0007964,47.63
2,43,1987,2030,0.0012427,0.0008438,46.67
2,44,1987,2031,0.0013435,0.0009046,45.71
2,45,1987,2032,0.0014588,0.0009763,44.75
2,46,1987,2033,0.0015840,0.0010550,43.79
2,47,1987,2034,0.0017152,0.0011301,42.84
2,48,1987,2035,0.0018531,0.0012030,41.89
2,49,1987,2036,0.0020059,0.0012811,40.94
2,50,1987,2037,0.0021845,0.0013693,39.99
2,51,1987,2038,0.0023896,0.0014665,39.04
2,52,1987,2039,0.0026115,0.0015655,38.10
2,53,1987,2040,0.0028474,0.0016687,37.16
2,54,1987,2041,0.0031082,0.0017935,36.22
2,55,1987,2042,0.0034035,0.0019398,35.28
2,56,1987,2043,0.0037277,0.0020979,34.35
2,57,1987,2044,0.0040692,0.0022454,33.42
2,58,1987,2045,0.0044295,0.0023860,32.50
2,59,1987,2046,0.0048296,0.0025448,31.57
2,60,1987,2047,0.0052973,0.0027479,30.65
2,61,1987,2048,0.0058480,0.0030031,29.73
2,62,1987,2049,0.0064757,0.0032999,28.82
2,63,1987,2050,0.0071641,0.0036288,27.92
2,64,1987,2051,0.0078986,0.0039758,27.02
2,65,1987,2052,0.0086645,0.0043121,26.12
2,66,1987,2053,0.0094558,0.0046335,25.23
2,67,1987,2054,0.0103010,0.0049609,24.35
2,68,1987,2055,0.0112531,0.0053326,23.47
2,69,1987,2056,0.0123584,0.0057792,22.59
2,70,1987,2057,0.0136702,0.0063459,21.72
2,71,1987,2058,0.0152518,0.0071074,20.85
2,72,1987,2059,0.0170987,0.0080566,20.00
2,73,1987,2060,0.0190837,0.0090616,19.16
2,74,1987,2061,0.0210750,0.0100117,18.33
2,75,1987,2062,0.0231062,0.0109401,17.51
2,76,1987,2063,0.0253497,0.0120116,16.70
2,77,1987,2064,0.0279666,0.0133642,15.89
2,78,1987,2065,0.0310443,0.0150680,15.10
2,79,1987,2066,0.0345982,0.0171378,14.33
2,80,1987,2067,0.0395295,0.0206238,13.57
2,81,1987,2068,0.0438328,0.0232179,12.84
2,82,1987,2069,0.0485928,0.0261270,12.14
2,83,1987,2070,0.0538556,0.0293678,11.45
2,84,1987,2071,0.0596709,0.0329904,10.78
2,85,1987,2072,0.0660929,0.0370975,10.13
2,86,1987,2073,0.0731799,0.0417780,9.50
2,87,1987,2074,0.0809950,0.0470523,8.89
2,88,1987,2075,0.0896059,0.0529411,8.31
2,89,1987,2076,0.0990850,0.0595266,7.74
2,90,1987,2077,0.1095094,0.0669668,7.20
2,91,1987,2078,0.1209607,0.0753974,6.68
2,92,1987,2079,0.1335249,0.0848873,6.19
2,93,1987,2080,0.1472918,0.0955255,5.71
2,94,1987,2081,0.1623547,0.1074860,5.27
2,95,1987,2082,0.1788093,0.1209833,4.84
2,96,1987,2083,0.1967531,0.1362034,4.44
2,97,1987,2084,0.2162837,0.1532644,4.06
2,98,1987,2085,0.2374976,0.1723129,3.70
2,99,1987,2086,0.2604884,0.1935985,3.37
2,100,1987,2087,0.2853445,0.2174063,3.06
2,101,1987,2088,0.3121468,0.2439677,2.77
2,102,1987,2089,0.3409660,0.2734219,2.50
2,103,1987,2090,0.3718598,0.3059327,2.25
2,104,1987,2091,0.4048696,0.3417493,2.02
2,105,1987,2092,0.4400178,0.3811086,1.81
2,106,1987,2093,0.4773042,0.4241417,1.62
2,107,1987,2094,0.5167037,0.4708610,1.45
2,108,1987,2095,0.5581634,0.5212675,1.29
2,109,1987,2096,0.6016004,0.5753582,1.14
2,110,1987,2097,0.6469012,0.6330222,1.01
2,111,1987,2098,0.6939204,0.6939985,0.89
2,112,1987,2099,0.7424819,0.7579324,0.79
2,113,1987,2100,0.7923800,0.8244257,0.69
2,114,1987,2101,0.8433824,0.8929681,0.61
2,115,1987,2102,1.0000000,1.0000000,0.50
2,12,1988,2000,0.0001783,0.0002346,76.91
2,13,1988,2001,0.0002061,0.0002584,75.93
2,14,1988,2002,0.0002415,0.0002913,74.95
2,15,1988,2003,0.0002756,0.0003238,73.97
2,16,1988,2004,0.0003003,0.0003471,73.00
2,17,1988,2005,0.0003175,0.0003627,72.02
2,18,1988,2006,0.0003342,0.0003770,71.05
2,19,1988,2007,0.0003539,0.0003932,70.07
2,20,1988,2008,0.0003732,0.0004080,69.10
2,21,1988,2009,0.0003859,0.0004150,68.13
2,22,1988,2010,0.0003897,0.0004116,67.16
2,23,1988,2011,0.0003908,0.0004048,66.18
2,24,1988,2012,0.0003983,0.0004041,65.21
2,25,1988,2013,0.0004147,0.0004119,64.24
2,26,1988,2014,0.0004348,0.0004219,63.26
2,27,1988,2015,0.0004528,0.0004280,62.29
2,28,1988,2016,0.0004684,0.0004312,61.32
2,29,1988,2017,0.0004856,0.0004361,60.34
2,30,1988,2018,0.0005091,0.0004470,59.37
2,31,1988,2019,0.0005408,0.0004641,58.39
2,32,1988,2020,0.0005796,0.0004849,57.42
2,33,1988,2021,0.0006220,0.0005064,56.45
2,34,1988,2022,0.0006665,0.0005283,55.48
2,35,1988,2023,0.0007153,0.0005524,54.51
2,36,1988,2024,0.0007710,0.0005816,53.54
2,37,1988,2025,0.0008314,0.0006111,52.57
2,38,1988,2026,0.0008908,0.0006393,51.60
2,39,1988,2027,0.0009481,0.0006680,50.63
2,40,1988,2028,0.0010090,0.0007010,49.67
2,41,1988,2029,0.0010784,0.0007382,48.70
2,42,1988,2030,0.0011559,0.0007776,47.74
2,43,1988,2031,0.0012427,0.0008238,46.77
2,44,1988,2032,0.0013435,0.0008852,45.81
2,45,1988,2033,0.0014588,0.0009577,44.85
2,46,1988,2034,0.0015840,0.0010351,43.89
2,47,1988,2035,0.0017152,0.0011074,42.94
2,48,1988,2036,0.0018531,0.0011786,41.98
2,49,1988,2037,0.0020059,0.0012569,41.03
2,50,1988,2038,0.0021845,0.0013453,40.08
2,51,1988,2039,0.0023896,0.0014399,39.14
2,52,1988,2040,0.0026115,0.0015343,38.19
2,53,1988,2041,0.0028474,0.0016345,37.25
2,54,1988,2042,0.0031082,0.0017592,36.31
2,55,1988,2043,0.0034035,0.0019059,35.37
2,56,1988,2044,0.0037277,0.0020609,34.44
2,57,1988,2045,0.0040692,0.0022022,33.51
2,58,1988,2046,0.0044295,0.0023387,32.58
2,59,1988,2047,0.0048296,0.0024970,31.66
2,60,1988,2048,0.0052973,0.0027001,30.74
2,61,1988,2049,0.0058480,0.0029498,29.82
2,62,1988,2050,0.0064757,0.0032369,28.91
2,63,1988,2051,0.0071641,0.0035592,28.00
2,64,1988,2052,0.0078986,0.0039052,27.10
2,65,1988,2053,0.0086645,0.0042413,26.20
2,66,1988,2054,0.0094558,0.0045549,25.31
2,67,1988,2055,0.0103010,0.0048690,24.42
2,68,1988,2056,0.0112531,0.0052318,23.54
2,69,1988,2057,0.0123584,0.0056770,22.66
2,70,1988,2058,0.0136702,0.0062432,21.79
2,71,1988,2059,0.0152518,0.0069926,20.92
2,72,1988,2060,0.0170987,0.0079199,20.07
2,73,1988,2061,0.0190837,0.0089092,19.22
2,74,1988,2062,0.0210750,0.0098566,18.39
2,75,1988,2063,0.0231062,0.0107850,17.57
2,76,1988,2064,0.0253497,0.0118397,16.76
2,77,1988,2065,0.0279666,0.0131619,15.95
2,78,1988,2066,0.0310443,0.0148439,15.16
2,79,1988,2067,0.0345982,0.0169090,14.38
2,80,1988,2068,0.0395295,0.0203921,13.62
2,81,1988,2069,0.0438328,0.0229617,12.89
2,82,1988,2070,0.0485928,0.0258259,12.18
2,83,1988,2071,0.0538556,0.0290351,11.49
2,84,1988,2072,0.0596709,0.0326524,10.82
2,85,1988,2073,0.0660929,0.0367599,10.17
2,86,1988,2074,0.0731799,0.0414056,9.53
2,87,1988,2075,0.0809950,0.0466165,8.93
2,88,1988,2076,0.0896059,0.0524623,8.34
2,89,1988,2077,0.0990850,0.0590433,7.77
2,90,1988,2078,0.1095094,0.0664880,7.23
2,91,1988,2079,0.1209607,0.0748740,6.71
2,92,1988,2080,0.1335249,0.0842808,6.21
2,93,1988,2081,0.1472918,0.0948670,5.73
2,94,1988,2082,0.1623547,0.1068308,5.28
2,95,1988,2083,0.1788093,0.1203447,4.85
2,96,1988,2084,0.1967531,0.1355181,4.45
2,97,1988,2085,0.2162837,0.1524877,4.07
2,98,1988,2086,0.2374976,0.1714911,3.71
2,99,1988,2087,0.2604884,0.1928045,3.38
2,100,1988,2088,0.2853445,0.2166576,3.06
2,101,1988,2089,0.3121468,0.2431941,2.77
2,102,1988,2090,0.3409660,0.2725855,2.50
2,103,1988,2091,0.3718598,0.3050970,2.25
2,104,1988,2092,0.4048696,0.3409956,2.03
2,105,1988,2093,0.4400178,0.3804551,1.81
2,106,1988,2094,0.4773042,0.4235346,1.62
2,107,1988,2095,0.5167037,0.4702904,1.45
2,108,1988,2096,0.5581634,0.5207985,1.29
2,109,1988,2097,0.6016004,0.5750452,1.14
2,110,1988,2098,0.6469012,0.6328693,1.01
2,111,1988,2099,0.6939204,0.6939995,0.89
2,112,1988,2100,0.7424819,0.7581208,0.79
2,113,1988,2101,0.7923800,0.8248218,0.69
2,114,1988,2102,0.8433824,0.8935379,0.61
2,115,1988,2103,1.0000000,1.0000000,0.50
2,11,1989,2000,0.0001596,0.0002158,78.02
2,12,1989,2001,0.0001783,0.0002290,77.03
2,13,1989,2002,0.0002061,0.0002531,76.05
2,14,1989,2003,0.0002415,0.0002865,75.07
2,15,1989,2004,0.0002756,0.0003190,74.09
2,16,1989,2005,0.0003003,0.0003416,73.11
2,17,1989,2006,0.0003175,0.0003567,72.14
2,18,1989,2007,0.0003342,0.0003709,71.16
2,19,1989,2008,0.0003539,0.0003869,70.19
2,20,1989,2009,0.0003732,0.0004009,69.22
2,21,1989,2010,0.0003859,0.0004068,68.24
2,22,1989,2011,0.0003897,0.0004030,67.27
2,23,1989,2012,0.0003908,0.0003964,66.30
2,24,1989,2013,0.0003983,0.0003957,65.33
2,25,1989,2014,0.0004147,0.0004023,64.35
2,26,1989,2015,0.0004348,0.0004109,63.38
2,27,1989,2016,0.0004528,0.0004166,62.40
2,28,1989,2017,0.0004684,0.0004204,61.43
2,29,1989,2018,0.0004856,0.0004260,60.45
2,30,1989,2019,0.0005091,0.0004365,59.48
2,31,1989,2020,0.0005408,0.0004524,58.50
2,32,1989,2021,0.0005796,0.0004723,57.53
2,33,1989,2022,0.0006220,0.0004939,56.56
2,34,1989,2023,0.0006665,0.0005161,55.59
2,35,1989,2024,0.0007153,0.0005392,54.61
2,36,1989,2025,0.0007710,0.0005666,53.64
2,37,1989,2026,0.0008314,0.0005949,52.67
2,38,1989,2027,0.0008908,0.0006235,51.70
2,39,1989,2028,0.0009481,0.0006530,50.74
2,40,1989,2029,0.0010090,0.0006852,49.77
2,41,1989,2030,0.0010784,0.0007205,48.80
2,42,1989,2031,0.0011559,0.0007588,47.84
2,43,1989,2032,0.0012427,0.0008055,46.87
2,44,1989,2033,0.0013435,0.0008677,45.91
2,45,1989,2034,0.0014588,0.0009391,44.95
2,46,1989,2035,0.0015840,0.0010140,43.99
2,47,1989,2036,0.0017152,0.0010847,43.04
2,48,1989,2037,0.0018531,0.0011560,42.08
2,49,1989,2038,0.0020059,0.0012348,41.13
2,50,1989,2039,0.0021845,0.0013211,40.18
2,51,1989,2040,0.0023896,0.0014115,39.23
2,52,1989,2041,0.0026115,0.0015031,38.29
2,53,1989,2042,0.0028474,0.0016030,37.35
2,54,1989,2043,0.0031082,0.0017281,36.40
2,55,1989,2044,0.0034035,0.0018720,35.47
2,56,1989,2045,0.0037277,0.0020214,34.53
2,57,1989,2046,0.0040692,0.0021589,33.60
2,58,1989,2047,0.0044295,0.0022949,32.67
2,59,1989,2048,0.0048296,0.0024533,31.75
2,60,1989,2049,0.0052973,0.0026516,30.82
2,61,1989,2050,0.0058480,0.0028926,29.90
2,62,1989,2051,0.0064757,0.0031737,28.99
2,63,1989,2052,0.0071641,0.0034948,28.08
2,64,1989,2053,0.0078986,0.0038405,27.18
2,65,1989,2054,0.0086645,0.0041692,26.28
2,66,1989,2055,0.0094558,0.0044705,25.39
2,67,1989,2056,0.0103010,0.0047766,24.50
2,68,1989,2057,0.0112531,0.0051385,23.61
2,69,1989,2058,0.0123584,0.0055839,22.73
2,70,1989,2059,0.0136702,0.0061398,21.86
2,71,1989,2060,0.0152518,0.0068698,20.99
2,72,1989,2061,0.0170987,0.0077824,20.13
2,73,1989,2062,0.0190837,0.0087680,19.29
2,74,1989,2063,0.0210750,0.0097146,18.45
2,75,1989,2064,0.0231062,0.0106276,17.63
2,76,1989,2065,0.0253497,0.0116550,16.81
2,77,1989,2066,0.0279666,0.0129579,16.01
2,78,1989,2067,0.0310443,0.0146359,15.21
2,79,1989,2068,0.0345982,0.0167001,14.43
2,80,1989,2069,0.0395295,0.0201579,13.66
2,81,1989,2070,0.0438328,0.0226862,12.93
2,82,1989,2071,0.0485928,0.0255211,12.22
2,83,1989,2072,0.0538556,0.0287252,11.53
2,84,1989,2073,0.0596709,0.0323423,10.86
2,85,1989,2074,0.0660929,0.0364172,10.20
2,86,1989,2075,0.0731799,0.0410037,9.57
2,87,1989,2076,0.0809950,0.0461743,8.96
2,88,1989,2077,0.0896059,0.0520153,8.37
2,89,1989,2078,0.0990850,0.0585993,7.80
2,90,1989,2079,0.1095094,0.0660012,7.25
2,91,1989,2080,0.1209607,0.0743080,6.73
2,92,1989,2081,0.1335249,0.0836641,6.23
2,93,1989,2082,0.1472918,0.0942507,5.75
2,94,1989,2083,0.1623547,0.1062272,5.30
2,95,1989,2084,0.1788093,0.1196934,4.87
2,96,1989,2085,0.1967531,0.1347754,4.46
2,97,1989,2086,0.2162837,0.1516962,4.08
2,98,1989,2087,0.2374976,0.1707200,3.72
2,99,1989,2088,0.2604884,0.1920702,3.39
2,100,1989,2089,0.2853445,0.2158903,3.07
2,101,1989,2090,0.3121468,0.2423532,2.78
2,102,1989,2091,0.3409660,0.2717314,2.51
2,103,1989,2092,0.3718598,0.3043110,2.26
2,104,1989,2093,0.4048696,0.3402966,2.03
2,105,1989,2094,0.4400178,0.3797835,1.82
2,106,1989,2095,0.4773042,0.4228731,1.62
2,107,1989,2096,0.5167037,0.4697067,1.45
2,108,1989,2097,0.5581634,0.5203569,1.29
2,109,1989,2098,0.6016004,0.5747548,1.14
2,110,1989,2099,0.6469012,0.6327122,1.01
2,111,1989,2100,0.6939204,0.6940004,0.89
2,112,1989,2101,0.7424819,0.7583137,0.79
2,113,1989,2102,0.7923800,0.8251947,0.69
2,114,1989,2103,0.8433824,0.8940636,0.61
2,115,1989,2104,1.0000000,1.0000000,0.50
2,10,1990,2000,0.0001465,0.0002045,79.12
2,11,1990,2001,0.0001596,0.0002102,78.13
2,12,1990,2002,0.0001783,0.0002239,77.15
2,13,1990,2003,0.0002061,0.0002486,76.17
2,14,1990,2004,0.0002415,0.0002820,75.19
2,15,1990,2005,0.0002756,0.0003139,74.21
2,16,1990,2006,0.0003003,0.0003362,73.23
2,17,1990,2007,0.0003175,0.0003511,72.26
2,18,1990,2008,0.0003342,0.0003650,71.28
2,19,1990,2009,0.0003539,0.0003801,70.31
2,20,1990,2010,0.0003732,0.0003932,69.33
2,21,1990,2011,0.0003859,0.0003986,68.36
2,22,1990,2012,0.0003897,0.0003950,67.39
2,23,1990,2013,0.0003908,0.0003883,66.41
2,24,1990,2014,0.0003983,0.0003864,65.44
2,25,1990,2015,0.0004147,0.0003917,64.46
2,26,1990,2016,0.0004348,0.0004000,63.49
2,27,1990,2017,0.0004528,0.0004062,62.51
2,28,1990,2018,0.0004684,0.0004107,61.54
2,29,1990,2019,0.0004856,0.0004160,60.56
2,30,1990,2020,0.0005091,0.0004254,59.59
2,31,1990,2021,0.0005408,0.0004406,58.61
2,32,1990,2022,0.0005796,0.0004607,57.64
2,33,1990,2023,0.0006220,0.0004827,56.67
2,34,1990,2024,0.0006665,0.0005039,55.69
2,35,1990,2025,0.0007153,0.0005252,54.72
2,36,1990,2026,0.0007710,0.0005516,53.75
2,37,1990,2027,0.0008314,0.0005801,52.78
2,38,1990,2028,0.0008908,0.0006092,51.81
2,39,1990,2029,0.0009481,0.0006379,50.84
2,40,1990,2030,0.0010090,0.0006684,49.87
2,41,1990,2031,0.0010784,0.0007028,48.91
2,42,1990,2032,0.0011559,0.0007415,47.94
2,43,1990,2033,0.0012427,0.0007889,46.98
2,44,1990,2034,0.0013435,0.0008502,46.01
2,45,1990,2035,0.0014588,0.0009192,45.05
2,46,1990,2036,0.0015840,0.0009928,44.09
2,47,1990,2037,0.0017152,0.0010637,43.14
2,48,1990,2038,0.0018531,0.0011356,42.18
2,49,1990,2039,0.0020059,0.0012126,41.23
2,50,1990,2040,0.0021845,0.0012953,40.28
2,51,1990,2041,0.0023896,0.0013830,39.33
2,52,1990,2042,0.0026115,0.0014742,38.38
2,53,1990,2043,0.0028474,0.0015744,37.44
2,54,1990,2044,0.0031082,0.0016970,36.50
2,55,1990,2045,0.0034035,0.0018358,35.56
2,56,1990,2046,0.0037277,0.0019817,34.62
2,57,1990,2047,0.0040692,0.0021188,33.69
2,58,1990,2048,0.0044295,0.0022549,32.76
2,59,1990,2049,0.0048296,0.0024091,31.83
2,60,1990,2050,0.0052973,0.0025997,30.91
2,61,1990,2051,0.0058480,0.0028352,29.99
2,62,1990,2052,0.0064757,0.0031151,29.07
2,63,1990,2053,0.0071641,0.0034358,28.16
2,64,1990,2054,0.0078986,0.0037746,27.26
2,65,1990,2055,0.0086645,0.0040918,26.36
2,66,1990,2056,0.0094558,0.0043857,25.46
2,67,1990,2057,0.0103010,0.0046911,24.57
2,68,1990,2058,0.0112531,0.0050536,23.69
2,69,1990,2059,0.0123584,0.0054902,22.81
2,70,1990,2060,0.0136702,0.0060291,21.93
2,71,1990,2061,0.0152518,0.0067462,21.06
2,72,1990,2062,0.0170987,0.0076550,20.20
2,73,1990,2063,0.0190837,0.0086388,19.35
2,74,1990,2064,0.0210750,0.0095706,18.51
2,75,1990,2065,0.0231062,0.0104586,17.69
2,76,1990,2066,0.0253497,0.0114689,16.87
2,77,1990,2067,0.0279666,0.0127687,16.06
2,78,1990,2068,0.0310443,0.0144461,15.26
2,79,1990,2069,0.0345982,0.0164892,14.48
2,80,1990,2070,0.0395295,0.0199060,13.71
2,81,1990,2071,0.0438328,0.0224074,12.98
2,82,1990,2072,0.0485928,0.0252373,12.27
2,83,1990,2073,0.0538556,0.0284410,11.57
2,84,1990,2074,0.0596709,0.0320278,10.90
2,85,1990,2075,0.0660929,0.0360476,10.24
2,86,1990,2076,0.0731799,0.0405962,9.60
2,87,1990,2077,0.0809950,0.0457615,8.99
2,88,1990,2078,0.0896059,0.0516047,8.40
2,89,1990,2079,0.0990850,0.0581481,7.83
2,90,1990,2080,0.1095094,0.0654751,7.28
2,91,1990,2081,0.1209607,0.0737328,6.75
2,92,1990,2082,0.1335249,0.0830871,6.25
2,93,1990,2083,0.1472918,0.0936833,5.77
2,94,1990,2084,0.1623547,0.1056119,5.32
2,95,1990,2085,0.1788093,0.1189879,4.89
2,96,1990,2086,0.1967531,0.1340188,4.48
2,97,1990,2087,0.2162837,0.1509539,4.09
2,98,1990,2088,0.2374976,0.1700072,3.73
2,99,1990,2089,0.2604884,0.1913181,3.40
2,100,1990,2090,0.2853445,0.2150565,3.08
2,101,1990,2091,0.3121468,0.2414948,2.79
2,102,1990,2092,0.3409660,0.2709285,2.51
2,103,1990,2093,0.3718598,0.3035824,2.26
2,104,1990,2094,0.4048696,0.3395784,2.03
2,105,1990,2095,0.4400178,0.3790519,1.82
2,106,1990,2096,0.4773042,0.4221966,1.63
2,107,1990,2097,0.5167037,0.4691571,1.45
2,108,1990,2098,0.5581634,0.5199473,1.29
2,109,1990,2099,0.6016004,0.5744566,1.14
2,110,1990,2100,0.6469012,0.6325409,1.01
2,111,1990,2101,0.6939204,0.6940014,0.89
2,112,1990,2102,0.7424819,0.7584953,0.79
2,113,1990,2103,0.7923800,0.8255386,0.69
2,114,1990,2104,0.8433824,0.8945987,0.61
2,115,1990,2105,1.0000000,1.0000000,0.50
2,9,1991,2000,0.0001377,0.0001986,80.22
2,10,1991,2001,0.0001465,0.0001986,79.24
2,11,1991,2002,0.0001596,0.0002050,78.25
2,12,1991,2003,0.0001783,0.0002194,77.27
2,13,1991,2004,0.0002061,0.0002443,76.28
2,14,1991,2005,0.0002415,0.0002773,75.30
2,15,1991,2006,0.0002756,0.0003088,74.32
2,16,1991,2007,0.0003003,0.0003310,73.35
2,17,1991,2008,0.0003175,0.0003457,72.37
2,18,1991,2009,0.0003342,0.0003587,71.40
2,19,1991,2010,0.0003539,0.0003728,70.42
2,20,1991,2011,0.0003732,0.0003854,69.45
2,21,1991,2012,0.0003859,0.0003910,68.47
2,22,1991,2013,0.0003897,0.0003872,67.50
2,23,1991,2014,0.0003908,0.0003793,66.53
2,24,1991,2015,0.0003983,0.0003762,65.55
2,25,1991,2016,0.0004147,0.0003812,64.58
2,26,1991,2017,0.0004348,0.0003900,63.60
2,27,1991,2018,0.0004528,0.0003968,62.63
2,28,1991,2019,0.0004684,0.0004009,61.65
2,29,1991,2020,0.0004856,0.0004053,60.67
2,30,1991,2021,0.0005091,0.0004143,59.70
2,31,1991,2022,0.0005408,0.0004298,58.72
2,32,1991,2023,0.0005796,0.0004503,57.75
2,33,1991,2024,0.0006220,0.0004714,56.77
2,34,1991,2025,0.0006665,0.0004910,55.80
2,35,1991,2026,0.0007153,0.0005113,54.83
2,36,1991,2027,0.0007710,0.0005378,53.86
2,37,1991,2028,0.0008314,0.0005667,52.88
2,38,1991,2029,0.0008908,0.0005949,51.91
2,39,1991,2030,0.0009481,0.0006219,50.94
2,40,1991,2031,0.0010090,0.0006517,49.98
2,41,1991,2032,0.0010784,0.0006865,49.01
2,42,1991,2033,0.0011559,0.0007259,48.04
2,43,1991,2034,0.0012427,0.0007724,47.08
2,44,1991,2035,0.0013435,0.0008315,46.11
2,45,1991,2036,0.0014588,0.0008993,45.15
2,46,1991,2037,0.0015840,0.0009732,44.19
2,47,1991,2038,0.0017152,0.0010446,43.23
2,48,1991,2039,0.0018531,0.0011149,42.28
2,49,1991,2040,0.0020059,0.0011888,41.32
2,50,1991,2041,0.0021845,0.0012693,40.37
2,51,1991,2042,0.0023896,0.0013567,39.42
2,52,1991,2043,0.0026115,0.0014480,38.48
2,53,1991,2044,0.0028474,0.0015458,37.53
2,54,1991,2045,0.0031082,0.0016638,36.59
2,55,1991,2046,0.0034035,0.0017994,35.65
2,56,1991,2047,0.0037277,0.0019450,34.71
2,57,1991,2048,0.0040692,0.0020821,33.78
2,58,1991,2049,0.0044295,0.0022143,32.85
2,59,1991,2050,0.0048296,0.0023616,31.92
2,60,1991,2051,0.0052973,0.0025476,30.99
2,61,1991,2052,0.0058480,0.0027822,30.07
2,62,1991,2053,0.0064757,0.0030615,29.15
2,63,1991,2054,0.0071641,0.0033757,28.24
2,64,1991,2055,0.0078986,0.0037039,27.34
2,65,1991,2056,0.0086645,0.0040141,26.44
2,66,1991,2057,0.0094558,0.0043073,25.54
2,67,1991,2058,0.0103010,0.0046134,24.65
2,68,1991,2059,0.0112531,0.0049681,23.76
2,69,1991,2060,0.0123584,0.0053899,22.88
2,70,1991,2061,0.0136702,0.0059179,22.00
2,71,1991,2062,0.0152518,0.0066318,21.13
2,72,1991,2063,0.0170987,0.0075385,20.26
2,73,1991,2064,0.0190837,0.0085078,19.41
2,74,1991,2065,0.0210750,0.0094159,18.58
2,75,1991,2066,0.0231062,0.0102882,17.75
2,76,1991,2067,0.0253497,0.0112964,16.93
2,77,1991,2068,0.0279666,0.0125962,16.12
2,78,1991,2069,0.0310443,0.0142547,15.31
2,79,1991,2070,0.0345982,0.0162628,14.53
2,80,1991,2071,0.0395295,0.0196514,13.76
2,81,1991,2072,0.0438328,0.0221479,13.03
2,82,1991,2073,0.0485928,0.0249773,12.31
2,83,1991,2074,0.0538556,0.0281529,11.61
2,84,1991,2075,0.0596709,0.0316887,10.94
2,85,1991,2076,0.0660929,0.0356729,10.28
2,86,1991,2077,0.0731799,0.0402161,9.64
2,87,1991,2078,0.0809950,0.0453827,9.02
2,88,1991,2079,0.0896059,0.0511876,8.43
2,89,1991,2080,0.0990850,0.0576606,7.85
2,90,1991,2081,0.1095094,0.0649406,7.30
2,91,1991,2082,0.1209607,0.0731949,6.78
2,92,1991,2083,0.1335249,0.0825560,6.27
2,93,1991,2084,0.1472918,0.0931050,5.79
2,94,1991,2085,0.1623547,0.1049457,5.33
2,95,1991,2086,0.1788093,0.1182695,4.90
2,96,1991,2087,0.1967531,0.1333095,4.49
2,97,1991,2088,0.2162837,0.1502679,4.11
2,98,1991,2089,0.2374976,0.1692773,3.74
2,99,1991,2090,0.2604884,0.1905010,3.40
2,100,1991,2091,0.2853445,0.2142057,3.09
2,101,1991,2092,0.3121468,0.2406882,2.79
2,102,1991,2093,0.3409660,0.2701845,2.52
2,103,1991,2094,0.3718598,0.3028340,2.27
2,104,1991,2095,0.4048696,0.3387963,2.04
2,105,1991,2096,0.4400178,0.3783040,1.82
2,106,1991,2097,0.4773042,0.4215599,1.63
2,107,1991,2098,0.5167037,0.4686476,1.45
2,108,1991,2099,0.5581634,0.5195267,1.29
2,109,1991,2100,0.6016004,0.5741315,1.14
2,110,1991,2101,0.6469012,0.6323656,1.01
2,111,1991,2102,0.6939204,0.6940023,0.89
2,112,1991,2103,0.7424819,0.7586628,0.79
2,113,1991,2104,0.7923800,0.8258887,0.69
2,114,1991,2105,0.8433824,0.8951802,0.60
2,115,1991,2106,1.0000000,1.0000000,0.50
2,8,1992,2000,0.0001336,0.0001994,81.32
2,9,1992,2001,0.0001377,0.0001923,80.34
2,10,1992,2002,0.0001465,0.0001932,79.35
2,11,1992,2003,0.0001596,0.0002005,78.37
2,12,1992,2004,0.0001783,0.0002152,77.38
2,13,1992,2005,0.0002061,0.0002398,76.40
2,14,1992,2006,0.0002415,0.0002725,75.42
2,15,1992,2007,0.0002756,0.0003041,74.44
2,16,1992,2008,0.0003003,0.0003261,73.46
2,17,1992,2009,0.0003175,0.0003400,72.49
2,18,1992,2010,0.0003342,0.0003519,71.51
2,19,1992,2011,0.0003539,0.0003654,70.54
2,20,1992,2012,0.0003732,0.0003781,69.56
2,21,1992,2013,0.0003859,0.0003835,68.59
2,22,1992,2014,0.0003897,0.0003786,67.61
2,23,1992,2015,0.0003908,0.0003695,66.64
2,24,1992,2016,0.0003983,0.0003660,65.66
2,25,1992,2017,0.0004147,0.0003715,64.69
2,26,1992,2018,0.0004348,0.0003809,63.71
2,27,1992,2019,0.0004528,0.0003873,62.73
2,28,1992,2020,0.0004684,0.0003906,61.76
2,29,1992,2021,0.0004856,0.0003947,60.78
2,30,1992,2022,0.0005091,0.0004041,59.81
2,31,1992,2023,0.0005408,0.0004200,58.83
2,32,1992,2024,0.0005796,0.0004398,57.86
2,33,1992,2025,0.0006220,0.0004594,56.88
2,34,1992,2026,0.0006665,0.0004781,55.91
2,35,1992,2027,0.0007153,0.0004985,54.93
2,36,1992,2028,0.0007710,0.0005253,53.96
2,37,1992,2029,0.0008314,0.0005532,52.99
2,38,1992,2030,0.0008908,0.0005796,52.02
2,39,1992,2031,0.0009481,0.0006060,51.05
2,40,1992,2032,0.0010090,0.0006363,50.08
2,41,1992,2033,0.0010784,0.0006718,49.11
2,42,1992,2034,0.0011559,0.0007103,48.14
2,43,1992,2035,0.0012427,0.0007547,47.18
2,44,1992,2036,0.0013435,0.0008128,46.21
2,45,1992,2037,0.0014588,0.0008809,45.25
2,46,1992,2038,0.0015840,0.0009554,44.29
2,47,1992,2039,0.0017152,0.0010254,43.33
2,48,1992,2040,0.0018531,0.0010929,42.37
2,49,1992,2041,0.0020059,0.0011650,41.42
2,50,1992,2042,0.0021845,0.0012454,40.47
2,51,1992,2043,0.0023896,0.0013329,39.52
2,52,1992,2044,0.0026115,0.0014218,38.57
2,53,1992,2045,0.0028474,0.0015152,37.62
2,54,1992,2046,0.0031082,0.0016304,36.68
2,55,1992,2047,0.0034035,0.0017658,35.74
2,56,1992,2048,0.0037277,0.0019115,34.80
2,57,1992,2049,0.0040692,0.0020449,33.87
2,58,1992,2050,0.0044295,0.0021709,32.94
2,59,1992,2051,0.0048296,0.0023140,32.01
2,60,1992,2052,0.0052973,0.0024993,31.08
2,61,1992,2053,0.0058480,0.0027336,30.16
2,62,1992,2054,0.0064757,0.0030070,29.24
2,63,1992,2055,0.0071641,0.0033113,28.32
2,64,1992,2056,0.0078986,0.0036329,27.42
2,65,1992,2057,0.0086645,0.0039423,26.51
2,66,1992,2058,0.0094558,0.0042359,25.62
2,67,1992,2059,0.0103010,0.0045351,24.72
2,68,1992,2060,0.0112531,0.0048767,23.83
2,69,1992,2061,0.0123584,0.0052891,22.95
2,70,1992,2062,0.0136702,0.0058149,22.07
2,71,1992,2063,0.0152518,0.0065273,21.19
2,72,1992,2064,0.0170987,0.0074204,20.33
2,73,1992,2065,0.0190837,0.0083671,19.48
2,74,1992,2066,0.0210750,0.0092601,18.64
2,75,1992,2067,0.0231062,0.0101304,17.81
2,76,1992,2068,0.0253497,0.0111391,16.98
2,77,1992,2069,0.0279666,0.0124222,16.17
2,78,1992,2070,0.0310443,0.0140492,15.37
2,79,1992,2071,0.0345982,0.0160341,14.58
2,80,1992,2072,0.0395295,0.0194145,13.81
2,81,1992,2073,0.0438328,0.0219103,13.07
2,82,1992,2074,0.0485928,0.0247137,12.35
2,83,1992,2075,0.0538556,0.0278424,11.65
2,84,1992,2076,0.0596709,0.0313451,10.97
2,85,1992,2077,0.0660929,0.0353236,10.31
2,86,1992,2078,0.0731799,0.0398672,9.67
2,87,1992,2079,0.0809950,0.0449979,9.05
2,88,1992,2080,0.0896059,0.0507372,8.46
2,89,1992,2081,0.0990850,0.0571656,7.88
2,90,1992,2082,0.1095094,0.0644409,7.33
2,91,1992,2083,0.1209607,0.0727000,6.80
2,92,1992,2084,0.1335249,0.0820151,6.29
2,93,1992,2085,0.1472918,0.0924791,5.81
2,94,1992,2086,0.1623547,0.1042676,5.35
2,95,1992,2087,0.1788093,0.1175963,4.92
2,96,1992,2088,0.1967531,0.1326543,4.51
2,97,1992,2089,0.2162837,0.1495657,4.12
2,98,1992,2090,0.2374976,0.1684847,3.75
2,99,1992,2091,0.2604884,0.1896677,3.41
2,100,1992,2092,0.2853445,0.2134066,3.10
2,101,1992,2093,0.3121468,0.2399410,2.80
2,102,1992,2094,0.3409660,0.2694205,2.53
2,103,1992,2095,0.3718598,0.3020194,2.27
2,104,1992,2096,0.4048696,0.3379971,2.04
2,105,1992,2097,0.4400178,0.3776003,1.83
2,106,1992,2098,0.4773042,0.4209697,1.63
2,107,1992,2099,0.5167037,0.4681243,1.45
2,108,1992,2100,0.5581634,0.5190684,1.29
2,109,1992,2101,0.6016004,0.5737988,1.14
2,110,1992,2102,0.6469012,0.6322006,1.01
2,111,1992,2103,0.6939204,0.6940032,0.89
2,112,1992,2104,0.7424819,0.7588332,0.79
2,113,1992,2105,0.7923800,0.8262691,0.69
2,114,1992,2106,0.8433824,0.8957756,0.60
2,115,1992,2107,1.0000000,1.0000000,0.50
2,7,1993,2000,0.0001348,0.0002079,82.42
2,8,1993,2001,0.0001336,0.0001925,81.44
2,9,1993,2002,0.0001377,0.0001866,80.46
2,10,1993,2003,0.0001465,0.0001885,79.47
2,11,1993,2004,0.0001596,0.0001963,78.48
2,12,1993,2005,0.0001783,0.0002108,77.50
2,13,1993,2006,0.0002061,0.0002353,76.52
2,14,1993,2007,0.0002415,0.0002680,75.53
2,15,1993,2008,0.0002756,0.0002995,74.55
2,16,1993,2009,0.0003003,0.0003209,73.58
2,17,1993,2010,0.0003175,0.0003337,72.60
2,18,1993,2011,0.0003342,0.0003450,71.62
2,19,1993,2012,0.0003539,0.0003585,70.65
2,20,1993,2013,0.0003732,0.0003710,69.67
2,21,1993,2014,0.0003859,0.0003753,68.70
2,22,1993,2015,0.0003897,0.0003692,67.73
2,23,1993,2016,0.0003908,0.0003597,66.75
2,24,1993,2017,0.0003983,0.0003567,65.77
2,25,1993,2018,0.0004147,0.0003627,64.80
2,26,1993,2019,0.0004348,0.0003718,63.82
2,27,1993,2020,0.0004528,0.0003772,62.84
2,28,1993,2021,0.0004684,0.0003803,61.87
2,29,1993,2022,0.0004856,0.0003849,60.89
2,30,1993,2023,0.0005091,0.0003949,59.91
2,31,1993,2024,0.0005408,0.0004103,58.94
2,32,1993,2025,0.0005796,0.0004287,57.96
2,33,1993,2026,0.0006220,0.0004474,56.99
2,34,1993,2027,0.0006665,0.0004663,56.01
2,35,1993,2028,0.0007153,0.0004869,55.04
2,36,1993,2029,0.0007710,0.0005129,54.06
2,37,1993,2030,0.0008314,0.0005390,53.09
2,38,1993,2031,0.0008908,0.0005645,52.12
2,39,1993,2032,0.0009481,0.0005913,51.15
2,40,1993,2033,0.0010090,0.0006223,50.18
2,41,1993,2034,0.0010784,0.0006571,49.21
2,42,1993,2035,0.0011559,0.0006937,48.24
2,43,1993,2036,0.0012427,0.0007371,47.27
2,44,1993,2037,0.0013435,0.0007956,46.31
2,45,1993,2038,0.0014588,0.0008643,45.35
2,46,1993,2039,0.0015840,0.0009375,44.38
2,47,1993,2040,0.0017152,0.0010049,43.43
2,48,1993,2041,0.0018531,0.0010708,42.47
2,49,1993,2042,0.0020059,0.0011430,41.51
2,50,1993,2043,0.0021845,0.0012236,40.56
2,51,1993,2044,0.0023896,0.0013090,39.61
2,52,1993,2045,0.0026115,0.0013939,38.66
2,53,1993,2046,0.0028474,0.0014846,37.71
2,54,1993,2047,0.0031082,0.0015996,36.77
2,55,1993,2048,0.0034035,0.0017351,35.83
2,56,1993,2049,0.0037277,0.0018775,34.89
2,57,1993,2050,0.0040692,0.0020051,33.95
2,58,1993,2051,0.0044295,0.0021273,33.02
2,59,1993,2052,0.0048296,0.0022700,32.09
2,60,1993,2053,0.0052973,0.0024552,31.16
2,61,1993,2054,0.0058480,0.0026842,30.24
2,62,1993,2055,0.0064757,0.0029486,29.32
2,63,1993,2056,0.0071641,0.0032467,28.40
2,64,1993,2057,0.0078986,0.0035673,27.49
2,65,1993,2058,0.0086645,0.0038769,26.59
2,66,1993,2059,0.0094558,0.0041641,25.69
2,67,1993,2060,0.0103010,0.0044514,24.80
2,68,1993,2061,0.0112531,0.0047848,23.91
2,69,1993,2062,0.0123584,0.0051958,23.02
2,70,1993,2063,0.0136702,0.0057208,22.14
2,71,1993,2064,0.0152518,0.0064214,21.26
2,72,1993,2065,0.0170987,0.0072937,20.40
2,73,1993,2066,0.0190837,0.0082255,19.54
2,74,1993,2067,0.0210750,0.0091158,18.70
2,75,1993,2068,0.0231062,0.0099866,17.87
2,76,1993,2069,0.0253497,0.0109806,17.04
2,77,1993,2070,0.0279666,0.0122357,16.23
2,78,1993,2071,0.0310443,0.0138419,15.42
2,79,1993,2072,0.0345982,0.0158216,14.63
2,80,1993,2073,0.0395295,0.0191977,13.86
2,81,1993,2074,0.0438328,0.0216695,13.12
2,82,1993,2075,0.0485928,0.0244298,12.40
2,83,1993,2076,0.0538556,0.0275279,11.70
2,84,1993,2077,0.0596709,0.0310249,11.01
2,85,1993,2078,0.0660929,0.0350032,10.35
2,86,1993,2079,0.0731799,0.0395131,9.71
2,87,1993,2080,0.0809950,0.0445827,9.09
2,88,1993,2081,0.0896059,0.0502800,8.49
2,89,1993,2082,0.0990850,0.0567031,7.91
2,90,1993,2083,0.1095094,0.0639814,7.35
2,91,1993,2084,0.1209607,0.0721961,6.82
2,92,1993,2085,0.1335249,0.0814299,6.31
2,93,1993,2086,0.1472918,0.0918424,5.83
2,94,1993,2087,0.1623547,0.1036325,5.37
2,95,1993,2088,0.1788093,0.1169747,4.93
2,96,1993,2089,0.1967531,0.1319840,4.52
2,97,1993,2090,0.2162837,0.1488036,4.13
2,98,1993,2091,0.2374976,0.1676767,3.76
2,99,1993,2092,0.2604884,0.1888854,3.42
2,100,1993,2093,0.2853445,0.2126667,3.10
2,101,1993,2094,0.3121468,0.2391741,2.81
2,102,1993,2095,0.3409660,0.2685892,2.53
2,103,1993,2096,0.3718598,0.3011872,2.28
2,104,1993,2097,0.4048696,0.3372454,2.04
2,105,1993,2098,0.4400178,0.3769483,1.83
2,106,1993,2099,0.4773042,0.4203638,1.63
2,107,1993,2100,0.5167037,0.4675544,1.45
2,108,1993,2101,0.5581634,0.5185993,1.29
2,109,1993,2102,0.6016004,0.5734857,1.15
2,110,1993,2103,0.6469012,0.6320484,1.01
2,111,1993,2104,0.6939204,0.6940041,0.89
2,112,1993,2105,0.7424819,0.7590185,0.79
2,113,1993,2106,0.7923800,0.8266587,0.69
2,114,1993,2107,0.8433824,0.8963369,0.60
2,115,1993,2108,1.0000000,1.0000000,0.50
2,6,1994,2000,0.0001399,0.0002231,83.52
2,7,1994,2001,0.0001348,0.0002002,82.54
2,8,1994,2002,0.0001336,0.0001863,81.56
2,9,1994,2003,0.0001377,0.0001817,80.57
2,10,1994,2004,0.0001465,0.0001842,79.59
2,11,1994,2005,0.0001596,0.0001919,78.60
2,12,1994,2006,0.0001783,0.0002064,77.61
2,13,1994,2007,0.0002061,0.0002310,76.63
2,14,1994,2008,0.0002415,0.0002638,75.65
2,15,1994,2009,0.0002756,0.0002947,74.67
2,16,1994,2010,0.0003003,0.0003151,73.69
2,17,1994,2011,0.0003175,0.0003273,72.71
2,18,1994,2012,0.0003342,0.0003385,71.74
2,19,1994,2013,0.0003539,0.0003518,70.76
2,20,1994,2014,0.0003732,0.0003632,69.79
2,21,1994,2015,0.0003859,0.0003663,68.81
2,22,1994,2016,0.0003897,0.0003598,67.84
2,23,1994,2017,0.0003908,0.0003507,66.86
2,24,1994,2018,0.0003983,0.0003482,65.88
2,25,1994,2019,0.0004147,0.0003540,64.91
2,26,1994,2020,0.0004348,0.0003621,63.93
2,27,1994,2021,0.0004528,0.0003672,62.95
2,28,1994,2022,0.0004684,0.0003708,61.97
2,29,1994,2023,0.0004856,0.0003760,61.00
2,30,1994,2024,0.0005091,0.0003856,60.02
2,31,1994,2025,0.0005408,0.0003998,59.04
2,32,1994,2026,0.0005796,0.0004175,58.07
2,33,1994,2027,0.0006220,0.0004364,57.09
2,34,1994,2028,0.0006665,0.0004555,56.12
2,35,1994,2029,0.0007153,0.0004753,55.14
2,36,1994,2030,0.0007710,0.0004996,54.17
2,37,1994,2031,0.0008314,0.0005247,53.19
2,38,1994,2032,0.0008908,0.0005505,52.22
2,39,1994,2033,0.0009481,0.0005780,51.25
2,40,1994,2034,0.0010090,0.0006085,50.28
2,41,1994,2035,0.0010784,0.0006415,49.31
2,42,1994,2036,0.0011559,0.0006771,48.34
2,43,1994,2037,0.0012427,0.0007209,47.37
2,44,1994,2038,0.0013435,0.0007799,46.41
2,45,1994,2039,0.0014588,0.0008475,45.44
2,46,1994,2040,0.0015840,0.0009183,44.48
2,47,1994,2041,0.0017152,0.0009843,43.52
2,48,1994,2042,0.0018531,0.0010504,42.56
2,49,1994,2043,0.0020059,0.0011230,41.61
2,50,1994,2044,0.0021845,0.0012019,40.65
2,51,1994,2045,0.0023896,0.0012835,39.70
2,52,1994,2046,0.0026115,0.0013658,38.75
2,53,1994,2047,0.0028474,0.0014563,37.81
2,54,1994,2048,0.0031082,0.0015714,36.86
2,55,1994,2049,0.0034035,0.0017040,35.92
2,56,1994,2050,0.0037277,0.0018410,34.98
2,57,1994,2051,0.0040692,0.0019651,34.04
2,58,1994,2052,0.0044295,0.0020869,33.11
2,59,1994,2053,0.0048296,0.0022297,32.18
2,60,1994,2054,0.0052973,0.0024104,31.25
2,61,1994,2055,0.0058480,0.0026312,30.32
2,62,1994,2056,0.0064757,0.0028899,29.40
2,63,1994,2057,0.0071641,0.0031869,28.48
2,64,1994,2058,0.0078986,0.0035076,27.57
2,65,1994,2059,0.0086645,0.0038110,26.67
2,66,1994,2060,0.0094558,0.0040872,25.77
2,67,1994,2061,0.0103010,0.0043673,24.87
2,68,1994,2062,0.0112531,0.0046998,23.98
2,69,1994,2063,0.0123584,0.0051106,23.09
2,70,1994,2064,0.0136702,0.0056256,22.21
2,71,1994,2065,0.0152518,0.0063078,21.33
2,72,1994,2066,0.0170987,0.0071662,20.46
2,73,1994,2067,0.0190837,0.0080943,19.60
2,74,1994,2068,0.0210750,0.0089843,18.76
2,75,1994,2069,0.0231062,0.0098416,17.93
2,76,1994,2070,0.0253497,0.0108106,17.10
2,77,1994,2071,0.0279666,0.0120475,16.28
2,78,1994,2072,0.0310443,0.0136494,15.47
2,79,1994,2073,0.0345982,0.0156274,14.68
2,80,1994,2074,0.0395295,0.0189781,13.90
2,81,1994,2075,0.0438328,0.0214103,13.16
2,82,1994,2076,0.0485928,0.0241424,12.44
2,83,1994,2077,0.0538556,0.0272350,11.74
2,84,1994,2078,0.0596709,0.0307313,11.05
2,85,1994,2079,0.0660929,0.0346781,10.39
2,86,1994,2080,0.0731799,0.0391311,9.74
2,87,1994,2081,0.0809950,0.0441613,9.12
2,88,1994,2082,0.0896059,0.0498530,8.52
2,89,1994,2083,0.0990850,0.0562779,7.94
2,90,1994,2084,0.1095094,0.0635138,7.38
2,91,1994,2085,0.1209607,0.0716512,6.85
2,92,1994,2086,0.1335249,0.0808348,6.34
2,93,1994,2087,0.1472918,0.0912463,5.85
2,94,1994,2088,0.1623547,0.1030462,5.39
2,95,1994,2089,0.1788093,0.1163391,4.95
2,96,1994,2090,0.1967531,0.1312567,4.53
2,97,1994,2091,0.2162837,0.1480270,4.14
2,98,1994,2092,0.2374976,0.1669185,3.78
2,99,1994,2093,0.2604884,0.1881612,3.43
2,100,1994,2094,0.2853445,0.2119075,3.11
2,101,1994,2095,0.3121468,0.2383399,2.81
2,102,1994,2096,0.3409660,0.2677403,2.54
2,103,1994,2097,0.3718598,0.3004048,2.28
2,104,1994,2098,0.4048696,0.3365491,2.05
2,105,1994,2099,0.4400178,0.3762791,1.83
2,106,1994,2100,0.4773042,0.4197041,1.63
2,107,1994,2101,0.5167037,0.4669714,1.46
2,108,1994,2102,0.5581634,0.5181581,1.29
2,109,1994,2103,0.6016004,0.5731971,1.15
2,110,1994,2104,0.6469012,0.6318936,1.01
2,111,1994,2105,0.6939204,0.6940050,0.89
2,112,1994,2106,0.7424819,0.7592081,0.79
2,113,1994,2107,0.7923800,0.8270261,0.69
2,114,1994,2108,0.8433824,0.8968592,0.60
2,115,1994,2109,1.0000000,1.0000000,0.50
2,5,1995,2000,0.0001465,0.0002422,84.62
2,6,1995,2001,0.0001399,0.0002141,83.64
2,7,1995,2002,0.0001348,0.0001931,82.65
2,8,1995,2003,0.0001336,0.0001809,81.67
2,9,1995,2004,0.0001377,0.0001770,80.69
2,10,1995,2005,0.0001465,0.0001796,79.70
2,11,1995,2006,0.0001596,0.0001875,78.71
2,12,1995,2007,0.0001783,0.0002024,77.73
2,13,1995,2008,0.0002061,0.0002270,76.74
2,14,1995,2009,0.0002415,0.0002593,75.76
2,15,1995,2010,0.0002756,0.0002893,74.78
2,16,1995,2011,0.0003003,0.0003093,73.80
2,17,1995,2012,0.0003175,0.0003214,72.83
2,18,1995,2013,0.0003342,0.0003323,71.85
2,19,1995,2014,0.0003539,0.0003444,70.87
2,20,1995,2015,0.0003732,0.0003546,69.90
2,21,1995,2016,0.0003859,0.0003574,68.92
2,22,1995,2017,0.0003897,0.0003512,67.95
2,23,1995,2018,0.0003908,0.0003425,66.97
2,24,1995,2019,0.0003983,0.0003398,65.99
2,25,1995,2020,0.0004147,0.0003447,65.01
2,26,1995,2021,0.0004348,0.0003525,64.04
2,27,1995,2022,0.0004528,0.0003580,63.06
2,28,1995,2023,0.0004684,0.0003622,62.08
2,29,1995,2024,0.0004856,0.0003672,61.10
2,30,1995,2025,0.0005091,0.0003758,60.13
2,31,1995,2026,0.0005408,0.0003895,59.15
2,32,1995,2027,0.0005796,0.0004073,58.17
2,33,1995,2028,0.0006220,0.0004265,57.19
2,34,1995,2029,0.0006665,0.0004448,56.22
2,35,1995,2030,0.0007153,0.0004630,55.24
2,36,1995,2031,0.0007710,0.0004864,54.27
2,37,1995,2032,0.0008314,0.0005117,53.30
2,38,1995,2033,0.0008908,0.0005380,52.32
2,39,1995,2034,0.0009481,0.0005648,51.35
2,40,1995,2035,0.0010090,0.0005937,50.38
2,41,1995,2036,0.0010784,0.0006259,49.41
2,42,1995,2037,0.0011559,0.0006618,48.44
2,43,1995,2038,0.0012427,0.0007061,47.47
2,44,1995,2039,0.0013435,0.0007642,46.50
2,45,1995,2040,0.0014588,0.0008296,45.54
2,46,1995,2041,0.0015840,0.0008992,44.58
2,47,1995,2042,0.0017152,0.0009653,43.62
2,48,1995,2043,0.0018531,0.0010318,42.66
2,49,1995,2044,0.0020059,0.0011030,41.70
2,50,1995,2045,0.0021845,0.0011786,40.75
2,51,1995,2046,0.0023896,0.0012580,39.79
2,52,1995,2047,0.0026115,0.0013399,38.84
2,53,1995,2048,0.0028474,0.0014304,37.90
2,54,1995,2049,0.0031082,0.0015429,36.95
2,55,1995,2050,0.0034035,0.0016706,36.01
2,56,1995,2051,0.0037277,0.0018044,35.06
2,57,1995,2052,0.0040692,0.0019281,34.13
2,58,1995,2053,0.0044295,0.0020500,33.19
2,59,1995,2054,0.0048296,0.0021888,32.26
2,60,1995,2055,0.0052973,0.0023623,31.33
2,61,1995,2056,0.0058480,0.0025781,30.40
2,62,1995,2057,0.0064757,0.0028357,29.48
2,63,1995,2058,0.0071641,0.0031326,28.56
2,64,1995,2059,0.0078986,0.0034475,27.65
2,65,1995,2060,0.0086645,0.0037406,26.74
2,66,1995,2061,0.0094558,0.0040100,25.84
2,67,1995,2062,0.0103010,0.0042894,24.94
2,68,1995,2063,0.0112531,0.0046222,24.05
2,69,1995,2064,0.0123584,0.0050244,23.16
2,70,1995,2065,0.0136702,0.0055235,22.27
2,71,1995,2066,0.0152518,0.0061936,21.39
2,72,1995,2067,0.0170987,0.0070482,20.52
2,73,1995,2068,0.0190837,0.0079749,19.67
2,74,1995,2069,0.0210750,0.0088518,18.82
2,75,1995,2070,0.0231062,0.0096863,17.98
2,76,1995,2071,0.0253497,0.0106393,17.16
2,77,1995,2072,0.0279666,0.0118729,16.33
2,78,1995,2073,0.0310443,0.0134735,15.52
2,79,1995,2074,0.0345982,0.0154308,14.73
2,80,1995,2075,0.0395295,0.0187418,13.95
2,81,1995,2076,0.0438328,0.0211481,13.21
2,82,1995,2077,0.0485928,0.0238748,12.48
2,83,1995,2078,0.0538556,0.0269665,11.78
2,84,1995,2079,0.0596709,0.0304335,11.09
2,85,1995,2080,0.0660929,0.0343275,10.42
2,86,1995,2081,0.0731799,0.0387437,9.78
2,87,1995,2082,0.0809950,0.0437680,9.15
2,88,1995,2083,0.0896059,0.0494607,8.55
2,89,1995,2084,0.0990850,0.0558453,7.96
2,90,1995,2085,0.1095094,0.0630083,7.41
2,91,1995,2086,0.1209607,0.0710973,6.87
2,92,1995,2087,0.1335249,0.0802779,6.36
2,93,1995,2088,0.1472918,0.0906963,5.87
2,94,1995,2089,0.1623547,0.1024469,5.40
2,95,1995,2090,0.1788093,0.1156497,4.96
2,96,1995,2091,0.1967531,0.1305159,4.55
2,97,1995,2092,0.2162837,0.1472985,4.15
2,98,1995,2093,0.2374976,0.1662169,3.79
2,99,1995,2094,0.2604884,0.1874185,3.44
2,100,1995,2095,0.2853445,0.2110821,3.12
2,101,1995,2096,0.3121468,0.2374885,2.82
2,102,1995,2097,0.3409660,0.2669426,2.54
2,103,1995,2098,0.3718598,0.2996803,2.29
2,104,1995,2099,0.4048696,0.3358348,2.05
2,105,1995,2100,0.4400178,0.3755506,1.83
2,106,1995,2101,0.4773042,0.4190293,1.64
2,107,1995,2102,0.5167037,0.4664230,1.46
2,108,1995,2103,0.5581634,0.5177515,1.29
2,109,1995,2104,0.6016004,0.5729034,1.15
2,110,1995,2105,0.6469012,0.6317254,1.01
2,111,1995,2106,0.6939204,0.6940060,0.89
2,112,1995,2107,0.7424819,0.7593870,0.79
2,113,1995,2108,0.7923800,0.8273678,0.69
2,114,1995,2109,0.8433824,0.8973981,0.60
2,115,1995,2110,1.0000000,1.0000000,0.50
2,4,1996,2000,0.0001520,0.0002634,85.71
2,5,1996,2001,0.0001465,0.0002318,84.73
2,6,1996,2002,0.0001399,0.0002061,83.75
2,7,1996,2003,0.0001348,0.0001871,82.77
2,8,1996,2004,0.0001336,0.0001758,81.78
2,9,1996,2005,0.0001377,0.0001722,80.80
2,10,1996,2006,0.0001465,0.0001751,79.81
2,11,1996,2007,0.0001596,0.0001834,78.83
2,12,1996,2008,0.0001783,0.0001985,77.84
2,13,1996,2009,0.0002061,0.0002227,76.86
2,14,1996,2010,0.0002415,0.0002543,75.87
2,15,1996,2011,0.0002756,0.0002840,74.89
2,16,1996,2012,0.0003003,0.0003039,73.91
2,17,1996,2013,0.0003175,0.0003157,72.94
2,18,1996,2014,0.0003342,0.0003254,71.96
2,19,1996,2015,0.0003539,0.0003363,70.98
2,20,1996,2016,0.0003732,0.0003461,70.01
2,21,1996,2017,0.0003859,0.0003491,69.03
2,22,1996,2018,0.0003897,0.0003433,68.05
2,23,1996,2019,0.0003908,0.0003344,67.08
2,24,1996,2020,0.0003983,0.0003308,66.10
2,25,1996,2021,0.0004147,0.0003354,65.12
2,26,1996,2022,0.0004348,0.0003437,64.14
2,27,1996,2023,0.0004528,0.0003497,63.16
2,28,1996,2024,0.0004684,0.0003537,62.19
2,29,1996,2025,0.0004856,0.0003577,61.21
2,30,1996,2026,0.0005091,0.0003660,60.23
2,31,1996,2027,0.0005408,0.0003799,59.25
2,32,1996,2028,0.0005796,0.0003981,58.27
2,33,1996,2029,0.0006220,0.0004165,57.30
2,34,1996,2030,0.0006665,0.0004334,56.32
2,35,1996,2031,0.0007153,0.0004508,55.35
2,36,1996,2032,0.0007710,0.0004743,54.37
2,37,1996,2033,0.0008314,0.0004999,53.40
2,38,1996,2034,0.0008908,0.0005255,52.42
2,39,1996,2035,0.0009481,0.0005508,51.45
2,40,1996,2036,0.0010090,0.0005790,50.48
2,41,1996,2037,0.0010784,0.0006115,49.51
2,42,1996,2038,0.0011559,0.0006480,48.54
2,43,1996,2039,0.0012427,0.0006914,47.57
2,44,1996,2040,0.0013435,0.0007475,46.60
2,45,1996,2041,0.0014588,0.0008117,45.63
2,46,1996,2042,0.0015840,0.0008815,44.67
2,47,1996,2043,0.0017152,0.0009481,43.71
2,48,1996,2044,0.0018531,0.0010133,42.75
2,49,1996,2045,0.0020059,0.0010817,41.79
2,50,1996,2046,0.0021845,0.0011553,40.84
2,51,1996,2047,0.0023896,0.0012343,39.89
2,52,1996,2048,0.0026115,0.0013162,38.93
2,53,1996,2049,0.0028474,0.0014042,37.98
2,54,1996,2050,0.0031082,0.0015123,37.04
2,55,1996,2051,0.0034035,0.0016371,36.09
2,56,1996,2052,0.0037277,0.0017706,35.15
2,57,1996,2053,0.0040692,0.0018943,34.21
2,58,1996,2054,0.0044295,0.0020125,33.28
2,59,1996,2055,0.0048296,0.0021449,32.34
2,60,1996,2056,0.0052973,0.0023140,31.41
2,61,1996,2057,0.0058480,0.0025290,30.48
2,62,1996,2058,0.0064757,0.0027864,29.56
2,63,1996,2059,0.0071641,0.0030779,28.64
2,64,1996,2060,0.0078986,0.0033832,27.73
2,65,1996,2061,0.0086645,0.0036698,26.82
2,66,1996,2062,0.0094558,0.0039386,25.92
2,67,1996,2063,0.0103010,0.0042184,25.02
2,68,1996,2064,0.0112531,0.0045437,24.12
2,69,1996,2065,0.0123584,0.0049320,23.23
2,70,1996,2066,0.0136702,0.0054209,22.34
2,71,1996,2067,0.0152518,0.0060879,21.46
2,72,1996,2068,0.0170987,0.0069407,20.59
2,73,1996,2069,0.0190837,0.0078546,19.73
2,74,1996,2070,0.0210750,0.0087099,18.88
2,75,1996,2071,0.0231062,0.0095298,18.04
2,76,1996,2072,0.0253497,0.0104805,17.21
2,77,1996,2073,0.0279666,0.0117135,16.39
2,78,1996,2074,0.0310443,0.0132956,15.58
2,79,1996,2075,0.0345982,0.0152196,14.78
2,80,1996,2076,0.0395295,0.0185029,14.00
2,81,1996,2077,0.0438328,0.0209040,13.26
2,82,1996,2078,0.0485928,0.0236297,12.53
2,83,1996,2079,0.0538556,0.0266943,11.82
2,84,1996,2080,0.0596709,0.0301126,11.13
2,85,1996,2081,0.0660929,0.0339721,10.46
2,86,1996,2082,0.0731799,0.0383822,9.81
2,87,1996,2083,0.0809950,0.0434068,9.18
2,88,1996,2084,0.0896059,0.0490617,8.57
2,89,1996,2085,0.0990850,0.0553779,7.99
2,90,1996,2086,0.1095094,0.0624947,7.43
2,91,1996,2087,0.1209607,0.0705792,6.89
2,92,1996,2088,0.1335249,0.0797643,6.38
2,93,1996,2089,0.1472918,0.0901343,5.89
2,94,1996,2090,0.1623547,0.1017973,5.42
2,95,1996,2091,0.1788093,0.1149478,4.98
2,96,1996,2092,0.1967531,0.1298214,4.56
2,97,1996,2093,0.2162837,0.1466247,4.17
2,98,1996,2094,0.2374976,0.1654976,3.80
2,99,1996,2095,0.2604884,0.1866114,3.45
2,100,1996,2096,0.2853445,0.2102399,3.13
2,101,1996,2097,0.3121468,0.2366886,2.83
2,102,1996,2098,0.3409660,0.2662041,2.55
2,103,1996,2099,0.3718598,0.2989373,2.29
2,104,1996,2100,0.4048696,0.3350574,2.05
2,105,1996,2101,0.4400178,0.3748059,1.84
2,106,1996,2102,0.4773042,0.4183950,1.64
2,107,1996,2103,0.5167037,0.4659177,1.46
2,108,1996,2104,0.5581634,0.5173378,1.29
2,109,1996,2105,0.6016004,0.5725844,1.15
2,110,1996,2106,0.6469012,0.6315532,1.01
2,111,1996,2107,0.6939204,0.6940068,0.89
2,112,1996,2108,0.7424819,0.7595534,0.79
2,113,1996,2109,0.7923800,0.8277204,0.69
2,114,1996,2110,0.8433824,0.8979865,0.60
2,115,1996,2111,1.0000000,1.0000000,0.50
2,3,1997,2000,0.0001960,0.0003466,86.80
2,4,1997,2001,0.0001520,0.0002509,85.83
2,5,1997,2002,0.0001465,0.0002223,84.85
2,6,1997,2003,0.0001399,0.0001991,83.87
2,7,1997,2004,0.0001348,0.0001815,82.88
2,8,1997,2005,0.0001336,0.0001706,81.90
2,9,1997,2006,0.0001377,0.0001674,80.91
2,10,1997,2007,0.0001465,0.0001709,79.93
2,11,1997,2008,0.0001596,0.0001795,78.94
2,12,1997,2009,0.0001783,0.0001943,77.95
2,13,1997,2010,0.0002061,0.0002181,76.97
2,14,1997,2011,0.0002415,0.0002493,75.98
2,15,1997,2012,0.0002756,0.0002790,75.00
2,16,1997,2013,0.0003003,0.0002987,74.02
2,17,1997,2014,0.0003175,0.0003093,73.05
2,18,1997,2015,0.0003342,0.0003178,72.07
2,19,1997,2016,0.0003539,0.0003282,71.09
2,20,1997,2017,0.0003732,0.0003382,70.11
2,21,1997,2018,0.0003859,0.0003416,69.14
2,22,1997,2019,0.0003897,0.0003355,68.16
2,23,1997,2020,0.0003908,0.0003257,67.18
2,24,1997,2021,0.0003983,0.0003219,66.21
2,25,1997,2022,0.0004147,0.0003269,65.23
2,26,1997,2023,0.0004348,0.0003357,64.25
2,27,1997,2024,0.0004528,0.0003414,63.27
2,28,1997,2025,0.0004684,0.0003446,62.29
2,29,1997,2026,0.0004856,0.0003483,61.31
2,30,1997,2027,0.0005091,0.0003570,60.33
2,31,1997,2028,0.0005408,0.0003713,59.36
2,32,1997,2029,0.0005796,0.0003889,58.38
2,33,1997,2030,0.0006220,0.0004059,57.40
2,34,1997,2031,0.0006665,0.0004221,56.42
2,35,1997,2032,0.0007153,0.0004395,55.45
2,36,1997,2033,0.0007710,0.0004634,54.47
2,37,1997,2034,0.0008314,0.0004882,53.50
2,38,1997,2035,0.0008908,0.0005122,52.52
2,39,1997,2036,0.0009481,0.0005368,51.55
2,40,1997,2037,0.0010090,0.0005654,50.58
2,41,1997,2038,0.0010784,0.0005985,49.60
2,42,1997,2039,0.0011559,0.0006341,48.63
2,43,1997,2040,0.0012427,0.0006756,47.66
2,44,1997,2041,0.0013435,0.0007307,46.70
2,45,1997,2042,0.0014588,0.0007951,45.73
2,46,1997,2043,0.0015840,0.0008654,44.77
2,47,1997,2044,0.0017152,0.0009308,43.80
2,48,1997,2045,0.0018531,0.0009935,42.84
2,49,1997,2046,0.0020059,0.0010603,41.89
2,50,1997,2047,0.0021845,0.0011338,40.93
2,51,1997,2048,0.0023896,0.0012127,39.98
2,52,1997,2049,0.0026115,0.0012922,39.02
2,53,1997,2050,0.0028474,0.0013761,38.07
2,54,1997,2051,0.0031082,0.0014816,37.13
2,55,1997,2052,0.0034035,0.0016062,36.18
2,56,1997,2053,0.0037277,0.0017396,35.24
2,57,1997,2054,0.0040692,0.0018599,34.30
2,58,1997,2055,0.0044295,0.0019723,33.36
2,59,1997,2056,0.0048296,0.0021009,32.43
2,60,1997,2057,0.0052973,0.0022695,31.49
2,61,1997,2058,0.0058480,0.0024844,30.56
2,62,1997,2059,0.0064757,0.0027368,29.64
2,63,1997,2060,0.0071641,0.0030194,28.72
2,64,1997,2061,0.0078986,0.0033186,27.80
2,65,1997,2062,0.0086645,0.0036044,26.89
2,66,1997,2063,0.0094558,0.0038733,25.99
2,67,1997,2064,0.0103010,0.0041464,25.09
2,68,1997,2065,0.0112531,0.0044595,24.19
2,69,1997,2066,0.0123584,0.0048392,23.30
2,70,1997,2067,0.0136702,0.0053261,22.41
2,71,1997,2068,0.0152518,0.0059918,21.53
2,72,1997,2069,0.0170987,0.0068326,20.65
2,73,1997,2070,0.0190837,0.0077257,19.79
2,74,1997,2071,0.0210750,0.0085669,18.94
2,75,1997,2072,0.0231062,0.0093847,18.10
2,76,1997,2073,0.0253497,0.0103354,17.27
2,77,1997,2074,0.0279666,0.0115524,16.44
2,78,1997,2075,0.0310443,0.0131046,15.63
2,79,1997,2076,0.0345982,0.0150063,14.83
2,80,1997,2077,0.0395295,0.0182806,14.05
2,81,1997,2078,0.0438328,0.0206805,13.30
2,82,1997,2079,0.0485928,0.0233813,12.57
2,83,1997,2080,0.0538556,0.0264011,11.86
2,84,1997,2081,0.0596709,0.0297874,11.17
2,85,1997,2082,0.0660929,0.0336407,10.50
2,86,1997,2083,0.0731799,0.0380503,9.84
2,87,1997,2084,0.0809950,0.0430395,9.21
2,88,1997,2085,0.0896059,0.0486307,8.60
2,89,1997,2086,0.0990850,0.0549032,8.02
2,90,1997,2087,0.1095094,0.0620144,7.46
2,91,1997,2088,0.1209607,0.0701016,6.92
2,92,1997,2089,0.1335249,0.0792397,6.40
2,93,1997,2090,0.1472918,0.0895253,5.91
2,94,1997,2091,0.1623547,0.1011362,5.44
2,95,1997,2092,0.1788093,0.1142900,4.99
2,96,1997,2093,0.1967531,0.1291793,4.57
2,97,1997,2094,0.2162837,0.1459343,4.18
2,98,1997,2095,0.2374976,0.1647163,3.81
2,99,1997,2096,0.2604884,0.1857882,3.46
2,100,1997,2097,0.2853445,0.2094491,3.13
2,101,1997,2098,0.3121468,0.2359485,2.83
2,102,1997,2099,0.3409660,0.2654470,2.55
2,103,1997,2100,0.3718598,0.2981291,2.30
2,104,1997,2101,0.4048696,0.3342630,2.06
2,105,1997,2102,0.4400178,0.3741060,1.84
2,106,1997,2103,0.4773042,0.4178106,1.64
2,107,1997,2104,0.5167037,0.4654039,1.46
2,108,1997,2105,0.5581634,0.5168886,1.30
2,109,1997,2106,0.6016004,0.5722579,1.15
2,110,1997,2107,0.6469012,0.6313909,1.01
2,111,1997,2108,0.6939204,0.6940077,0.89
2,112,1997,2109,0.7424819,0.7597251,0.79
2,113,1997,2110,0.7923800,0.8281054,0.69
2,114,1997,2111,0.8433824,0.8985890,0.60
2,115,1997,2112,1.0000000,1.0000000,0.50
2,2,1998,2000,0.0002805,0.0005166,87.87
2,3,1998,2001,0.0001960,0.0003297,86.91
2,4,1998,2002,0.0001520,0.0002398,85.94
2,5,1998,2003,0.0001465,0.0002143,84.96
2,6,1998,2004,0.0001399,0.0001927,83.98
2,7,1998,2005,0.0001348,0.0001756,83.00
2,8,1998,2006,0.0001336,0.0001655,82.01
2,9,1998,2007,0.0001377,0.0001630,81.02
2,10,1998,2008,0.0001465,0.0001669,80.04
2,11,1998,2009,0.0001596,0.0001754,79.05
2,12,1998,2010,0.0001783,0.0001898,78.06
2,13,1998,2011,0.0002061,0.0002134,77.08
2,14,1998,2012,0.0002415,0.0002446,76.09
2,15,1998,2013,0.0002756,0.0002741,75.11
2,16,1998,2014,0.0003003,0.0002929,74.13
2,17,1998,2015,0.0003175,0.0003024,73.16
2,18,1998,2016,0.0003342,0.0003102,72.18
2,19,1998,2017,0.0003539,0.0003207,71.20
2,20,1998,2018,0.0003732,0.0003311,70.22
2,21,1998,2019,0.0003859,0.0003341,69.25
2,22,1998,2020,0.0003897,0.0003272,68.27
2,23,1998,2021,0.0003908,0.0003171,67.29
2,24,1998,2022,0.0003983,0.0003137,66.31
2,25,1998,2023,0.0004147,0.0003192,65.33
2,26,1998,2024,0.0004348,0.0003277,64.35
2,27,1998,2025,0.0004528,0.0003325,63.37
2,28,1998,2026,0.0004684,0.0003355,62.39
2,29,1998,2027,0.0004856,0.0003397,61.42
2,30,1998,2028,0.0005091,0.0003488,60.44
2,31,1998,2029,0.0005408,0.0003627,59.46
2,32,1998,2030,0.0005796,0.0003790,58.48
2,33,1998,2031,0.0006220,0.0003954,57.50
2,34,1998,2032,0.0006665,0.0004116,56.52
2,35,1998,2033,0.0007153,0.0004294,55.55
2,36,1998,2034,0.0007710,0.0004525,54.57
2,37,1998,2035,0.0008314,0.0004757,53.59
2,38,1998,2036,0.0008908,0.0004989,52.62
2,39,1998,2037,0.0009481,0.0005240,51.65
2,40,1998,2038,0.0010090,0.0005531,50.67
2,41,1998,2039,0.0010784,0.0005855,49.70
2,42,1998,2040,0.0011559,0.0006193,48.73
2,43,1998,2041,0.0012427,0.0006599,47.76
2,44,1998,2042,0.0013435,0.0007152,46.79
2,45,1998,2043,0.0014588,0.0007802,45.82
2,46,1998,2044,0.0015840,0.0008494,44.86
2,47,1998,2045,0.0017152,0.0009124,43.90
2,48,1998,2046,0.0018531,0.0009737,42.94
2,49,1998,2047,0.0020059,0.0010405,41.98
2,50,1998,2048,0.0021845,0.0011141,41.02
2,51,1998,2049,0.0023896,0.0011908,40.07
2,52,1998,2050,0.0026115,0.0012664,39.11
2,53,1998,2051,0.0028474,0.0013479,38.16
2,54,1998,2052,0.0031082,0.0014533,37.21
2,55,1998,2053,0.0034035,0.0015778,36.27
2,56,1998,2054,0.0037277,0.0017081,35.32
2,57,1998,2055,0.0040692,0.0018230,34.38
2,58,1998,2056,0.0044295,0.0019319,33.44
2,59,1998,2057,0.0048296,0.0020603,32.51
2,60,1998,2058,0.0052973,0.0022290,31.57
2,61,1998,2059,0.0058480,0.0024395,30.64
2,62,1998,2060,0.0064757,0.0026838,29.72
2,63,1998,2061,0.0071641,0.0029606,28.80
2,64,1998,2062,0.0078986,0.0032588,27.88
2,65,1998,2063,0.0086645,0.0035446,26.97
2,66,1998,2064,0.0094558,0.0038073,26.06
2,67,1998,2065,0.0103010,0.0040694,25.16
2,68,1998,2066,0.0112531,0.0043749,24.26
2,69,1998,2067,0.0123584,0.0047534,23.37
2,70,1998,2068,0.0136702,0.0052398,22.48
2,71,1998,2069,0.0152518,0.0058951,21.59
2,72,1998,2070,0.0170987,0.0067169,20.72
2,73,1998,2071,0.0190837,0.0075960,19.85
2,74,1998,2072,0.0210750,0.0084343,19.00
2,75,1998,2073,0.0231062,0.0092523,18.16
2,76,1998,2074,0.0253497,0.0101890,17.32
2,77,1998,2075,0.0279666,0.0113795,16.50
2,78,1998,2076,0.0310443,0.0129119,15.68
2,79,1998,2077,0.0345982,0.0148081,14.88
2,80,1998,2078,0.0395295,0.0180772,14.10
2,81,1998,2079,0.0438328,0.0204542,13.35
2,82,1998,2080,0.0485928,0.0231137,12.61
2,83,1998,2081,0.0538556,0.0261042,11.90
2,84,1998,2082,0.0596709,0.0294843,11.21
2,85,1998,2083,0.0660929,0.0333365,10.53
2,86,1998,2084,0.0731799,0.0377131,9.88
2,87,1998,2085,0.0809950,0.0426430,9.24
2,88,1998,2086,0.0896059,0.0481933,8.63
2,89,1998,2087,0.0990850,0.0544596,8.05
2,90,1998,2088,0.1095094,0.0615719,7.48
2,91,1998,2089,0.1209607,0.0696139,6.94
2,92,1998,2090,0.1335249,0.0786715,6.42
2,93,1998,2091,0.1472918,0.0889059,5.93
2,94,1998,2092,0.1623547,0.1005169,5.46
2,95,1998,2093,0.1788093,0.1136821,5.01
2,96,1998,2094,0.1967531,0.1285215,4.59
2,97,1998,2095,0.2162837,0.1451845,4.19
2,98,1998,2096,0.2374976,0.1639198,3.82
2,99,1998,2097,0.2604884,0.1850155,3.47
2,100,1998,2098,0.2853445,0.2087176,3.14
2,101,1998,2099,0.3121468,0.2351900,2.84
2,102,1998,2100,0.3409660,0.2646238,2.56
2,103,1998,2101,0.3718598,0.2973033,2.30
2,104,1998,2102,0.4048696,0.3335166,2.06
2,105,1998,2103,0.4400178,0.3734614,1.84
2,106,1998,2104,0.4773042,0.4172164,1.64
2,107,1998,2105,0.5167037,0.4648459,1.46
2,108,1998,2106,0.5581634,0.5164288,1.30
2,109,1998,2107,0.6016004,0.5719502,1.15
2,110,1998,2108,0.6469012,0.6312399,1.01
2,111,1998,2109,0.6939204,0.6940085,0.89
2,112,1998,2110,0.7424819,0.7599125,0.79
2,113,1998,2111,0.7923800,0.8284996,0.69
2,114,1998,2112,0.8433824,0.8991564,0.60
2,115,1998,2113,1.0000000,1.0000000,0.50
2,1,1999,2000,0.0005341,0.0010202,88.89
2,2,1999,2001,0.0002805,0.0004895,87.98
2,3,1999,2002,0.0001960,0.0003146,87.03
2,4,1999,2003,0.0001520,0.0002304,86.05
2,5,1999,2004,0.0001465,0.0002068,85.07
2,6,1999,2005,0.0001399,0.0001861,84.09
2,7,1999,2006,0.0001348,0.0001699,83.11
2,8,1999,2007,0.0001336,0.0001607,82.12
2,9,1999,2008,0.0001377,0.0001589,81.13
2,10,1999,2009,0.0001465,0.0001627,80.15
2,11,1999,2010,0.0001596,0.0001709,79.16
2,12,1999,2011,0.0001783,0.0001853,78.17
2,13,1999,2012,0.0002061,0.0002090,77.19
2,14,1999,2013,0.0002415,0.0002401,76.20
2,15,1999,2014,0.0002756,0.0002687,75.22
2,16,1999,2015,0.0003003,0.0002865,74.24
2,17,1999,2016,0.0003175,0.0002954,73.26
2,18,1999,2017,0.0003342,0.0003032,72.28
2,19,1999,2018,0.0003539,0.0003140,71.31
2,20,1999,2019,0.0003732,0.0003239,70.33
2,21,1999,2020,0.0003859,0.0003261,69.35
2,22,1999,2021,0.0003897,0.0003188,68.37
2,23,1999,2022,0.0003908,0.0003091,67.40
2,24,1999,2023,0.0003983,0.0003063,66.42
2,25,1999,2024,0.0004147,0.0003115,65.44
2,26,1999,2025,0.0004348,0.0003192,64.46
2,27,1999,2026,0.0004528,0.0003237,63.48
2,28,1999,2027,0.0004684,0.0003271,62.50
2,29,1999,2028,0.0004856,0.0003319,61.52
2,30,1999,2029,0.0005091,0.0003407,60.54
2,31,1999,2030,0.0005408,0.0003535,59.56
2,32,1999,2031,0.0005796,0.0003692,58.58
2,33,1999,2032,0.0006220,0.0003857,57.60
2,34,1999,2033,0.0006665,0.0004022,56.62
2,35,1999,2034,0.0007153,0.0004192,55.65
2,36,1999,2035,0.0007710,0.0004410,54.67
2,37,1999,2036,0.0008314,0.0004633,53.69
2,38,1999,2037,0.0008908,0.0004867,52.72
2,39,1999,2038,0.0009481,0.0005123,51.74
2,40,1999,2039,0.0010090,0.0005408,50.77
2,41,1999,2040,0.0010784,0.0005716,49.80
2,42,1999,2041,0.0011559,0.0006046,48.82
2,43,1999,2042,0.0012427,0.0006454,47.85
2,44,1999,2043,0.0013435,0.0007013,46.88
2,45,1999,2044,0.0014588,0.0007652,45.92
2,46,1999,2045,0.0015840,0.0008323,44.95
2,47,1999,2046,0.0017152,0.0008940,43.99
2,48,1999,2047,0.0018531,0.0009553,43.03
2,49,1999,2048,0.0020059,0.0010224,42.07
2,50,1999,2049,0.0021845,0.0010941,41.11
2,51,1999,2050,0.0023896,0.0011673,40.16
2,52,1999,2051,0.0026115,0.0012406,39.20
2,53,1999,2052,0.0028474,0.0013218,38.25
2,54,1999,2053,0.0031082,0.0014273,37.30
2,55,1999,2054,0.0034035,0.0015490,36.35
2,56,1999,2055,0.0037277,0.0016743,35.41
2,57,1999,2056,0.0040692,0.0017860,34.47
2,58,1999,2057,0.0044295,0.0018947,33.53
2,59,1999,2058,0.0048296,0.0020233,32.59
2,60,1999,2059,0.0052973,0.0021883,31.65
2,61,1999,2060,0.0058480,0.0023915,30.72
2,62,1999,2061,0.0064757,0.0026306,29.80
2,63,1999,2062,0.0071641,0.0029063,28.87
2,64,1999,2063,0.0078986,0.0032043,27.96
2,65,1999,2064,0.0086645,0.0034841,27.04
2,66,1999,2065,0.0094558,0.0037366,26.14
2,67,1999,2066,0.0103010,0.0039919,25.23
2,68,1999,2067,0.0112531,0.0042968,24.33
2,69,1999,2068,0.0123584,0.0046754,23.43
2,70,1999,2069,0.0136702,0.0051531,22.54
2,71,1999,2070,0.0152518,0.0057917,21.66
2,72,1999,2071,0.0170987,0.0066004,20.78
2,73,1999,2072,0.0190837,0.0074758,19.91
2,74,1999,2073,0.0210750,0.0083134,19.06
2,75,1999,2074,0.0231062,0.0091186,18.22
2,76,1999,2075,0.0253497,0.0100318,17.38
2,77,1999,2076,0.0279666,0.0112051,16.55
2,78,1999,2077,0.0310443,0.0127330,15.73
2,79,1999,2078,0.0345982,0.0146270,14.93
2,80,1999,2079,0.0395295,0.0178712,14.14
2,81,1999,2080,0.0438328,0.0202105,13.39
2,82,1999,2081,0.0485928,0.0228430,12.66
2,83,1999,2082,0.0538556,0.0258275,11.94
2,84,1999,2083,0.0596709,0.0292062,11.24
2,85,1999,2084,0.0660929,0.0330276,10.57
2,86,1999,2085,0.0731799,0.0373491,9.91
2,87,1999,2086,0.0809950,0.0422408,9.28
2,88,1999,2087,0.0896059,0.0477846,8.66
2,89,1999,2088,0.0990850,0.0540510,8.07
2,90,1999,2089,0.1095094,0.0611202,7.51
2,91,1999,2090,0.1209607,0.0690859,6.96
2,92,1999,2091,0.1335249,0.0780937,6.44
2,93,1999,2092,0.1472918,0.0883258,5.95
2,94,1999,2093,0.1623547,0.0999448,5.47
2,95,1999,2094,0.1788093,0.1130596,5.03
2,96,1999,2095,0.1967531,0.1278075,4.60
2,97,1999,2096,0.2162837,0.1444205,4.20
2,98,1999,2097,0.2374976,0.1631725,3.83
2,99,1999,2098,0.2604884,0.1843011,3.48
2,100,1999,2099,0.2853445,0.2079682,3.15
2,101,1999,2100,0.3121468,0.2343655,2.85
2,102,1999,2101,0.3409660,0.2637832,2.56
2,103,1999,2102,0.3718598,0.2965279,2.30
2,104,1999,2103,0.4048696,0.3328294,2.06
2,105,1999,2104,0.4400178,0.3728061,1.85
2,106,1999,2105,0.4773042,0.4165715,1.65
2,107,1999,2106,0.5167037,0.4642751,1.46
2,108,1999,2107,0.5581634,0.5159957,1.30
2,109,1999,2108,0.6016004,0.5716640,1.15
2,110,1999,2109,0.6469012,0.6310841,1.01
2,111,1999,2110,0.6939204,0.6940095,0.89
2,112,1999,2111,0.7424819,0.7601044,0.79
2,113,1999,2112,0.7923800,0.8288710,0.69
2,114,1999,2113,0.8433824,0.8996817,0.60
2,115,1999,2114,1.0000000,1.0000000,0.50
2,0,2000,2000,0.0078008,0.0118750,88.95
2,1,2000,2001,0.0005341,0.0009637,89.01
2,2,2000,2002,0.0002805,0.0004655,88.10
2,3,2000,2003,0.0001960,0.0003017,87.14
2,4,2000,2004,0.0001520,0.0002216,86.17
2,5,2000,2005,0.0001465,0.0001992,85.19
2,6,2000,2006,0.0001399,0.0001795,84.20
2,7,2000,2007,0.0001348,0.0001646,83.22
2,8,2000,2008,0.0001336,0.0001562,82.23
2,9,2000,2009,0.0001377,0.0001544,81.24
2,10,2000,2010,0.0001465,0.0001581,80.26
2,11,2000,2011,0.0001596,0.0001665,79.27
2,12,2000,2012,0.0001783,0.0001811,78.28
2,13,2000,2013,0.0002061,0.0002047,77.30
2,14,2000,2014,0.0002415,0.0002351,76.31
2,15,2000,2015,0.0002756,0.0002628,75.33
2,16,2000,2016,0.0003003,0.0002801,74.35
2,17,2000,2017,0.0003175,0.0002890,73.37
2,18,2000,2018,0.0003342,0.0002969,72.39
2,19,2000,2019,0.0003539,0.0003072,71.41
2,20,2000,2020,0.0003732,0.0003163,70.43
2,21,2000,2021,0.0003859,0.0003181,69.46
2,22,2000,2022,0.0003897,0.0003112,68.48
2,23,2000,2023,0.0003908,0.0003020,67.50
2,24,2000,2024,0.0003983,0.0002989,66.52
2,25,2000,2025,0.0004147,0.0003034,65.54
2,26,2000,2026,0.0004348,0.0003107,64.56
2,27,2000,2027,0.0004528,0.0003156,63.58
2,28,2000,2028,0.0004684,0.0003196,62.60
2,29,2000,2029,0.0004856,0.0003241,61.62
2,30,2000,2030,0.0005091,0.0003320,60.64
2,31,2000,2031,0.0005408,0.0003443,59.66
2,32,2000,2032,0.0005796,0.0003602,58.68
2,33,2000,2033,0.0006220,0.0003770,57.70
2,34,2000,2034,0.0006665,0.0003929,56.72
2,35,2000,2035,0.0007153,0.0004085,55.74
2,36,2000,2036,0.0007710,0.0004294,54.77
2,37,2000,2037,0.0008314,0.0004519,53.79
2,38,2000,2038,0.0008908,0.0004757,52.81
2,39,2000,2039,0.0009481,0.0005006,51.84
2,40,2000,2040,0.0010090,0.0005277,50.86
2,41,2000,2041,0.0010784,0.0005577,49.89
2,42,2000,2042,0.0011559,0.0005910,48.92
2,43,2000,2043,0.0012427,0.0006323,47.95
2,44,2000,2044,0.0013435,0.0006873,46.98
2,45,2000,2045,0.0014588,0.0007492,46.01
2,46,2000,2046,0.0015840,0.0008151,45.04
2,47,2000,2047,0.0017152,0.0008769,44.08
2,48,2000,2048,0.0018531,0.0009385,43.12
2,49,2000,2049,0.0020059,0.0010040,42.16
2,50,2000,2050,0.0021845,0.0010727,41.20
2,51,2000,2051,0.0023896,0.0011438,40.24
2,52,2000,2052,0.0026115,0.0012168,39.29
2,53,2000,2053,0.0028474,0.0012980,38.34
2,54,2000,2054,0.0031082,0.0014009,37.39
2,55,2000,2055,0.0034035,0.0015181,36.44
2,56,2000,2056,0.0037277,0.0016404,35.49
2,57,2000,2057,0.0040692,0.0017518,34.55
2,58,2000,2058,0.0044295,0.0018608,33.61
2,59,2000,2059,0.0048296,0.0019862,32.67
2,60,2000,2060,0.0052973,0.0021448,31.73
2,61,2000,2061,0.0058480,0.0023434,30.80
2,62,2000,2062,0.0064757,0.0025814,29.87
2,63,2000,2063,0.0071641,0.0028568,28.95
2,64,2000,2064,0.0078986,0.0031491,28.03
2,65,2000,2065,0.0086645,0.0034193,27.12
2,66,2000,2066,0.0094558,0.0036655,26.21
2,67,2000,2067,0.0103010,0.0039204,25.30
2,68,2000,2068,0.0112531,0.0042257,24.40
2,69,2000,2069,0.0123584,0.0045969,23.50
2,70,2000,2070,0.0136702,0.0050603,22.61
2,71,2000,2071,0.0152518,0.0056877,21.72
2,72,2000,2072,0.0170987,0.0064925,20.84
2,73,2000,2073,0.0190837,0.0073662,19.98
2,74,2000,2074,0.0210750,0.0081914,19.12
2,75,2000,2075,0.0231062,0.0089752,18.27
2,76,2000,2076,0.0253497,0.0098734,17.44
2,77,2000,2077,0.0279666,0.0110433,16.60
2,78,2000,2078,0.0310443,0.0125695,15.78
2,79,2000,2079,0.0345982,0.0144438,14.98
2,80,2000,2080,0.0395295,0.0176496,14.19
2,81,2000,2081,0.0438328,0.0199640,13.44
2,82,2000,2082,0.0485928,0.0225908,12.70
2,83,2000,2083,0.0538556,0.0255737,11.98
2,84,2000,2084,0.0596709,0.0289239,11.28
2,85,2000,2085,0.0660929,0.0326943,10.60
2,86,2000,2086,0.0731799,0.0369800,9.95
2,87,2000,2087,0.0809950,0.0418651,9.31
2,88,2000,2088,0.0896059,0.0474083,8.69
2,89,2000,2089,0.0990850,0.0536341,8.10
2,90,2000,2090,0.1095094,0.0606314,7.53
2,91,2000,2091,0.1209607,0.0685493,6.99
2,92,2000,2092,0.1335249,0.0775530,6.46
2,93,2000,2093,0.1472918,0.0877902,5.96
2,94,2000,2094,0.1623547,0.0993592,5.49
2,95,2000,2095,0.1788093,0.1123843,5.04
2,96,2000,2096,0.1967531,0.1270804,4.62
2,97,2000,2097,0.2162837,0.1437041,4.22
2,98,2000,2098,0.2374976,0.1624818,3.84
2,99,2000,2099,0.2604884,0.1835696,3.49
2,100,2000,2100,0.2853445,0.2071541,3.16
2,101,2000,2101,0.3121468,0.2335240,2.85
2,102,2000,2102,0.3409660,0.2629940,2.57
2,103,2000,2103,0.3718598,0.2958142,2.31
2,104,2000,2104,0.4048696,0.3321311,2.07
2,105,2000,2105,0.4400178,0.3720952,1.85
2,106,2000,2106,0.4773042,0.4159119,1.65
2,107,2000,2107,0.5167037,0.4637375,1.46
2,108,2000,2108,0.5581634,0.5155929,1.30
2,109,2000,2109,0.6016004,0.5713689,1.15
2,110,2000,2110,0.6469012,0.6309142,1.01
2,111,2000,2111,0.6939204,0.6940105,0.89
2,112,2000,2112,0.7424819,0.7602851,0.78
2,113,2000,2113,0.7923800,0.8292147,0.69
2,114,2000,2114,0.8433824,0.9002193,0.60
2,115,2000,2115,1.0000000,1.0000000,0.50
2,0,2001,2001,0.0078007,0.0114446,89.10
2,1,2001,2002,0.0005341,0.0009137,89.13
2,2,2001,2003,0.0002805,0.0004452,88.21
2,3,2001,2004,0.0001960,0.0002898,87.25
2,4,2001,2005,0.0001520,0.0002127,86.28
2,5,2001,2006,0.0001465,0.0001916,85.30
2,6,2001,2007,0.0001399,0.0001735,84.31
2,7,2001,2008,0.0001348,0.0001596,83.33
2,8,2001,2009,0.0001336,0.0001515,82.34
2,9,2001,2010,0.0001377,0.0001497,81.35
2,10,2001,2011,0.0001465,0.0001535,80.37
2,11,2001,2012,0.0001596,0.0001623,79.38
2,12,2001,2013,0.0001783,0.0001770,78.39
2,13,2001,2014,0.0002061,0.0002001,77.40
2,14,2001,2015,0.0002415,0.0002296,76.42
2,15,2001,2016,0.0002756,0.0002569,75.44
2,16,2001,2017,0.0003003,0.0002742,74.46
2,17,2001,2018,0.0003175,0.0002831,73.48
2,18,2001,2019,0.0003342,0.0002906,72.50
2,19,2001,2020,0.0003539,0.0002999,71.52
2,20,2001,2021,0.0003732,0.0003086,70.54
2,21,2001,2022,0.0003859,0.0003107,69.56
2,22,2001,2023,0.0003897,0.0003043,68.58
2,23,2001,2024,0.0003908,0.0002948,67.60
2,24,2001,2025,0.0003983,0.0002910,66.62
2,25,2001,2026,0.0004147,0.0002952,65.64
2,26,2001,2027,0.0004348,0.0003029,64.66
2,27,2001,2028,0.0004528,0.0003083,63.68
2,28,2001,2029,0.0004684,0.0003120,62.70
2,29,2001,2030,0.0004856,0.0003158,61.72
2,30,2001,2031,0.0005091,0.0003234,60.74
2,31,2001,2032,0.0005408,0.0003359,59.76
2,32,2001,2033,0.0005796,0.0003521,58.78
2,33,2001,2034,0.0006220,0.0003682,57.80
2,34,2001,2035,0.0006665,0.0003829,56.82
2,35,2001,2036,0.0007153,0.0003978,55.84
2,36,2001,2037,0.0007710,0.0004189,54.86
2,37,2001,2038,0.0008314,0.0004416,53.89
2,38,2001,2039,0.0008908,0.0004647,52.91
2,39,2001,2040,0.0009481,0.0004882,51.93
2,40,2001,2041,0.0010090,0.0005147,50.96
2,41,2001,2042,0.0010784,0.0005449,49.99
2,42,2001,2043,0.0011559,0.0005787,49.01
2,43,2001,2044,0.0012427,0.0006192,48.04
2,44,2001,2045,0.0013435,0.0006724,47.07
2,45,2001,2046,0.0014588,0.0007332,46.10
2,46,2001,2047,0.0015840,0.0007993,45.13
2,47,2001,2048,0.0017152,0.0008613,44.17
2,48,2001,2049,0.0018531,0.0009215,43.21
2,49,2001,2050,0.0020059,0.0009844,42.25
2,50,2001,2051,0.0021845,0.0010512,41.29
2,51,2001,2052,0.0023896,0.0011220,40.33
2,52,2001,2053,0.0026115,0.0011949,39.38
2,53,2001,2054,0.0028474,0.0012738,38.42
2,54,2001,2055,0.0031082,0.0013726,37.47
2,55,2001,2056,0.0034035,0.0014871,36.52
2,56,2001,2057,0.0037277,0.0016092,35.58
2,57,2001,2058,0.0040692,0.0017207,34.63
2,58,2001,2059,0.0044295,0.0018268,33.69
2,59,2001,2060,0.0048296,0.0019465,32.75
2,60,2001,2061,0.0052973,0.0021012,31.81
2,61,2001,2062,0.0058480,0.0022990,30.88
2,62,2001,2063,0.0064757,0.0025365,29.95
2,63,2001,2064,0.0071641,0.0028067,29.03
2,64,2001,2065,0.0078986,0.0030900,28.11
2,65,2001,2066,0.0086645,0.0033542,27.19
2,66,2001,2067,0.0094558,0.0035999,26.28
2,67,2001,2068,0.0103010,0.0038553,25.37
2,68,2001,2069,0.0112531,0.0041543,24.47
2,69,2001,2070,0.0123584,0.0045131,23.57
2,70,2001,2071,0.0136702,0.0049671,22.68
2,71,2001,2072,0.0152518,0.0055914,21.79
2,72,2001,2073,0.0170987,0.0063942,20.91
2,73,2001,2074,0.0190837,0.0072556,20.04
2,74,2001,2075,0.0210750,0.0080605,19.18
2,75,2001,2076,0.0231062,0.0088307,18.33
2,76,2001,2077,0.0253497,0.0097265,17.49
2,77,2001,2078,0.0279666,0.0108955,16.66
2,78,2001,2079,0.0310443,0.0124043,15.84
2,79,2001,2080,0.0345982,0.0142469,15.03
2,80,2001,2081,0.0395295,0.0174256,14.24
2,81,2001,2082,0.0438328,0.0197345,13.48
2,82,2001,2083,0.0485928,0.0223596,12.74
2,83,2001,2084,0.0538556,0.0253162,12.02
2,84,2001,2085,0.0596709,0.0286195,11.32
2,85,2001,2086,0.0660929,0.0323565,10.64
2,86,2001,2087,0.0731799,0.0366356,9.98
2,87,2001,2088,0.0809950,0.0415194,9.34
2,88,2001,2089,0.0896059,0.0470245,8.72
2,89,2001,2090,0.0990850,0.0531831,8.13
2,90,2001,2091,0.1095094,0.0601349,7.56
2,91,2001,2092,0.1209607,0.0680473,7.01
2,92,2001,2093,0.1335249,0.0770539,6.48
2,93,2001,2094,0.1472918,0.0872422,5.98
2,94,2001,2095,0.1623547,0.0987242,5.51
2,95,2001,2096,0.1788093,0.1116968,5.06
2,96,2001,2097,0.1967531,0.1263987,4.63
2,97,2001,2098,0.2162837,0.1430422,4.23
2,98,2001,2099,0.2374976,0.1617749,3.85
2,99,2001,2100,0.2604884,0.1827751,3.50
2,100,2001,2101,0.2853445,0.2063234,3.17
2,101,2001,2102,0.3121468,0.2327343,2.86
2,102,2001,2103,0.3409660,0.2622679,2.58
2,103,2001,2104,0.3718598,0.2950892,2.31
2,104,2001,2105,0.4048696,0.3313738,2.07
2,105,2001,2106,0.4400178,0.3713684,1.85
2,106,2001,2107,0.4773042,0.4152909,1.65
2,107,2001,2108,0.5167037,0.4632378,1.47
2,108,2001,2109,0.5581634,0.5151777,1.30
2,109,2001,2110,0.6016004,0.5710468,1.15
2,110,2001,2111,0.6469012,0.6307401,1.01
2,111,2001,2112,0.6939204,0.6940114,0.89
2,112,2001,2113,0.7424819,0.7604525,0.78
2,113,2001,2114,0.7923800,0.8295665,0.69
2,114,2001,2115,0.8433824,0.9008047,0.60
2,115,2001,2116,1.0000000,1.0000000,0.50
2,0,2002,2002,0.0078007,0.0110558,89.25
2,1,2002,2003,0.0005341,0.0008714,89.25
2,2,2002,2004,0.0002805,0.0004264,88.33
2,3,2002,2005,0.0001960,0.0002777,87.36
2,4,2002,2006,0.0001520,0.0002039,86.39
2,5,2002,2007,0.0001465,0.0001847,85.41
2,6,2002,2008,0.0001399,0.0001679,84.42
2,7,2002,2009,0.0001348,0.0001544,83.44
2,8,2002,2010,0.0001336,0.0001464,82.45
2,9,2002,2011,0.0001377,0.0001449,81.46
2,10,2002,2012,0.0001465,0.0001493,80.47
2,11,2002,2013,0.0001596,0.0001583,79.48
2,12,2002,2014,0.0001783,0.0001726,78.50
2,13,2002,2015,0.0002061,0.0001949,77.51
2,14,2002,2016,0.0002415,0.0002241,76.53
2,15,2002,2017,0.0002756,0.0002514,75.54
2,16,2002,2018,0.0003003,0.0002688,74.56
2,17,2002,2019,0.0003175,0.0002773,73.58
2,18,2002,2020,0.0003342,0.0002838,72.60
2,19,2002,2021,0.0003539,0.0002927,71.62
2,20,2002,2022,0.0003732,0.0003016,70.64
2,21,2002,2023,0.0003859,0.0003041,69.66
2,22,2002,2024,0.0003897,0.0002973,68.69
2,23,2002,2025,0.0003908,0.0002872,67.71
2,24,2002,2026,0.0003983,0.0002831,66.72
2,25,2002,2027,0.0004147,0.0002877,65.74
2,26,2002,2028,0.0004348,0.0002959,64.76
2,27,2002,2029,0.0004528,0.0003009,63.78
2,28,2002,2030,0.0004684,0.0003040,62.80
2,29,2002,2031,0.0004856,0.0003075,61.82
2,30,2002,2032,0.0005091,0.0003154,60.84
2,31,2002,2033,0.0005408,0.0003283,59.86
2,32,2002,2034,0.0005796,0.0003440,58.88
2,33,2002,2035,0.0006220,0.0003590,57.90
2,34,2002,2036,0.0006665,0.0003730,56.92
2,35,2002,2037,0.0007153,0.0003880,55.94
2,36,2002,2038,0.0007710,0.0004093,54.96
2,37,2002,2039,0.0008314,0.0004312,53.98
2,38,2002,2040,0.0008908,0.0004529,53.01
2,39,2002,2041,0.0009481,0.0004759,52.03
2,40,2002,2042,0.0010090,0.0005026,51.05
2,41,2002,2043,0.0010784,0.0005334,50.08
2,42,2002,2044,0.0011559,0.0005664,49.11
2,43,2002,2045,0.0012427,0.0006052,48.13
2,44,2002,2046,0.0013435,0.0006575,47.16
2,45,2002,2047,0.0014588,0.0007185,46.19
2,46,2002,2048,0.0015840,0.0007848,45.23
2,47,2002,2049,0.0017152,0.0008455,44.26
2,48,2002,2050,0.0018531,0.0009033,43.30
2,49,2002,2051,0.0020059,0.0009646,42.34
2,50,2002,2052,0.0021845,0.0010313,41.38
2,51,2002,2053,0.0023896,0.0011021,40.42
2,52,2002,2054,0.0026115,0.0011727,39.46
2,53,2002,2055,0.0028474,0.0012478,38.51
2,54,2002,2056,0.0031082,0.0013443,37.56
2,55,2002,2057,0.0034035,0.0014585,36.61
2,56,2002,2058,0.0037277,0.0015807,35.66
2,57,2002,2059,0.0040692,0.0016895,34.71
2,58,2002,2060,0.0044295,0.0017904,33.77
2,59,2002,2061,0.0048296,0.0019067,32.83
2,60,2002,2062,0.0052973,0.0020609,31.89
2,61,2002,2063,0.0058480,0.0022584,30.96
2,62,2002,2064,0.0064757,0.0024912,30.03
2,63,2002,2065,0.0071641,0.0027530,29.10
2,64,2002,2066,0.0078986,0.0030306,28.18
2,65,2002,2067,0.0086645,0.0032940,27.26
2,66,2002,2068,0.0094558,0.0035402,26.35
2,67,2002,2069,0.0103010,0.0037900,25.44
2,68,2002,2070,0.0112531,0.0040780,24.54
2,69,2002,2071,0.0123584,0.0044288,23.64
2,70,2002,2072,0.0136702,0.0048808,22.74
2,71,2002,2073,0.0152518,0.0055037,21.85
2,72,2002,2074,0.0170987,0.0062950,20.97
2,73,2002,2075,0.0190837,0.0071370,20.10
2,74,2002,2076,0.0210750,0.0079286,19.24
2,75,2002,2077,0.0231062,0.0086967,18.39
2,76,2002,2078,0.0253497,0.0095924,17.55
2,77,2002,2079,0.0279666,0.0107463,16.71
2,78,2002,2080,0.0310443,0.0122268,15.89
2,79,2002,2081,0.0345982,0.0140481,15.08
2,80,2002,2082,0.0395295,0.0172171,14.28
2,81,2002,2083,0.0438328,0.0195243,13.53
2,82,2002,2084,0.0485928,0.0221252,12.79
2,83,2002,2085,0.0538556,0.0250387,12.06
2,84,2002,2086,0.0596709,0.0283110,11.36
2,85,2002,2087,0.0660929,0.0320414,10.68
2,86,2002,2088,0.0731799,0.0363186,10.01
2,87,2002,2089,0.0809950,0.0411669,9.37
2,88,2002,2090,0.0896059,0.0466096,8.75
2,89,2002,2091,0.0990850,0.0527251,8.16
2,90,2002,2092,0.1095094,0.0596705,7.58
2,91,2002,2093,0.1209607,0.0675841,7.03
2,92,2002,2094,0.1335249,0.0765434,6.51
2,93,2002,2095,0.1472918,0.0866482,6.00
2,94,2002,2096,0.1623547,0.0980780,5.53
2,95,2002,2097,0.1788093,0.1110526,5.07
2,96,2002,2098,0.1967531,0.1257692,4.64
2,97,2002,2099,0.2162837,0.1423650,4.24
2,98,2002,2100,0.2374976,0.1610074,3.86
2,99,2002,2101,0.2604884,0.1819648,3.51
2,100,2002,2102,0.2853445,0.2055442,3.17
2,101,2002,2103,0.3121468,0.2320080,2.87
2,102,2002,2104,0.3409660,0.2615307,2.58
2,103,2002,2105,0.3718598,0.2943032,2.32
2,104,2002,2106,0.4048696,0.3305998,2.08
2,105,2002,2107,0.4400178,0.3706842,1.85
2,106,2002,2108,0.4773042,0.4147138,1.65
2,107,2002,2109,0.5167037,0.4627226,1.47
2,108,2002,2110,0.5581634,0.5147246,1.30
2,109,2002,2111,0.6016004,0.5707172,1.15
2,110,2002,2112,0.6469012,0.6305763,1.01
2,111,2002,2113,0.6939204,0.6940123,0.89
2,112,2002,2114,0.7424819,0.7606238,0.78
2,113,2002,2115,0.7923800,0.8299496,0.69
2,114,2002,2116,0.8433824,0.9014042,0.60
2,115,2002,2117,1.0000000,1.0000000,0.50
2,0,2003,2003,0.0078006,0.0107207,89.40
2,1,2003,2004,0.0005341,0.0008325,89.37
2,2,2003,2005,0.0002805,0.0004073,88.44
2,3,2003,2006,0.0001960,0.0002658,87.47
2,4,2003,2007,0.0001520,0.0001959,86.50
2,5,2003,2008,0.0001465,0.0001783,85.51
2,6,2003,2009,0.0001399,0.0001620,84.53
2,7,2003,2010,0.0001348,0.0001488,83.54
2,8,2003,2011,0.0001336,0.0001413,82.56
2,9,2003,2012,0.0001377,0.0001406,81.57
2,10,2003,2013,0.0001465,0.0001453,80.58
2,11,2003,2014,0.0001596,0.0001539,79.59
2,12,2003,2015,0.0001783,0.0001677,78.60
2,13,2003,2016,0.0002061,0.0001898,77.62
2,14,2003,2017,0.0002415,0.0002191,76.63
2,15,2003,2018,0.0002756,0.0002465,75.65
2,16,2003,2019,0.0003003,0.0002634,74.67
2,17,2003,2020,0.0003175,0.0002710,73.69
2,18,2003,2021,0.0003342,0.0002770,72.71
2,19,2003,2022,0.0003539,0.0002861,71.73
2,20,2003,2023,0.0003732,0.0002952,70.75
2,21,2003,2024,0.0003859,0.0002974,69.77
2,22,2003,2025,0.0003897,0.0002899,68.79
2,23,2003,2026,0.0003908,0.0002796,67.81
2,24,2003,2027,0.0003983,0.0002759,66.83
2,25,2003,2028,0.0004147,0.0002810,65.84
2,26,2003,2029,0.0004348,0.0002888,64.86
2,27,2003,2030,0.0004528,0.0002932,63.88
2,28,2003,2031,0.0004684,0.0002960,62.90
2,29,2003,2032,0.0004856,0.0003000,61.92
2,30,2003,2033,0.0005091,0.0003083,60.94
2,31,2003,2034,0.0005408,0.0003208,59.95
2,32,2003,2035,0.0005796,0.0003354,58.97
2,33,2003,2036,0.0006220,0.0003498,57.99
2,34,2003,2037,0.0006665,0.0003639,57.01
2,35,2003,2038,0.0007153,0.0003791,56.03
2,36,2003,2039,0.0007710,0.0003997,55.06
2,37,2003,2040,0.0008314,0.0004202,54.08
2,38,2003,2041,0.0008908,0.0004412,53.10
2,39,2003,2042,0.0009481,0.0004645,52.12
2,40,2003,2043,0.0010090,0.0004918,51.15
2,41,2003,2044,0.0010784,0.0005219,50.17
2,42,2003,2045,0.0011559,0.0005534,49.20
2,43,2003,2046,0.0012427,0.0005913,48.22
2,44,2003,2047,0.0013435,0.0006437,47.25
2,45,2003,2048,0.0014588,0.0007050,46.28
2,46,2003,2049,0.0015840,0.0007701,45.32
2,47,2003,2050,0.0017152,0.0008286,44.35
2,48,2003,2051,0.0018531,0.0008850,43.39
2,49,2003,2052,0.0020059,0.0009464,42.42
2,50,2003,2053,0.0021845,0.0010131,41.46
2,51,2003,2054,0.0023896,0.0010818,40.51
2,52,2003,2055,0.0026115,0.0011490,39.55
2,53,2003,2056,0.0028474,0.0012218,38.59
2,54,2003,2057,0.0031082,0.0013181,37.64
2,55,2003,2058,0.0034035,0.0014325,36.69
2,56,2003,2059,0.0037277,0.0015521,35.74
2,57,2003,2060,0.0040692,0.0016561,34.80
2,58,2003,2061,0.0044295,0.0017539,33.85
2,59,2003,2062,0.0048296,0.0018700,32.91
2,60,2003,2063,0.0052973,0.0020241,31.97
2,61,2003,2064,0.0058480,0.0022174,31.04
2,62,2003,2065,0.0064757,0.0024426,30.10
2,63,2003,2066,0.0071641,0.0026991,29.18
2,64,2003,2067,0.0078986,0.0029757,28.25
2,65,2003,2068,0.0086645,0.0032393,27.34
2,66,2003,2069,0.0094558,0.0034802,26.42
2,67,2003,2070,0.0103010,0.0037201,25.51
2,68,2003,2071,0.0112531,0.0040012,24.61
2,69,2003,2072,0.0123584,0.0043509,23.70
2,70,2003,2073,0.0136702,0.0048022,22.81
2,71,2003,2074,0.0152518,0.0054153,21.91
2,72,2003,2075,0.0170987,0.0061887,21.03
2,73,2003,2076,0.0190837,0.0070175,20.16
2,74,2003,2077,0.0210750,0.0078064,19.30
2,75,2003,2078,0.0231062,0.0085745,18.45
2,76,2003,2079,0.0253497,0.0094571,17.60
2,77,2003,2080,0.0279666,0.0105862,16.76
2,78,2003,2081,0.0310443,0.0120478,15.94
2,79,2003,2082,0.0345982,0.0138634,15.13
2,80,2003,2083,0.0395295,0.0170262,14.33
2,81,2003,2084,0.0438328,0.0193111,13.57
2,82,2003,2085,0.0485928,0.0218726,12.83
2,83,2003,2086,0.0538556,0.0247577,12.10
2,84,2003,2087,0.0596709,0.0280234,11.40
2,85,2003,2088,0.0660929,0.0317516,10.71
2,86,2003,2089,0.0731799,0.0359957,10.05
2,87,2003,2090,0.0809950,0.0407860,9.40
2,88,2003,2091,0.0896059,0.0461884,8.78
2,89,2003,2092,0.0990850,0.0522971,8.18
2,90,2003,2093,0.1095094,0.0592423,7.61
2,91,2003,2094,0.1209607,0.0671106,7.06
2,92,2003,2095,0.1335249,0.0759903,6.53
2,93,2003,2096,0.1472918,0.0860440,6.02
2,94,2003,2097,0.1623547,0.0974727,5.54
2,95,2003,2098,0.1788093,0.1104579,5.09
2,96,2003,2099,0.1967531,0.1251254,4.66
2,97,2003,2100,0.2162837,0.1416301,4.25
2,98,2003,2101,0.2374976,0.1602250,3.87
2,99,2003,2102,0.2604884,0.1812050,3.51
2,100,2003,2103,0.2853445,0.2048279,3.18
2,101,2003,2104,0.3121468,0.2312709,2.87
2,102,2003,2105,0.3409660,0.2607317,2.59
2,103,2003,2106,0.3718598,0.2935002,2.32
2,104,2003,2107,0.4048696,0.3298715,2.08
2,105,2003,2108,0.4400178,0.3700486,1.86
2,106,2003,2109,0.4773042,0.4141190,1.65
2,107,2003,2110,0.5167037,0.4621607,1.47
2,108,2003,2111,0.5581634,0.5142610,1.30
2,109,2003,2112,0.6016004,0.5704069,1.15
2,110,2003,2113,0.6469012,0.6304246,1.01
2,111,2003,2114,0.6939204,0.6940131,0.89
2,112,2003,2115,0.7424819,0.7608102,0.78
2,113,2003,2116,0.7923800,0.8303419,0.69
2,114,2003,2117,0.8433824,0.9019693,0.60
2,115,2003,2118,1.0000000,1.0000000,0.50
2,0,2004,2004,0.0078006,0.0104081,89.54
2,1,2004,2005,0.0005341,0.0007931,89.48
2,2,2004,2006,0.0002805,0.0003887,88.55
2,3,2004,2007,0.0001960,0.0002550,87.58
2,4,2004,2008,0.0001520,0.0001884,86.61
2,5,2004,2009,0.0001465,0.0001715,85.62
2,6,2004,2010,0.0001399,0.0001556,84.64
2,7,2004,2011,0.0001348,0.0001432,83.65
2,8,2004,2012,0.0001336,0.0001367,82.66
2,9,2004,2013,0.0001377,0.0001364,81.67
2,10,2004,2014,0.0001465,0.0001408,80.68
2,11,2004,2015,0.0001596,0.0001491,79.70
2,12,2004,2016,0.0001783,0.0001628,78.71
2,13,2004,2017,0.0002061,0.0001851,77.72
2,14,2004,2018,0.0002415,0.0002145,76.73
2,15,2004,2019,0.0002756,0.0002415,75.75
2,16,2004,2020,0.0003003,0.0002577,74.77
2,17,2004,2021,0.0003175,0.0002648,73.79
2,18,2004,2022,0.0003342,0.0002708,72.81
2,19,2004,2023,0.0003539,0.0002800,71.83
2,20,2004,2024,0.0003732,0.0002888,70.85
2,21,2004,2025,0.0003859,0.0002903,69.87
2,22,2004,2026,0.0003897,0.0002826,68.89
2,23,2004,2027,0.0003908,0.0002726,67.91
2,24,2004,2028,0.0003983,0.0002694,66.93
2,25,2004,2029,0.0004147,0.0002742,65.94
2,26,2004,2030,0.0004348,0.0002814,64.96
2,27,2004,2031,0.0004528,0.0002854,63.98
2,28,2004,2032,0.0004684,0.0002886,63.00
2,29,2004,2033,0.0004856,0.0002931,62.02
2,30,2004,2034,0.0005091,0.0003012,61.03
2,31,2004,2035,0.0005408,0.0003127,60.05
2,32,2004,2036,0.0005796,0.0003268,59.07
2,33,2004,2037,0.0006220,0.0003413,58.09
2,34,2004,2038,0.0006665,0.0003556,57.11
2,35,2004,2039,0.0007153,0.0003702,56.13
2,36,2004,2040,0.0007710,0.0003895,55.15
2,37,2004,2041,0.0008314,0.0004093,54.17
2,38,2004,2042,0.0008908,0.0004305,53.19
2,39,2004,2043,0.0009481,0.0004542,52.22
2,40,2004,2044,0.0010090,0.0004810,51.24
2,41,2004,2045,0.0010784,0.0005097,50.26
2,42,2004,2046,0.0011559,0.0005403,49.29
2,43,2004,2047,0.0012427,0.0005784,48.32
2,44,2004,2048,0.0013435,0.0006312,47.34
2,45,2004,2049,0.0014588,0.0006914,46.37
2,46,2004,2050,0.0015840,0.0007544,45.40
2,47,2004,2051,0.0017152,0.0008116,44.44
2,48,2004,2052,0.0018531,0.0008681,43.47
2,49,2004,2053,0.0020059,0.0009297,42.51
2,50,2004,2054,0.0021845,0.0009946,41.55
2,51,2004,2055,0.0023896,0.0010601,40.59
2,52,2004,2056,0.0026115,0.0011251,39.63
2,53,2004,2057,0.0028474,0.0011978,38.68
2,54,2004,2058,0.0031082,0.0012943,37.72
2,55,2004,2059,0.0034035,0.0014064,36.77
2,56,2004,2060,0.0037277,0.0015215,35.82
2,57,2004,2061,0.0040692,0.0016226,34.88
2,58,2004,2062,0.0044295,0.0017202,33.93
2,59,2004,2063,0.0048296,0.0018365,32.99
2,60,2004,2064,0.0052973,0.0019870,32.05
2,61,2004,2065,0.0058480,0.0021736,31.11
2,62,2004,2066,0.0064757,0.0023939,30.18
2,63,2004,2067,0.0071641,0.0026493,29.25
2,64,2004,2068,0.0078986,0.0029259,28.33
2,65,2004,2069,0.0086645,0.0031843,27.41
2,66,2004,2070,0.0094558,0.0034160,26.50
2,67,2004,2071,0.0103010,0.0036499,25.58
2,68,2004,2072,0.0112531,0.0039303,24.68
2,69,2004,2073,0.0123584,0.0042799,23.77
2,70,2004,2074,0.0136702,0.0047231,22.87
2,71,2004,2075,0.0152518,0.0053206,21.98
2,72,2004,2076,0.0170987,0.0060818,21.09
2,73,2004,2077,0.0190837,0.0069069,20.22
2,74,2004,2078,0.0210750,0.0076950,19.36
2,75,2004,2079,0.0231062,0.0084511,18.50
2,76,2004,2080,0.0253497,0.0093119,17.66
2,77,2004,2081,0.0279666,0.0104247,16.82
2,78,2004,2082,0.0310443,0.0118815,15.99
2,79,2004,2083,0.0345982,0.0136944,15.17
2,80,2004,2084,0.0395295,0.0168327,14.38
2,81,2004,2085,0.0438328,0.0190816,13.62
2,82,2004,2086,0.0485928,0.0216169,12.87
2,83,2004,2087,0.0538556,0.0244957,12.14
2,84,2004,2088,0.0596709,0.0277591,11.44
2,85,2004,2089,0.0660929,0.0314564,10.75
2,86,2004,2090,0.0731799,0.0356468,10.08
2,87,2004,2091,0.0809950,0.0403996,9.44
2,88,2004,2092,0.0896059,0.0457949,8.81
2,89,2004,2093,0.0990850,0.0519025,8.21
2,90,2004,2094,0.1095094,0.0588047,7.63
2,91,2004,2095,0.1209607,0.0665977,7.08
2,92,2004,2096,0.1335249,0.0754280,6.55
2,93,2004,2097,0.1472918,0.0854783,6.04
2,94,2004,2098,0.1623547,0.0969143,5.56
2,95,2004,2099,0.1788093,0.1098500,5.10
2,96,2004,2100,0.1967531,0.1244271,4.67
2,97,2004,2101,0.2162837,0.1408813,4.26
2,98,2004,2102,0.2374976,0.1594918,3.88
2,99,2004,2103,0.2604884,0.1805069,3.52
2,100,2004,2104,0.2853445,0.2041012,3.19
2,101,2004,2105,0.3121468,0.2304723,2.88
2,102,2004,2106,0.3409660,0.2599157,2.59
2,103,2004,2107,0.3718598,0.2927449,2.33
2,104,2004,2108,0.4048696,0.3291951,2.08
2,105,2004,2109,0.4400178,0.3693938,1.86
2,106,2004,2110,0.4773042,0.4134704,1.66
2,107,2004,2111,0.5167037,0.4615858,1.47
2,108,2004,2112,0.5581634,0.5138246,1.30
2,109,2004,2113,0.6016004,0.5701197,1.15
2,110,2004,2114,0.6469012,0.6302694,1.01
2,111,2004,2115,0.6939204,0.6940141,0.89
2,112,2004,2116,0.7424819,0.7610011,0.78
2,113,2004,2117,0.7923800,0.8307117,0.69
2,114,2004,2118,0.8433824,0.9024952,0.60
2,115,2004,2119,1.0000000,1.0000000,0.50
2,0,2005,2005,0.0078006,0.0100853,89.68
2,1,2005,2006,0.0005341,0.0007547,89.59
2,2,2005,2007,0.0002805,0.0003717,88.66
2,3,2005,2008,0.0001960,0.0002449,87.69
2,4,2005,2009,0.0001520,0.0001806,86.71
2,5,2005,2010,0.0001465,0.0001643,85.73
2,6,2005,2011,0.0001399,0.0001494,84.74
2,7,2005,2012,0.0001348,0.0001381,83.76
2,8,2005,2013,0.0001336,0.0001322,82.77
2,9,2005,2014,0.0001377,0.0001318,81.78
2,10,2005,2015,0.0001465,0.0001360,80.79
2,11,2005,2016,0.0001596,0.0001444,79.80
2,12,2005,2017,0.0001783,0.0001584,78.81
2,13,2005,2018,0.0002061,0.0001809,77.82
2,14,2005,2019,0.0002415,0.0002099,76.84
2,15,2005,2020,0.0002756,0.0002362,75.85
2,16,2005,2021,0.0003003,0.0002519,74.87
2,17,2005,2022,0.0003175,0.0002590,73.89
2,18,2005,2023,0.0003342,0.0002652,72.91
2,19,2005,2024,0.0003539,0.0002740,71.93
2,20,2005,2025,0.0003732,0.0002820,70.95
2,21,2005,2026,0.0003859,0.0002832,69.97
2,22,2005,2027,0.0003897,0.0002758,68.99
2,23,2005,2028,0.0003908,0.0002663,68.01
2,24,2005,2029,0.0003983,0.0002629,67.02
2,25,2005,2030,0.0004147,0.0002671,66.04
2,26,2005,2031,0.0004348,0.0002739,65.06
2,27,2005,2032,0.0004528,0.0002783,64.08
2,28,2005,2033,0.0004684,0.0002820,63.10
2,29,2005,2034,0.0004856,0.0002863,62.11
2,30,2005,2035,0.0005091,0.0002936,61.13
2,31,2005,2036,0.0005408,0.0003047,60.15
2,32,2005,2037,0.0005796,0.0003189,59.17
2,33,2005,2038,0.0006220,0.0003336,58.19
2,34,2005,2039,0.0006665,0.0003473,57.20
2,35,2005,2040,0.0007153,0.0003607,56.22
2,36,2005,2041,0.0007710,0.0003793,55.24
2,37,2005,2042,0.0008314,0.0003992,54.26
2,38,2005,2043,0.0008908,0.0004208,53.29
2,39,2005,2044,0.0009481,0.0004440,52.31
2,40,2005,2045,0.0010090,0.0004695,51.33
2,41,2005,2046,0.0010784,0.0004975,50.36
2,42,2005,2047,0.0011559,0.0005283,49.38
2,43,2005,2048,0.0012427,0.0005667,48.41
2,44,2005,2049,0.0013435,0.0006185,47.43
2,45,2005,2050,0.0014588,0.0006768,46.46
2,46,2005,2051,0.0015840,0.0007386,45.49
2,47,2005,2052,0.0017152,0.0007959,44.53
2,48,2005,2053,0.0018531,0.0008527,43.56
2,49,2005,2054,0.0020059,0.0009127,42.60
2,50,2005,2055,0.0021845,0.0009748,41.64
2,51,2005,2056,0.0023896,0.0010383,40.68
2,52,2005,2057,0.0026115,0.0011031,39.72
2,53,2005,2058,0.0028474,0.0011760,38.76
2,54,2005,2059,0.0031082,0.0012704,37.81
2,55,2005,2060,0.0034035,0.0013784,36.85
2,56,2005,2061,0.0037277,0.0014909,35.90
2,57,2005,2062,0.0040692,0.0015917,34.96
2,58,2005,2063,0.0044295,0.0016895,34.01
2,59,2005,2064,0.0048296,0.0018026,33.07
2,60,2005,2065,0.0052973,0.0019472,32.13
2,61,2005,2066,0.0058480,0.0021295,31.19
2,62,2005,2067,0.0064757,0.0023489,30.26
2,63,2005,2068,0.0071641,0.0026041,29.33
2,64,2005,2069,0.0078986,0.0028757,28.40
2,65,2005,2070,0.0086645,0.0031256,27.48
2,66,2005,2071,0.0094558,0.0033516,26.57
2,67,2005,2072,0.0103010,0.0035850,25.65
2,68,2005,2073,0.0112531,0.0038657,24.74
2,69,2005,2074,0.0123584,0.0042084,23.84
2,70,2005,2075,0.0136702,0.0046384,22.94
2,71,2005,2076,0.0152518,0.0052254,22.04
2,72,2005,2077,0.0170987,0.0059828,21.15
2,73,2005,2078,0.0190837,0.0068060,20.28
2,74,2005,2079,0.0210750,0.0075825,19.41
2,75,2005,2080,0.0231062,0.0083188,18.56
2,76,2005,2081,0.0253497,0.0091655,17.71
2,77,2005,2082,0.0279666,0.0102747,16.87
2,78,2005,2083,0.0310443,0.0117295,16.04
2,79,2005,2084,0.0345982,0.0135233,15.22
2,80,2005,2085,0.0395295,0.0166244,14.43
2,81,2005,2086,0.0438328,0.0188493,13.66
2,82,2005,2087,0.0485928,0.0213786,12.91
2,83,2005,2088,0.0538556,0.0242550,12.19
2,84,2005,2089,0.0596709,0.0274899,11.48
2,85,2005,2090,0.0660929,0.0311376,10.79
2,86,2005,2091,0.0731799,0.0352930,10.12
2,87,2005,2092,0.0809950,0.0400386,9.47
2,88,2005,2093,0.0896059,0.0454323,8.84
2,89,2005,2094,0.0990850,0.0514993,8.24
2,90,2005,2095,0.1095094,0.0583309,7.66
2,91,2005,2096,0.1209607,0.0660765,7.10
2,92,2005,2097,0.1335249,0.0749018,6.57
2,93,2005,2098,0.1472918,0.0849566,6.06
2,94,2005,2099,0.1623547,0.0963436,5.58
2,95,2005,2100,0.1788093,0.1091909,5.12
2,96,2005,2101,0.1967531,0.1237159,4.69
2,97,2005,2102,0.2162837,0.1401798,4.28
2,98,2005,2103,0.2374976,0.1588183,3.89
2,99,2005,2104,0.2604884,0.1797989,3.53
2,100,2005,2105,0.2853445,0.2033141,3.20
2,101,2005,2106,0.3121468,0.2296570,2.89
2,102,2005,2107,0.3409660,0.2591485,2.60
2,103,2005,2108,0.3718598,0.2920437,2.33
2,104,2005,2109,0.4048696,0.3284984,2.09
2,105,2005,2110,0.4400178,0.3686800,1.86
2,106,2005,2111,0.4773042,0.4128072,1.66
2,107,2005,2112,0.5167037,0.4610449,1.47
2,108,2005,2113,0.5581634,0.5134209,1.30
2,109,2005,2114,0.6016004,0.5698259,1.15
2,110,2005,2115,0.6469012,0.6301005,1.02
2,111,2005,2116,0.6939204,0.6940151,0.89
2,112,2005,2117,0.7424819,0.7611811,0.78
2,113,2005,2118,0.7923800,0.8310558,0.69
2,114,2005,2119,0.8433824,0.9030377,0.60
2,115,2005,2120,1.0000000,1.0000000,0.50
2,0,2006,2006,0.0078005,0.0097651,89.82
2,1,2006,2007,0.0005341,0.0007199,89.70
2,2,2006,2008,0.0002805,0.0003561,88.77
2,3,2006,2009,0.0001960,0.0002344,87.80
2,4,2006,2010,0.0001520,0.0001723,86.82
2,5,2006,2011,0.0001465,0.0001572,85.84
2,6,2006,2012,0.0001399,0.0001436,84.85
2,7,2006,2013,0.0001348,0.0001332,83.86
2,8,2006,2014,0.0001336,0.0001274,82.87
2,9,2006,2015,0.0001377,0.0001268,81.88
2,10,2006,2016,0.0001465,0.0001312,80.89
2,11,2006,2017,0.0001596,0.0001400,79.90
2,12,2006,2018,0.0001783,0.0001544,78.91
2,13,2006,2019,0.0002061,0.0001766,77.93
2,14,2006,2020,0.0002415,0.0002050,76.94
2,15,2006,2021,0.0002756,0.0002309,75.96
2,16,2006,2022,0.0003003,0.0002466,74.97
2,17,2006,2023,0.0003175,0.0002538,73.99
2,18,2006,2024,0.0003342,0.0002595,73.01
2,19,2006,2025,0.0003539,0.0002675,72.03
2,20,2006,2026,0.0003732,0.0002752,71.05
2,21,2006,2027,0.0003859,0.0002766,70.07
2,22,2006,2028,0.0003897,0.0002697,69.09
2,23,2006,2029,0.0003908,0.0002600,68.11
2,24,2006,2030,0.0003983,0.0002560,67.12
2,25,2006,2031,0.0004147,0.0002599,66.14
2,26,2006,2032,0.0004348,0.0002671,65.16
2,27,2006,2033,0.0004528,0.0002719,64.17
2,28,2006,2034,0.0004684,0.0002754,63.19
2,29,2006,2035,0.0004856,0.0002790,62.21
2,30,2006,2036,0.0005091,0.0002860,61.23
2,31,2006,2037,0.0005408,0.0002974,60.24
2,32,2006,2038,0.0005796,0.0003118,59.26
2,33,2006,2039,0.0006220,0.0003259,58.28
2,34,2006,2040,0.0006665,0.0003386,57.30
2,35,2006,2041,0.0007153,0.0003513,56.32
2,36,2006,2042,0.0007710,0.0003700,55.34
2,37,2006,2043,0.0008314,0.0003902,54.36
2,38,2006,2044,0.0008908,0.0004111,53.38
2,39,2006,2045,0.0009481,0.0004331,52.40
2,40,2006,2046,0.0010090,0.0004580,51.42
2,41,2006,2047,0.0010784,0.0004862,50.45
2,42,2006,2048,0.0011559,0.0005174,49.47
2,43,2006,2049,0.0012427,0.0005549,48.50
2,44,2006,2050,0.0013435,0.0006050,47.52
2,45,2006,2051,0.0014588,0.0006621,46.55
2,46,2006,2052,0.0015840,0.0007241,45.58
2,47,2006,2053,0.0017152,0.0007816,44.61
2,48,2006,2054,0.0018531,0.0008369,43.65
2,49,2006,2055,0.0020059,0.0008945,42.68
2,50,2006,2056,0.0021845,0.0009549,41.72
2,51,2006,2057,0.0023896,0.0010182,40.76
2,52,2006,2058,0.0026115,0.0010831,39.80
2,53,2006,2059,0.0028474,0.0011541,38.85
2,54,2006,2060,0.0031082,0.0012449,37.89
2,55,2006,2061,0.0034035,0.0013504,36.94
2,56,2006,2062,0.0037277,0.0014625,35.99
2,57,2006,2063,0.0040692,0.0015635,35.04
2,58,2006,2064,0.0044295,0.0016585,34.09
2,59,2006,2065,0.0048296,0.0017664,33.15
2,60,2006,2066,0.0052973,0.0019074,32.21
2,61,2006,2067,0.0058480,0.0020889,31.27
2,62,2006,2068,0.0064757,0.0023080,30.33
2,63,2006,2069,0.0071641,0.0025586,29.40
2,64,2006,2070,0.0078986,0.0028222,28.47
2,65,2006,2071,0.0086645,0.0030665,27.55
2,66,2006,2072,0.0094558,0.0032920,26.64
2,67,2006,2073,0.0103010,0.0035259,25.72
2,68,2006,2074,0.0112531,0.0038007,24.81
2,69,2006,2075,0.0123584,0.0041319,23.90
2,70,2006,2076,0.0136702,0.0045532,23.00
2,71,2006,2077,0.0152518,0.0051372,22.10
2,72,2006,2078,0.0170987,0.0058925,21.22
2,73,2006,2079,0.0190837,0.0067042,20.34
2,74,2006,2080,0.0210750,0.0074618,19.47
2,75,2006,2081,0.0231062,0.0081854,18.62
2,76,2006,2082,0.0253497,0.0090297,17.76
2,77,2006,2083,0.0279666,0.0101378,16.92
2,78,2006,2084,0.0310443,0.0115758,16.09
2,79,2006,2085,0.0345982,0.0133394,15.27
2,80,2006,2086,0.0395295,0.0164139,14.47
2,81,2006,2087,0.0438328,0.0186331,13.71
2,82,2006,2088,0.0485928,0.0211599,12.96
2,83,2006,2089,0.0538556,0.0240100,12.23
2,84,2006,2090,0.0596709,0.0271993,11.51
2,85,2006,2091,0.0660929,0.0308145,10.82
2,86,2006,2092,0.0731799,0.0349628,10.15
2,87,2006,2093,0.0809950,0.0397062,9.50
2,88,2006,2094,0.0896059,0.0450620,8.87
2,89,2006,2095,0.0990850,0.0510631,8.27
2,90,2006,2096,0.1095094,0.0578496,7.69
2,91,2006,2097,0.1209607,0.0655890,7.13
2,92,2006,2098,0.1335249,0.0744166,6.59
2,93,2006,2099,0.1472918,0.0844237,6.08
2,94,2006,2100,0.1623547,0.0957251,5.60
2,95,2006,2101,0.1788093,0.1085199,5.14
2,96,2006,2102,0.1967531,0.1230499,4.70
2,97,2006,2103,0.2162837,0.1395358,4.29
2,98,2006,2104,0.2374976,0.1581354,3.90
2,99,2006,2105,0.2604884,0.1790324,3.54
2,100,2006,2106,0.2853445,0.2025110,3.21
2,101,2006,2107,0.3121468,0.2288908,2.89
2,102,2006,2108,0.3409660,0.2584365,2.60
2,103,2006,2109,0.3718598,0.2913218,2.34
2,104,2006,2110,0.4048696,0.3277393,2.09
2,105,2006,2111,0.4400178,0.3679502,1.87
2,106,2006,2112,0.4773042,0.4121832,1.66
2,107,2006,2113,0.5167037,0.4605446,1.47
2,108,2006,2114,0.5581634,0.5130079,1.30
2,109,2006,2115,0.6016004,0.5695062,1.15
2,110,2006,2116,0.6469012,0.6299276,1.02
2,111,2006,2117,0.6939204,0.6940160,0.89
2,112,2006,2118,0.7424819,0.7613486,0.78
2,113,2006,2119,0.7923800,0.8314109,0.68
2,114,2006,2120,0.8433824,0.9036301,0.60
2,115,2006,2121,1.0000000,1.0000000,0.50
2,0,2007,2007,0.0078005,0.0094705,89.96
2,1,2007,2008,0.0005341,0.0006878,89.81
2,2,2007,2009,0.0002805,0.0003397,88.88
2,3,2007,2010,0.0001960,0.0002232,87.91
2,4,2007,2011,0.0001520,0.0001642,86.93
2,5,2007,2012,0.0001465,0.0001507,85.94
2,6,2007,2013,0.0001399,0.0001382,84.95
2,7,2007,2014,0.0001348,0.0001280,83.96
2,8,2007,2015,0.0001336,0.0001222,82.98
2,9,2007,2016,0.0001377,0.0001219,81.99
2,10,2007,2017,0.0001465,0.0001269,81.00
2,11,2007,2018,0.0001596,0.0001361,80.01
2,12,2007,2019,0.0001783,0.0001504,79.02
2,13,2007,2020,0.0002061,0.0001721,78.03
2,14,2007,2021,0.0002415,0.0002001,77.04
2,15,2007,2022,0.0002756,0.0002260,76.06
2,16,2007,2023,0.0003003,0.0002418,75.07
2,17,2007,2024,0.0003175,0.0002485,74.09
2,18,2007,2025,0.0003342,0.0002535,73.11
2,19,2007,2026,0.0003539,0.0002611,72.13
2,20,2007,2027,0.0003732,0.0002690,71.15
2,21,2007,2028,0.0003859,0.0002707,70.17
2,22,2007,2029,0.0003897,0.0002635,69.19
2,23,2007,2030,0.0003908,0.0002532,68.20
2,24,2007,2031,0.0003983,0.0002491,67.22
2,25,2007,2032,0.0004147,0.0002533,66.24
2,26,2007,2033,0.0004348,0.0002609,65.25
2,27,2007,2034,0.0004528,0.0002655,64.27
2,28,2007,2035,0.0004684,0.0002684,63.29
2,29,2007,2036,0.0004856,0.0002718,62.30
2,30,2007,2037,0.0005091,0.0002791,61.32
2,31,2007,2038,0.0005408,0.0002907,60.34
2,32,2007,2039,0.0005796,0.0003046,59.36
2,33,2007,2040,0.0006220,0.0003177,58.37
2,34,2007,2041,0.0006665,0.0003298,57.39
2,35,2007,2042,0.0007153,0.0003426,56.41
2,36,2007,2043,0.0007710,0.0003616,55.43
2,37,2007,2044,0.0008314,0.0003811,54.45
2,38,2007,2045,0.0008908,0.0004009,53.47
2,39,2007,2046,0.0009481,0.0004223,52.49
2,40,2007,2047,0.0010090,0.0004474,51.51
2,41,2007,2048,0.0010784,0.0004760,50.54
2,42,2007,2049,0.0011559,0.0005063,49.56
2,43,2007,2050,0.0012427,0.0005423,48.58
2,44,2007,2051,0.0013435,0.0005914,47.61
2,45,2007,2052,0.0014588,0.0006486,46.64
2,46,2007,2053,0.0015840,0.0007108,45.67
2,47,2007,2054,0.0017152,0.0007670,44.70
2,48,2007,2055,0.0018531,0.0008201,43.73
2,49,2007,2056,0.0020059,0.0008762,42.77
2,50,2007,2057,0.0021845,0.0009366,41.81
2,51,2007,2058,0.0023896,0.0009999,40.85
2,52,2007,2059,0.0026115,0.0010630,39.89
2,53,2007,2060,0.0028474,0.0011307,38.93
2,54,2007,2061,0.0031082,0.0012193,37.97
2,55,2007,2062,0.0034035,0.0013245,37.02
2,56,2007,2063,0.0037277,0.0014367,36.07
2,57,2007,2064,0.0040692,0.0015350,35.12
2,58,2007,2065,0.0044295,0.0016252,34.17
2,59,2007,2066,0.0048296,0.0017300,33.23
2,60,2007,2067,0.0052973,0.0018706,32.28
2,61,2007,2068,0.0058480,0.0020520,31.34
2,62,2007,2069,0.0064757,0.0022670,30.41
2,63,2007,2070,0.0071641,0.0025101,29.47
2,64,2007,2071,0.0078986,0.0027684,28.55
2,65,2007,2072,0.0086645,0.0030119,27.62
2,66,2007,2073,0.0094558,0.0032378,26.71
2,67,2007,2074,0.0103010,0.0034664,25.79
2,68,2007,2075,0.0112531,0.0037311,24.88
2,69,2007,2076,0.0123584,0.0040551,23.97
2,70,2007,2077,0.0136702,0.0044744,23.07
2,71,2007,2078,0.0152518,0.0050570,22.17
2,72,2007,2079,0.0170987,0.0058015,21.28
2,73,2007,2080,0.0190837,0.0065951,20.40
2,74,2007,2081,0.0210750,0.0073403,19.53
2,75,2007,2082,0.0231062,0.0080618,18.67
2,76,2007,2083,0.0253497,0.0089057,17.82
2,77,2007,2084,0.0279666,0.0099993,16.97
2,78,2007,2085,0.0310443,0.0114106,16.14
2,79,2007,2086,0.0345982,0.0131537,15.32
2,80,2007,2087,0.0395295,0.0162179,14.52
2,81,2007,2088,0.0438328,0.0184346,13.75
2,82,2007,2089,0.0485928,0.0209373,13.00
2,83,2007,2090,0.0538556,0.0237457,12.27
2,84,2007,2091,0.0596709,0.0269050,11.55
2,85,2007,2092,0.0660929,0.0305130,10.86
2,86,2007,2093,0.0731799,0.0346587,10.18
2,87,2007,2094,0.0809950,0.0393669,9.53
2,88,2007,2095,0.0896059,0.0446615,8.90
2,89,2007,2096,0.0990850,0.0506202,8.29
2,90,2007,2097,0.1095094,0.0573997,7.71
2,91,2007,2098,0.1209607,0.0651398,7.15
2,92,2007,2099,0.1335249,0.0739213,6.61
2,93,2007,2100,0.1472918,0.0838464,6.10
2,94,2007,2101,0.1623547,0.0950958,5.61
2,95,2007,2102,0.1788093,0.1078918,5.15
2,96,2007,2103,0.1967531,0.1224387,4.71
2,97,2007,2104,0.2162837,0.1388830,4.30
2,98,2007,2105,0.2374976,0.1573966,3.91
2,99,2007,2106,0.2604884,0.1782506,3.55
2,100,2007,2107,0.2853445,0.2017565,3.21
2,101,2007,2108,0.3121468,0.2281800,2.90
2,102,2007,2109,0.3409660,0.2577037,2.61
2,103,2007,2110,0.3718598,0.2905354,2.34
2,104,2007,2111,0.4048696,0.3269635,2.09
2,105,2007,2112,0.4400178,0.3672639,1.87
2,106,2007,2113,0.4773042,0.4116063,1.66
2,107,2007,2114,0.5167037,0.4600330,1.48
2,108,2007,2115,0.5581634,0.5125586,1.31
2,109,2007,2116,0.6016004,0.5691789,1.15
2,110,2007,2117,0.6469012,0.6297646,1.02
2,111,2007,2118,0.6939204,0.6940168,0.89
2,112,2007,2119,0.7424819,0.7615214,0.78
2,113,2007,2120,0.7923800,0.8317986,0.68
2,114,2007,2121,0.8433824,0.9042367,0.60
2,115,2007,2122,1.0000000,1.0000000,0.50
2,0,2008,2008,0.0078005,0.0091938,90.09
2,1,2008,2009,0.0005341,0.0006543,89.92
2,2,2008,2010,0.0002805,0.0003224,88.98
2,3,2008,2011,0.0001960,0.0002123,88.01
2,4,2008,2012,0.0001520,0.0001568,87.03
2,5,2008,2013,0.0001465,0.0001445,86.04
2,6,2008,2014,0.0001399,0.0001323,85.06
2,7,2008,2015,0.0001348,0.0001223,84.07
2,8,2008,2016,0.0001336,0.0001170,83.08
2,9,2008,2017,0.0001377,0.0001175,82.09
2,10,2008,2018,0.0001465,0.0001230,81.10
2,11,2008,2019,0.0001596,0.0001322,80.11
2,12,2008,2020,0.0001783,0.0001461,79.12
2,13,2008,2021,0.0002061,0.0001676,78.13
2,14,2008,2022,0.0002415,0.0001956,77.14
2,15,2008,2023,0.0002756,0.0002215,76.16
2,16,2008,2024,0.0003003,0.0002370,75.17
2,17,2008,2025,0.0003175,0.0002430,74.19
2,18,2008,2026,0.0003342,0.0002474,73.21
2,19,2008,2027,0.0003539,0.0002552,72.23
2,20,2008,2028,0.0003732,0.0002633,71.25
2,21,2008,2029,0.0003859,0.0002648,70.26
2,22,2008,2030,0.0003897,0.0002570,69.28
2,23,2008,2031,0.0003908,0.0002465,68.30
2,24,2008,2032,0.0003983,0.0002428,67.32
2,25,2008,2033,0.0004147,0.0002474,66.33
2,26,2008,2034,0.0004348,0.0002548,65.35
2,27,2008,2035,0.0004528,0.0002587,64.37
2,28,2008,2036,0.0004684,0.0002614,63.38
2,29,2008,2037,0.0004856,0.0002652,62.40
2,30,2008,2038,0.0005091,0.0002728,61.42
2,31,2008,2039,0.0005408,0.0002840,60.43
2,32,2008,2040,0.0005796,0.0002970,59.45
2,33,2008,2041,0.0006220,0.0003096,58.47
2,34,2008,2042,0.0006665,0.0003218,57.48
2,35,2008,2043,0.0007153,0.0003348,56.50
2,36,2008,2044,0.0007710,0.0003532,55.52
2,37,2008,2045,0.0008314,0.0003716,54.54
2,38,2008,2046,0.0008908,0.0003906,53.56
2,39,2008,2047,0.0009481,0.0004123,52.58
2,40,2008,2048,0.0010090,0.0004378,51.60
2,41,2008,2049,0.0010784,0.0004656,50.63
2,42,2008,2050,0.0011559,0.0004945,49.65
2,43,2008,2051,0.0012427,0.0005296,48.67
2,44,2008,2052,0.0013435,0.0005789,47.70
2,45,2008,2053,0.0014588,0.0006363,46.73
2,46,2008,2054,0.0015840,0.0006973,45.76
2,47,2008,2055,0.0017152,0.0007513,44.79
2,48,2008,2056,0.0018531,0.0008032,43.82
2,49,2008,2057,0.0020059,0.0008594,42.86
2,50,2008,2058,0.0021845,0.0009199,41.89
2,51,2008,2059,0.0023896,0.0009816,40.93
2,52,2008,2060,0.0026115,0.0010415,39.97
2,53,2008,2061,0.0028474,0.0011072,39.01
2,54,2008,2062,0.0031082,0.0011956,38.05
2,55,2008,2063,0.0034035,0.0013009,37.10
2,56,2008,2064,0.0037277,0.0014106,36.15
2,57,2008,2065,0.0040692,0.0015044,35.20
2,58,2008,2066,0.0044295,0.0015919,34.25
2,59,2008,2067,0.0048296,0.0016965,33.30
2,60,2008,2068,0.0052973,0.0018372,32.36
2,61,2008,2069,0.0058480,0.0020150,31.42
2,62,2008,2070,0.0064757,0.0022231,30.48
2,63,2008,2071,0.0071641,0.0024613,29.55
2,64,2008,2072,0.0078986,0.0027187,28.62
2,65,2008,2073,0.0086645,0.0029623,27.69
2,66,2008,2074,0.0094558,0.0031831,26.78
2,67,2008,2075,0.0103010,0.0034027,25.86
2,68,2008,2076,0.0112531,0.0036612,24.95
2,69,2008,2077,0.0123584,0.0039840,24.04
2,70,2008,2078,0.0136702,0.0044027,23.13
2,71,2008,2079,0.0152518,0.0049761,22.23
2,72,2008,2080,0.0170987,0.0057040,21.34
2,73,2008,2081,0.0190837,0.0064853,20.46
2,74,2008,2082,0.0210750,0.0072277,19.59
2,75,2008,2083,0.0231062,0.0079489,18.73
2,76,2008,2084,0.0253497,0.0087804,17.87
2,77,2008,2085,0.0279666,0.0098507,17.03
2,78,2008,2086,0.0310443,0.0112439,16.19
2,79,2008,2087,0.0345982,0.0129811,15.37
2,80,2008,2088,0.0395295,0.0160380,14.57
2,81,2008,2089,0.0438328,0.0182327,13.79
2,82,2008,2090,0.0485928,0.0206973,13.04
2,83,2008,2091,0.0538556,0.0234781,12.31
2,84,2008,2092,0.0596709,0.0266305,11.59
2,85,2008,2093,0.0660929,0.0302356,10.89
2,86,2008,2094,0.0731799,0.0343485,10.22
2,87,2008,2095,0.0809950,0.0390000,9.56
2,88,2008,2096,0.0896059,0.0442550,8.93
2,89,2008,2097,0.0990850,0.0502063,8.32
2,90,2008,2098,0.1095094,0.0569852,7.74
2,91,2008,2099,0.1209607,0.0646812,7.17
2,92,2008,2100,0.1335249,0.0733849,6.63
2,93,2008,2101,0.1472918,0.0832592,6.12
2,94,2008,2102,0.1623547,0.0945070,5.63
2,95,2008,2103,0.1788093,0.1073157,5.17
2,96,2008,2104,0.1967531,0.1218195,4.73
2,97,2008,2105,0.2162837,0.1381770,4.31
2,98,2008,2106,0.2374976,0.1566433,3.92
2,99,2008,2107,0.2604884,0.1775165,3.56
2,100,2008,2108,0.2853445,0.2010568,3.22
2,101,2008,2109,0.3121468,0.2274487,2.91
2,102,2008,2110,0.3409660,0.2569058,2.61
2,103,2008,2111,0.3718598,0.2897320,2.34
2,104,2008,2112,0.4048696,0.3262342,2.10
2,105,2008,2113,0.4400178,0.3666297,1.87
2,106,2008,2114,0.4773042,0.4110165,1.66
2,107,2008,2115,0.5167037,0.4594765,1.48
2,108,2008,2116,0.5581634,0.5120989,1.31
2,109,2008,2117,0.6016004,0.5688705,1.15
2,110,2008,2118,0.6469012,0.6296129,1.02
2,111,2008,2119,0.6939204,0.6940177,0.89
2,112,2008,2120,0.7424819,0.7617100,0.78
2,113,2008,2121,0.7923800,0.8321956,0.68
2,114,2008,2122,0.8433824,0.9048083,0.60
2,115,2008,2123,1.0000000,1.0000000,0.50
2,0,2009,2009,0.0078004,0.0089007,90.22
2,1,2009,2010,0.0005341,0.0006190,90.03
2,2,2009,2011,0.0002805,0.0003055,89.09
2,3,2009,2012,0.0001960,0.0002024,88.12
2,4,2009,2013,0.0001520,0.0001498,87.13
2,5,2009,2014,0.0001465,0.0001379,86.15
2,6,2009,2015,0.0001399,0.0001260,85.16
2,7,2009,2016,0.0001348,0.0001167,84.17
2,8,2009,2017,0.0001336,0.0001124,83.18
2,9,2009,2018,0.0001377,0.0001136,82.19
2,10,2009,2019,0.0001465,0.0001191,81.20
2,11,2009,2020,0.0001596,0.0001281,80.21
2,12,2009,2021,0.0001783,0.0001419,79.22
2,13,2009,2022,0.0002061,0.0001635,78.23
2,14,2009,2023,0.0002415,0.0001915,77.24
2,15,2009,2024,0.0002756,0.0002171,76.26
2,16,2009,2025,0.0003003,0.0002318,75.27
2,17,2009,2026,0.0003175,0.0002374,74.29
2,18,2009,2027,0.0003342,0.0002419,73.31
2,19,2009,2028,0.0003539,0.0002498,72.32
2,20,2009,2029,0.0003732,0.0002576,71.34
2,21,2009,2030,0.0003859,0.0002585,70.36
2,22,2009,2031,0.0003897,0.0002505,69.38
2,23,2009,2032,0.0003908,0.0002404,68.40
2,24,2009,2033,0.0003983,0.0002371,67.41
2,25,2009,2034,0.0004147,0.0002415,66.43
2,26,2009,2035,0.0004348,0.0002482,65.44
2,27,2009,2036,0.0004528,0.0002519,64.46
2,28,2009,2037,0.0004684,0.0002550,63.48
2,29,2009,2038,0.0004856,0.0002591,62.49
2,30,2009,2039,0.0005091,0.0002665,61.51
2,31,2009,2040,0.0005408,0.0002769,60.52
2,32,2009,2041,0.0005796,0.0002894,59.54
2,33,2009,2042,0.0006220,0.0003021,58.56
2,34,2009,2043,0.0006665,0.0003145,57.58
2,35,2009,2044,0.0007153,0.0003271,56.59
2,36,2009,2045,0.0007710,0.0003443,55.61
2,37,2009,2046,0.0008314,0.0003620,54.63
2,38,2009,2047,0.0008908,0.0003812,53.65
2,39,2009,2048,0.0009481,0.0004032,52.67
2,40,2009,2049,0.0010090,0.0004281,51.69
2,41,2009,2050,0.0010784,0.0004546,50.71
2,42,2009,2051,0.0011559,0.0004827,49.74
2,43,2009,2052,0.0012427,0.0005180,48.76
2,44,2009,2053,0.0013435,0.0005674,47.79
2,45,2009,2054,0.0014588,0.0006238,46.81
2,46,2009,2055,0.0015840,0.0006828,45.84
2,47,2009,2056,0.0017152,0.0007357,44.87
2,48,2009,2057,0.0018531,0.0007876,43.91
2,49,2009,2058,0.0020059,0.0008441,42.94
2,50,2009,2059,0.0021845,0.0009031,41.98
2,51,2009,2060,0.0023896,0.0009619,41.01
2,52,2009,2061,0.0026115,0.0010200,40.05
2,53,2009,2062,0.0028474,0.0010855,39.09
2,54,2009,2063,0.0031082,0.0011740,38.13
2,55,2009,2064,0.0034035,0.0012771,37.18
2,56,2009,2065,0.0037277,0.0013826,36.23
2,57,2009,2066,0.0040692,0.0014738,35.27
2,58,2009,2067,0.0044295,0.0015611,34.33
2,59,2009,2068,0.0048296,0.0016661,33.38
2,60,2009,2069,0.0052973,0.0018037,32.43
2,61,2009,2070,0.0058480,0.0019754,31.49
2,62,2009,2071,0.0064757,0.0021791,30.55
2,63,2009,2072,0.0071641,0.0024163,29.62
2,64,2009,2073,0.0078986,0.0026734,28.69
2,65,2009,2074,0.0086645,0.0029122,27.76
2,66,2009,2075,0.0094558,0.0031247,26.84
2,67,2009,2076,0.0103010,0.0033387,25.93
2,68,2009,2077,0.0112531,0.0035965,25.01
2,69,2009,2078,0.0123584,0.0039193,24.10
2,70,2009,2079,0.0136702,0.0043305,23.19
2,71,2009,2080,0.0152518,0.0048895,22.29
2,72,2009,2081,0.0170987,0.0056059,21.40
2,73,2009,2082,0.0190837,0.0063835,20.52
2,74,2009,2083,0.0210750,0.0071249,19.65
2,75,2009,2084,0.0231062,0.0078348,18.78
2,76,2009,2085,0.0253497,0.0086459,17.93
2,77,2009,2086,0.0279666,0.0097007,17.08
2,78,2009,2087,0.0310443,0.0110890,16.24
2,79,2009,2088,0.0345982,0.0128229,15.42
2,80,2009,2089,0.0395295,0.0158553,14.61
2,81,2009,2090,0.0438328,0.0180151,13.84
2,82,2009,2091,0.0485928,0.0204544,13.08
2,83,2009,2092,0.0538556,0.0232286,12.35
2,84,2009,2093,0.0596709,0.0263779,11.63
2,85,2009,2094,0.0660929,0.0299527,10.93
2,86,2009,2095,0.0731799,0.0340132,10.25
2,87,2009,2096,0.0809950,0.0386278,9.60
2,88,2009,2097,0.0896059,0.0438753,8.96
2,89,2009,2098,0.0990850,0.0498251,8.35
2,90,2009,2099,0.1095094,0.0565623,7.76
2,91,2009,2100,0.1209607,0.0641849,7.20
2,92,2009,2101,0.1335249,0.0728395,6.66
2,93,2009,2102,0.1472918,0.0827101,6.14
2,94,2009,2103,0.1623547,0.0939671,5.65
2,95,2009,2104,0.1788093,0.1067322,5.18
2,96,2009,2105,0.1967531,0.1211500,4.74
2,97,2009,2106,0.2162837,0.1374575,4.33
2,98,2009,2107,0.2374976,0.1559362,3.93
2,99,2009,2108,0.2604884,0.1768360,3.57
2,100,2009,2109,0.2853445,0.2003373,3.23
2,101,2009,2110,0.3121468,0.2266528,2.91
2,102,2009,2111,0.3409660,0.2560910,2.62
2,103,2009,2112,0.3718598,0.2889770,2.35
2,104,2009,2113,0.4048696,0.3255604,2.10
2,105,2009,2114,0.4400178,0.3659814,1.87
2,106,2009,2115,0.4773042,0.4103751,1.67
2,107,2009,2116,0.5167037,0.4589072,1.48
2,108,2009,2117,0.5581634,0.5116658,1.31
2,109,2009,2118,0.6016004,0.5685836,1.15
2,110,2009,2119,0.6469012,0.6294565,1.02
2,111,2009,2120,0.6939204,0.6940187,0.89
2,112,2009,2121,0.7424819,0.7619032,0.78
2,113,2009,2122,0.7923800,0.8325698,0.68
2,114,2009,2123,0.8433824,0.9053395,0.59
2,115,2009,2124,1.0000000,1.0000000,0.50
2,0,2010,2010,0.0078004,0.0085855,90.36
2,1,2010,2011,0.0005341,0.0005848,90.14
2,2,2010,2012,0.0002805,0.0002903,89.19
2,3,2010,2013,0.0001960,0.0001931,88.22
2,4,2010,2014,0.0001520,0.0001423,87.24
2,5,2010,2015,0.0001465,0.0001309,86.25
2,6,2010,2016,0.0001399,0.0001199,85.26
2,7,2010,2017,0.0001348,0.0001117,84.27
2,8,2010,2018,0.0001336,0.0001083,83.28
2,9,2010,2019,0.0001377,0.0001096,82.29
2,10,2010,2020,0.0001465,0.0001150,81.30
2,11,2010,2021,0.0001596,0.0001240,80.31
2,12,2010,2022,0.0001783,0.0001380,79.32
2,13,2010,2023,0.0002061,0.0001597,78.33
2,14,2010,2024,0.0002415,0.0001874,77.34
2,15,2010,2025,0.0002756,0.0002123,76.35
2,16,2010,2026,0.0003003,0.0002266,75.37
2,17,2010,2027,0.0003175,0.0002322,74.39
2,18,2010,2028,0.0003342,0.0002368,73.40
2,19,2010,2029,0.0003539,0.0002444,72.42
2,20,2010,2030,0.0003732,0.0002516,71.44
2,21,2010,2031,0.0003859,0.0002521,70.46
2,22,2010,2032,0.0003897,0.0002445,69.47
2,23,2010,2033,0.0003908,0.0002349,68.49
2,24,2010,2034,0.0003983,0.0002314,67.51
2,25,2010,2035,0.0004147,0.0002353,66.52
2,26,2010,2036,0.0004348,0.0002417,65.54
2,27,2010,2037,0.0004528,0.0002457,64.55
2,28,2010,2038,0.0004684,0.0002492,63.57
2,29,2010,2039,0.0004856,0.0002531,62.59
2,30,2010,2040,0.0005091,0.0002598,61.60
2,31,2010,2041,0.0005408,0.0002698,60.62
2,32,2010,2042,0.0005796,0.0002825,59.63
2,33,2010,2043,0.0006220,0.0002953,58.65
2,34,2010,2044,0.0006665,0.0003073,57.67
2,35,2010,2045,0.0007153,0.0003188,56.68
2,36,2010,2046,0.0007710,0.0003355,55.70
2,37,2010,2047,0.0008314,0.0003532,54.72
2,38,2010,2048,0.0008908,0.0003727,53.74
2,39,2010,2049,0.0009481,0.0003940,52.76
2,40,2010,2050,0.0010090,0.0004177,51.78
2,41,2010,2051,0.0010784,0.0004435,50.80
2,42,2010,2052,0.0011559,0.0004718,49.82
2,43,2010,2053,0.0012427,0.0005073,48.85
2,44,2010,2054,0.0013435,0.0005558,47.87
2,45,2010,2055,0.0014588,0.0006104,46.90
2,46,2010,2056,0.0015840,0.0006682,45.93
2,47,2010,2057,0.0017152,0.0007212,44.96
2,48,2010,2058,0.0018531,0.0007734,43.99
2,49,2010,2059,0.0020059,0.0008286,43.02
2,50,2010,2060,0.0021845,0.0008852,42.06
2,51,2010,2061,0.0023896,0.0009423,41.10
2,52,2010,2062,0.0026115,0.0010001,40.13
2,53,2010,2063,0.0028474,0.0010657,39.17
2,54,2010,2064,0.0031082,0.0011522,38.21
2,55,2010,2065,0.0034035,0.0012515,37.26
2,56,2010,2066,0.0037277,0.0013546,36.30
2,57,2010,2067,0.0040692,0.0014455,35.35
2,58,2010,2068,0.0044295,0.0015332,34.40
2,59,2010,2069,0.0048296,0.0016355,33.46
2,60,2010,2070,0.0052973,0.0017679,32.51
2,61,2010,2071,0.0058480,0.0019358,31.57
2,62,2010,2072,0.0064757,0.0021385,30.63
2,63,2010,2073,0.0071641,0.0023753,29.69
2,64,2010,2074,0.0078986,0.0026278,28.76
2,65,2010,2075,0.0086645,0.0028587,27.83
2,66,2010,2076,0.0094558,0.0030660,26.91
2,67,2010,2077,0.0103010,0.0032796,25.99
2,68,2010,2078,0.0112531,0.0035376,25.08
2,69,2010,2079,0.0123584,0.0038541,24.17
2,70,2010,2080,0.0136702,0.0042532,23.26
2,71,2010,2081,0.0152518,0.0048024,22.35
2,72,2010,2082,0.0170987,0.0055150,21.46
2,73,2010,2083,0.0190837,0.0062906,20.58
2,74,2010,2084,0.0210750,0.0070210,19.70
2,75,2010,2085,0.0231062,0.0077125,18.84
2,76,2010,2086,0.0253497,0.0085103,17.98
2,77,2010,2087,0.0279666,0.0095615,17.13
2,78,2010,2088,0.0310443,0.0109472,16.29
2,79,2010,2089,0.0345982,0.0126622,15.47
2,80,2010,2090,0.0395295,0.0156583,14.66
2,81,2010,2091,0.0438328,0.0177950,13.88
2,82,2010,2092,0.0485928,0.0202280,13.13
2,83,2010,2093,0.0538556,0.0229992,12.39
2,84,2010,2094,0.0596709,0.0261205,11.67
2,85,2010,2095,0.0660929,0.0296470,10.97
2,86,2010,2096,0.0731799,0.0336732,10.29
2,87,2010,2097,0.0809950,0.0382803,9.63
2,88,2010,2098,0.0896059,0.0435258,8.99
2,89,2010,2099,0.0990850,0.0494364,8.38
2,90,2010,2100,0.1095094,0.0561048,7.79
2,91,2010,2101,0.1209607,0.0636805,7.22
2,92,2010,2102,0.1335249,0.0723298,6.68
2,93,2010,2103,0.1472918,0.0822067,6.16
2,94,2010,2104,0.1623547,0.0934205,5.66
2,95,2010,2105,0.1788093,0.1061016,5.20
2,96,2010,2106,0.1967531,0.1204681,4.75
2,97,2010,2107,0.2162837,0.1367825,4.34
2,98,2010,2108,0.2374976,0.1552811,3.95
2,99,2010,2109,0.2604884,0.1761364,3.58
2,100,2010,2110,0.2853445,0.1995544,3.24
2,101,2010,2111,0.3121468,0.2258403,2.92
2,102,2010,2112,0.3409660,0.2553256,2.62
2,103,2010,2113,0.3718598,0.2882798,2.35
2,104,2010,2114,0.4048696,0.3248719,2.10
2,105,2010,2115,0.4400178,0.3652766,1.88
2,106,2010,2116,0.4773042,0.4097192,1.67
2,107,2010,2117,0.5167037,0.4583710,1.48
2,108,2010,2118,0.5581634,0.5112630,1.31
2,109,2010,2119,0.6016004,0.5682878,1.15
2,110,2010,2120,0.6469012,0.6292858,1.02
2,111,2010,2121,0.6939204,0.6940196,0.89
2,112,2010,2122,0.7424819,0.7620853,0.78
2,113,2010,2123,0.7923800,0.8329174,0.68
2,114,2010,2124,0.8433824,0.9058864,0.59
2,115,2010,2125,1.0000000,1.0000000,0.50
2,0,2011,2011,0.0078004,0.0082743,90.49
2,1,2011,2012,0.0005341,0.0005540,90.25
2,2,2011,2013,0.0002805,0.0002760,89.30
2,3,2011,2014,0.0001960,0.0001831,88.32
2,4,2011,2015,0.0001520,0.0001344,87.34
2,5,2011,2016,0.0001465,0.0001240,86.35
2,6,2011,2017,0.0001399,0.0001143,85.36
2,7,2011,2018,0.0001348,0.0001073,84.37
2,8,2011,2019,0.0001336,0.0001042,83.38
2,9,2011,2020,0.0001377,0.0001055,82.39
2,10,2011,2021,0.0001465,0.0001110,81.40
2,11,2011,2022,0.0001596,0.0001203,80.40
2,12,2011,2023,0.0001783,0.0001345,79.41
2,13,2011,2024,0.0002061,0.0001560,78.42
2,14,2011,2025,0.0002415,0.0001830,77.44
2,15,2011,2026,0.0002756,0.0002075,76.45
2,16,2011,2027,0.0003003,0.0002219,75.47
2,17,2011,2028,0.0003175,0.0002275,74.48
2,18,2011,2029,0.0003342,0.0002318,73.50
2,19,2011,2030,0.0003539,0.0002387,72.52
2,20,2011,2031,0.0003732,0.0002455,71.53
2,21,2011,2032,0.0003859,0.0002463,70.55
2,22,2011,2033,0.0003897,0.0002391,69.57
2,23,2011,2034,0.0003908,0.0002293,68.59
2,24,2011,2035,0.0003983,0.0002254,67.60
2,25,2011,2036,0.0004147,0.0002290,66.62
2,26,2011,2037,0.0004348,0.0002358,65.63
2,27,2011,2038,0.0004528,0.0002400,64.65
2,28,2011,2039,0.0004684,0.0002434,63.66
2,29,2011,2040,0.0004856,0.0002467,62.68
2,30,2011,2041,0.0005091,0.0002531,61.69
2,31,2011,2042,0.0005408,0.0002633,60.71
2,32,2011,2043,0.0005796,0.0002762,59.72
2,33,2011,2044,0.0006220,0.0002886,58.74
2,34,2011,2045,0.0006665,0.0002996,57.76
2,35,2011,2046,0.0007153,0.0003106,56.77
2,36,2011,2047,0.0007710,0.0003273,55.79
2,37,2011,2048,0.0008314,0.0003452,54.81
2,38,2011,2049,0.0008908,0.0003641,53.83
2,39,2011,2050,0.0009481,0.0003843,52.85
2,40,2011,2051,0.0010090,0.0004074,51.87
2,41,2011,2052,0.0010784,0.0004334,50.89
2,42,2011,2053,0.0011559,0.0004619,49.91
2,43,2011,2054,0.0012427,0.0004966,48.93
2,44,2011,2055,0.0013435,0.0005434,47.96
2,45,2011,2056,0.0014588,0.0005969,46.98
2,46,2011,2057,0.0015840,0.0006549,46.01
2,47,2011,2058,0.0017152,0.0007081,45.04
2,48,2011,2059,0.0018531,0.0007592,44.07
2,49,2011,2060,0.0020059,0.0008122,43.11
2,50,2011,2061,0.0021845,0.0008672,42.14
2,51,2011,2062,0.0023896,0.0009241,41.18
2,52,2011,2063,0.0026115,0.0009820,40.21
2,53,2011,2064,0.0028474,0.0010458,39.25
2,54,2011,2065,0.0031082,0.0011289,38.29
2,55,2011,2066,0.0034035,0.0012259,37.34
2,56,2011,2067,0.0037277,0.0013287,36.38
2,57,2011,2068,0.0040692,0.0014199,35.43
2,58,2011,2069,0.0044295,0.0015052,34.48
2,59,2011,2070,0.0048296,0.0016029,33.53
2,60,2011,2071,0.0052973,0.0017320,32.58
2,61,2011,2072,0.0058480,0.0018991,31.64
2,62,2011,2073,0.0064757,0.0021015,30.70
2,63,2011,2074,0.0071641,0.0023341,29.76
2,64,2011,2075,0.0078986,0.0025791,28.83
2,65,2011,2076,0.0086645,0.0028049,27.90
2,66,2011,2077,0.0094558,0.0030117,26.98
2,67,2011,2078,0.0103010,0.0032257,26.06
2,68,2011,2079,0.0112531,0.0034784,25.14
2,69,2011,2080,0.0123584,0.0037844,24.23
2,70,2011,2081,0.0136702,0.0041754,23.32
2,71,2011,2082,0.0152518,0.0047218,22.42
2,72,2011,2083,0.0170987,0.0054321,21.52
2,73,2011,2084,0.0190837,0.0061968,20.63
2,74,2011,2085,0.0210750,0.0069096,19.76
2,75,2011,2086,0.0231062,0.0075892,18.89
2,76,2011,2087,0.0253497,0.0083844,18.03
2,77,2011,2088,0.0279666,0.0094341,17.18
2,78,2011,2089,0.0310443,0.0108033,16.34
2,79,2011,2090,0.0345982,0.0124894,15.51
2,80,2011,2091,0.0395295,0.0154592,14.70
2,81,2011,2092,0.0438328,0.0175900,13.93
2,82,2011,2093,0.0485928,0.0200199,13.17
2,83,2011,2094,0.0538556,0.0227654,12.43
2,84,2011,2095,0.0596709,0.0258425,11.71
2,85,2011,2096,0.0660929,0.0293372,11.00
2,86,2011,2097,0.0731799,0.0333559,10.32
2,87,2011,2098,0.0809950,0.0379606,9.66
2,88,2011,2099,0.0896059,0.0431695,9.02
2,89,2011,2100,0.0990850,0.0490160,8.40
2,90,2011,2101,0.1095094,0.0556400,7.81
2,91,2011,2102,0.1209607,0.0632093,7.24
2,92,2011,2103,0.1335249,0.0718628,6.70
2,93,2011,2104,0.1472918,0.0816974,6.18
2,94,2011,2105,0.1623547,0.0928301,5.68
2,95,2011,2106,0.1788093,0.1054597,5.21
2,96,2011,2107,0.1967531,0.1198286,4.77
2,97,2011,2108,0.2162837,0.1361573,4.35
2,98,2011,2109,0.2374976,0.1546078,3.96
2,99,2011,2110,0.2604884,0.1753756,3.59
2,100,2011,2111,0.2853445,0.1987557,3.24
2,101,2011,2112,0.3121468,0.2250774,2.93
2,102,2011,2113,0.3409660,0.2546190,2.63
2,103,2011,2114,0.3718598,0.2875676,2.36
2,104,2011,2115,0.4048696,0.3241238,2.11
2,105,2011,2116,0.4400178,0.3645561,1.88
2,106,2011,2117,0.4773042,0.4091016,1.67
2,107,2011,2118,0.5167037,0.4578725,1.48
2,108,2011,2119,0.5581634,0.5108476,1.31
2,109,2011,2120,0.6016004,0.5679650,1.16
2,110,2011,2121,0.6469012,0.6291111,1.02
2,111,2011,2122,0.6939204,0.6940206,0.89
2,112,2011,2123,0.7424819,0.7622544,0.78
2,113,2011,2124,0.7923800,0.8332753,0.68
2,114,2011,2125,0.8433824,0.9064830,0.59
2,115,2011,2126,1.0000000,1.0000000,0.50
2,0,2012,2012,0.0078003,0.0079882,90.62
2,1,2012,2013,0.0005341,0.0005251,90.35
2,2,2012,2014,0.0002805,0.0002607,89.40
2,3,2012,2015,0.0001960,0.0001725,88.42
2,4,2012,2016,0.0001520,0.0001267,87.44
2,5,2012,2017,0.0001465,0.0001178,86.45
2,6,2012,2018,0.0001399,0.0001095,85.46
2,7,2012,2019,0.0001348,0.0001029,84.47
2,8,2012,2020,0.0001336,0.0000999,83.48
2,9,2012,2021,0.0001377,0.0001014,82.49
2,10,2012,2022,0.0001465,0.0001073,81.49
2,11,2012,2023,0.0001596,0.0001170,80.50
2,12,2012,2024,0.0001783,0.0001310,79.51
2,13,2012,2025,0.0002061,0.0001520,78.52
2,14,2012,2026,0.0002415,0.0001787,77.53
2,15,2012,2027,0.0002756,0.0002031,76.55
2,16,2012,2028,0.0003003,0.0002175,75.56
2,17,2012,2029,0.0003175,0.0002228,74.58
2,18,2012,2030,0.0003342,0.0002264,73.60
2,19,2012,2031,0.0003539,0.0002329,72.61
2,20,2012,2032,0.0003732,0.0002400,71.63
2,21,2012,2033,0.0003859,0.0002411,70.65
2,22,2012,2034,0.0003897,0.0002337,69.66
2,23,2012,2035,0.0003908,0.0002235,68.68
2,24,2012,2036,0.0003983,0.0002194,67.69
2,25,2012,2037,0.0004147,0.0002233,66.71
2,26,2012,2038,0.0004348,0.0002303,65.72
2,27,2012,2039,0.0004528,0.0002344,64.74
2,28,2012,2040,0.0004684,0.0002372,63.75
2,29,2012,2041,0.0004856,0.0002403,62.77
2,30,2012,2042,0.0005091,0.0002470,61.78
2,31,2012,2043,0.0005408,0.0002575,60.80
2,32,2012,2044,0.0005796,0.0002699,59.81
2,33,2012,2045,0.0006220,0.0002815,58.83
2,34,2012,2046,0.0006665,0.0002919,57.85
2,35,2012,2047,0.0007153,0.0003030,56.86
2,36,2012,2048,0.0007710,0.0003199,55.88
2,37,2012,2049,0.0008314,0.0003371,54.90
2,38,2012,2050,0.0008908,0.0003549,53.92
2,39,2012,2051,0.0009481,0.0003745,52.94
2,40,2012,2052,0.0010090,0.0003978,51.96
2,41,2012,2053,0.0010784,0.0004241,50.98
2,42,2012,2054,0.0011559,0.0004519,50.00
2,43,2012,2055,0.0012427,0.0004850,49.02
2,44,2012,2056,0.0013435,0.0005310,48.04
2,45,2012,2057,0.0014588,0.0005845,47.07
2,46,2012,2058,0.0015840,0.0006427,46.10
2,47,2012,2059,0.0017152,0.0006949,45.13
2,48,2012,2060,0.0018531,0.0007440,44.16
2,49,2012,2061,0.0020059,0.0007957,43.19
2,50,2012,2062,0.0021845,0.0008506,42.22
2,51,2012,2063,0.0023896,0.0009075,41.26
2,52,2012,2064,0.0026115,0.0009637,40.30
2,53,2012,2065,0.0028474,0.0010244,39.33
2,54,2012,2066,0.0031082,0.0011055,38.37
2,55,2012,2067,0.0034035,0.0012023,37.42
2,56,2012,2068,0.0037277,0.0013052,36.46
2,57,2012,2069,0.0040692,0.0013941,35.51
2,58,2012,2070,0.0044295,0.0014753,34.56
2,59,2012,2071,0.0048296,0.0015702,33.61
2,60,2012,2072,0.0052973,0.0016988,32.66
2,61,2012,2073,0.0058480,0.0018658,31.71
2,62,2012,2074,0.0064757,0.0020643,30.77
2,63,2012,2075,0.0071641,0.0022899,29.83
2,64,2012,2076,0.0078986,0.0025301,28.90
2,65,2012,2077,0.0086645,0.0027551,27.97
2,66,2012,2078,0.0094558,0.0029623,27.05
2,67,2012,2079,0.0103010,0.0031715,26.13
2,68,2012,2080,0.0112531,0.0034150,25.21
2,69,2012,2081,0.0123584,0.0037143,24.29
2,70,2012,2082,0.0136702,0.0041035,23.38
2,71,2012,2083,0.0152518,0.0046483,22.48
2,72,2012,2084,0.0170987,0.0053485,21.58
2,73,2012,2085,0.0190837,0.0060962,20.69
2,74,2012,2086,0.0210750,0.0067973,19.82
2,75,2012,2087,0.0231062,0.0074747,18.95
2,76,2012,2088,0.0253497,0.0082693,18.09
2,77,2012,2089,0.0279666,0.0093049,17.23
2,78,2012,2090,0.0310443,0.0106485,16.39
2,79,2012,2091,0.0345982,0.0123148,15.56
2,80,2012,2092,0.0395295,0.0152738,14.75
2,81,2012,2093,0.0438328,0.0174016,13.97
2,82,2012,2094,0.0485928,0.0198080,13.21
2,83,2012,2095,0.0538556,0.0225131,12.47
2,84,2012,2096,0.0596709,0.0255609,11.74
2,85,2012,2097,0.0660929,0.0290483,11.04
2,86,2012,2098,0.0731799,0.0330642,10.35
2,87,2012,2099,0.0809950,0.0376348,9.69
2,88,2012,2100,0.0896059,0.0427844,9.05
2,89,2012,2101,0.0990850,0.0485892,8.43
2,90,2012,2102,0.1095094,0.0552060,7.84
2,91,2012,2103,0.1209607,0.0627777,7.27
2,92,2012,2104,0.1335249,0.0713904,6.72
2,93,2012,2105,0.1472918,0.0811475,6.20
2,94,2012,2106,0.1623547,0.0922293,5.70
2,95,2012,2107,0.1788093,0.1048578,5.23
2,96,2012,2108,0.1967531,0.1192365,4.78
2,97,2012,2109,0.2162837,0.1355151,4.36
2,98,2012,2110,0.2374976,0.1538759,3.97
2,99,2012,2111,0.2604884,0.1745997,3.60
2,100,2012,2112,0.2853445,0.1980060,3.25
2,101,2012,2113,0.3121468,0.2243734,2.93
2,102,2012,2114,0.3409660,0.2538975,2.64
2,103,2012,2115,0.3718598,0.2867939,2.36
2,104,2012,2116,0.4048696,0.3233592,2.11
2,105,2012,2117,0.4400178,0.3638780,1.88
2,106,2012,2118,0.4773042,0.4085276,1.67
2,107,2012,2119,0.5167037,0.4573586,1.48
2,108,2012,2120,0.5581634,0.5103945,1.31
2,109,2012,2121,0.6016004,0.5676345,1.16
2,110,2012,2122,0.6469012,0.6289464,1.02
2,111,2012,2123,0.6939204,0.6940214,0.89
2,112,2012,2124,0.7424819,0.7624286,0.78
2,113,2012,2125,0.7923800,0.8336657,0.68
2,114,2012,2126,0.8433824,0.9070938,0.59
2,115,2012,2127,1.0000000,1.0000000,0.50
2,0,2013,2013,0.0078003,0.0077147,90.75
2,1,2013,2014,0.0005341,0.0004944,90.46
2,2,2013,2015,0.0002805,0.0002446,89.50
2,3,2013,2016,0.0001960,0.0001623,88.52
2,4,2013,2017,0.0001520,0.0001199,87.54
2,5,2013,2018,0.0001465,0.0001124,86.55
2,6,2013,2019,0.0001399,0.0001047,85.56
2,7,2013,2020,0.0001348,0.0000983,84.57
2,8,2013,2021,0.0001336,0.0000957,83.57
2,9,2013,2022,0.0001377,0.0000978,82.58
2,10,2013,2023,0.0001465,0.0001041,81.59
2,11,2013,2024,0.0001596,0.0001136,80.60
2,12,2013,2025,0.0001783,0.0001273,79.61
2,13,2013,2026,0.0002061,0.0001480,78.62
2,14,2013,2027,0.0002415,0.0001747,77.63
2,15,2013,2028,0.0002756,0.0001991,76.64
2,16,2013,2029,0.0003003,0.0002132,75.66
2,17,2013,2030,0.0003175,0.0002178,74.67
2,18,2013,2031,0.0003342,0.0002210,73.69
2,19,2013,2032,0.0003539,0.0002277,72.71
2,20,2013,2033,0.0003732,0.0002349,71.72
2,21,2013,2034,0.0003859,0.0002359,70.74
2,22,2013,2035,0.0003897,0.0002280,69.76
2,23,2013,2036,0.0003908,0.0002176,68.77
2,24,2013,2037,0.0003983,0.0002139,67.79
2,25,2013,2038,0.0004147,0.0002181,66.80
2,26,2013,2039,0.0004348,0.0002249,65.82
2,27,2013,2040,0.0004528,0.0002284,64.83
2,28,2013,2041,0.0004684,0.0002310,63.85
2,29,2013,2042,0.0004856,0.0002345,62.86
2,30,2013,2043,0.0005091,0.0002415,61.87
2,31,2013,2044,0.0005408,0.0002516,60.89
2,32,2013,2045,0.0005796,0.0002633,59.90
2,33,2013,2046,0.0006220,0.0002743,58.92
2,34,2013,2047,0.0006665,0.0002849,57.94
2,35,2013,2048,0.0007153,0.0002961,56.95
2,36,2013,2049,0.0007710,0.0003124,55.97
2,37,2013,2050,0.0008314,0.0003286,54.99
2,38,2013,2051,0.0008908,0.0003457,54.00
2,39,2013,2052,0.0009481,0.0003656,53.02
2,40,2013,2053,0.0010090,0.0003892,52.04
2,41,2013,2054,0.0010784,0.0004147,51.06
2,42,2013,2055,0.0011559,0.0004411,50.08
2,43,2013,2056,0.0012427,0.0004735,49.10
2,44,2013,2057,0.0013435,0.0005196,48.13
2,45,2013,2058,0.0014588,0.0005733,47.15
2,46,2013,2059,0.0015840,0.0006305,46.18
2,47,2013,2060,0.0017152,0.0006808,45.21
2,48,2013,2061,0.0018531,0.0007287,44.24
2,49,2013,2062,0.0020059,0.0007804,43.27
2,50,2013,2063,0.0021845,0.0008354,42.30
2,51,2013,2064,0.0023896,0.0008908,41.34
2,52,2013,2065,0.0026115,0.0009441,40.38
2,53,2013,2066,0.0028474,0.0010030,39.41
2,54,2013,2067,0.0031082,0.0010840,38.45
2,55,2013,2068,0.0034035,0.0011809,37.49
2,56,2013,2069,0.0037277,0.0012816,36.54
2,57,2013,2070,0.0040692,0.0013666,35.58
2,58,2013,2071,0.0044295,0.0014453,34.63
2,59,2013,2072,0.0048296,0.0015400,33.68
2,60,2013,2073,0.0052973,0.0016687,32.73
2,61,2013,2074,0.0058480,0.0018323,31.79
2,62,2013,2075,0.0064757,0.0020246,30.84
2,63,2013,2076,0.0071641,0.0022456,29.90
2,64,2013,2077,0.0078986,0.0024848,28.97
2,65,2013,2078,0.0086645,0.0027099,28.04
2,66,2013,2079,0.0094558,0.0029125,27.12
2,67,2013,2080,0.0103010,0.0031135,26.19
2,68,2013,2081,0.0112531,0.0033513,25.27
2,69,2013,2082,0.0123584,0.0036494,24.36
2,70,2013,2083,0.0136702,0.0040380,23.45
2,71,2013,2084,0.0152518,0.0045741,22.54
2,72,2013,2085,0.0170987,0.0052588,21.64
2,73,2013,2086,0.0190837,0.0059949,20.75
2,74,2013,2087,0.0210750,0.0066932,19.87
2,75,2013,2088,0.0231062,0.0073701,19.00
2,76,2013,2089,0.0253497,0.0081526,18.14
2,77,2013,2090,0.0279666,0.0091660,17.29
2,78,2013,2091,0.0310443,0.0104923,16.44
2,79,2013,2092,0.0345982,0.0121525,15.61
2,80,2013,2093,0.0395295,0.0151036,14.80
2,81,2013,2094,0.0438328,0.0172099,14.02
2,82,2013,2095,0.0485928,0.0195794,13.25
2,83,2013,2096,0.0538556,0.0222576,12.51
2,84,2013,2097,0.0596709,0.0252983,11.78
2,85,2013,2098,0.0660929,0.0287826,11.07
2,86,2013,2099,0.0731799,0.0327669,10.39
2,87,2013,2100,0.0809950,0.0372827,9.72
2,88,2013,2101,0.0896059,0.0423935,9.08
2,89,2013,2102,0.0990850,0.0481908,8.46
2,90,2013,2103,0.1095094,0.0548086,7.86
2,91,2013,2104,0.1209607,0.0623414,7.29
2,92,2013,2105,0.1335249,0.0708805,6.74
2,93,2013,2106,0.1472918,0.0805881,6.22
2,94,2013,2107,0.1623547,0.0916663,5.72
2,95,2013,2108,0.1788093,0.1043009,5.24
2,96,2013,2109,0.1967531,0.1186286,4.80
2,97,2013,2110,0.2162837,0.1348172,4.37
2,98,2013,2111,0.2374976,0.1531298,3.98
2,99,2013,2112,0.2604884,0.1738717,3.61
2,100,2013,2113,0.2853445,0.1973144,3.26
2,101,2013,2114,0.3121468,0.2236548,2.94
2,102,2013,2115,0.3409660,0.2531140,2.64
2,103,2013,2116,0.3718598,0.2860036,2.37
2,104,2013,2117,0.4048696,0.3226397,2.12
2,105,2013,2118,0.4400178,0.3632479,1.88
2,106,2013,2119,0.4773042,0.4079361,1.67
2,107,2013,2120,0.5167037,0.4567981,1.48
2,108,2013,2121,0.5581634,0.5099308,1.31
2,109,2013,2122,0.6016004,0.5673232,1.16
2,110,2013,2123,0.6469012,0.6287934,1.02
2,111,2013,2124,0.6939204,0.6940224,0.89
2,112,2013,2125,0.7424819,0.7626186,0.78
2,113,2013,2126,0.7923800,0.8340656,0.68
2,114,2013,2127,0.8433824,0.9076692,0.59
2,115,2013,2128,1.0000000,1.0000000,0.50
2,0,2014,2014,0.0078003,0.0074179,90.88
2,1,2014,2015,0.0005341,0.0004620,90.56
2,2,2014,2016,0.0002805,0.0002291,89.60
2,3,2014,2017,0.0001960,0.0001532,88.62
2,4,2014,2018,0.0001520,0.0001139,87.64
2,5,2014,2019,0.0001465,0.0001071,86.65
2,6,2014,2020,0.0001399,0.0000997,85.65
2,7,2014,2021,0.0001348,0.0000939,84.66
2,8,2014,2022,0.0001336,0.0000919,83.67
2,9,2014,2023,0.0001377,0.0000945,82.68
2,10,2014,2024,0.0001465,0.0001008,81.69
2,11,2014,2025,0.0001596,0.0001101,80.69
2,12,2014,2026,0.0001783,0.0001237,79.70
2,13,2014,2027,0.0002061,0.0001444,78.71
2,14,2014,2028,0.0002415,0.0001710,77.72
2,15,2014,2029,0.0002756,0.0001951,76.74
2,16,2014,2030,0.0003003,0.0002086,75.75
2,17,2014,2031,0.0003175,0.0002128,74.77
2,18,2014,2032,0.0003342,0.0002161,73.78
2,19,2014,2033,0.0003539,0.0002229,72.80
2,20,2014,2034,0.0003732,0.0002299,71.82
2,21,2014,2035,0.0003859,0.0002303,70.83
2,22,2014,2036,0.0003897,0.0002222,69.85
2,23,2014,2037,0.0003908,0.0002123,68.86
2,24,2014,2038,0.0003983,0.0002089,67.88
2,25,2014,2039,0.0004147,0.0002130,66.89
2,26,2014,2040,0.0004348,0.0002192,65.91
2,27,2014,2041,0.0004528,0.0002224,64.92
2,28,2014,2042,0.0004684,0.0002254,63.94
2,29,2014,2043,0.0004856,0.0002292,62.95
2,30,2014,2044,0.0005091,0.0002360,61.96
2,31,2014,2045,0.0005408,0.0002454,60.98
2,32,2014,2046,0.0005796,0.0002566,59.99
2,33,2014,2047,0.0006220,0.0002678,59.01
2,34,2014,2048,0.0006665,0.0002785,58.02
2,35,2014,2049,0.0007153,0.0002892,57.04
2,36,2014,2050,0.0007710,0.0003045,56.06
2,37,2014,2051,0.0008314,0.0003200,55.07
2,38,2014,2052,0.0008908,0.0003373,54.09
2,39,2014,2053,0.0009481,0.0003574,53.11
2,40,2014,2054,0.0010090,0.0003804,52.13
2,41,2014,2055,0.0010784,0.0004047,51.15
2,42,2014,2056,0.0011559,0.0004304,50.17
2,43,2014,2057,0.0012427,0.0004629,49.19
2,44,2014,2058,0.0013435,0.0005092,48.21
2,45,2014,2059,0.0014588,0.0005620,47.24
2,46,2014,2060,0.0015840,0.0006174,46.26
2,47,2014,2061,0.0017152,0.0006666,45.29
2,48,2014,2062,0.0018531,0.0007146,44.32
2,49,2014,2063,0.0020059,0.0007665,43.35
2,50,2014,2064,0.0021845,0.0008201,42.38
2,51,2014,2065,0.0023896,0.0008728,41.42
2,52,2014,2066,0.0026115,0.0009245,40.45
2,53,2014,2067,0.0028474,0.0009832,39.49
2,54,2014,2068,0.0031082,0.0010644,38.53
2,55,2014,2069,0.0034035,0.0011593,37.57
2,56,2014,2070,0.0037277,0.0012564,36.61
2,57,2014,2071,0.0040692,0.0013391,35.66
2,58,2014,2072,0.0044295,0.0014176,34.71
2,59,2014,2073,0.0048296,0.0015126,33.75
2,60,2014,2074,0.0052973,0.0016384,32.81
2,61,2014,2075,0.0058480,0.0017965,31.86
2,62,2014,2076,0.0064757,0.0019846,30.91
2,63,2014,2077,0.0071641,0.0022047,29.98
2,64,2014,2078,0.0078986,0.0024436,29.04
2,65,2014,2079,0.0086645,0.0026643,28.11
2,66,2014,2080,0.0094558,0.0028593,27.18
2,67,2014,2081,0.0103010,0.0030553,26.26
2,68,2014,2082,0.0112531,0.0032924,25.34
2,69,2014,2083,0.0123584,0.0035904,24.42
2,70,2014,2084,0.0136702,0.0039719,23.51
2,71,2014,2085,0.0152518,0.0044947,22.60
2,72,2014,2086,0.0170987,0.0051686,21.70
2,73,2014,2087,0.0190837,0.0059010,20.81
2,74,2014,2088,0.0210750,0.0065980,19.93
2,75,2014,2089,0.0231062,0.0072641,19.06
2,76,2014,2090,0.0253497,0.0080273,18.19
2,77,2014,2091,0.0279666,0.0090260,17.34
2,78,2014,2092,0.0310443,0.0103473,16.49
2,79,2014,2093,0.0345982,0.0120037,15.66
2,80,2014,2094,0.0395295,0.0149304,14.84
2,81,2014,2095,0.0438328,0.0170031,14.06
2,82,2014,2096,0.0485928,0.0193480,13.29
2,83,2014,2097,0.0538556,0.0220195,12.55
2,84,2014,2098,0.0596709,0.0250570,11.82
2,85,2014,2099,0.0660929,0.0285121,11.11
2,86,2014,2100,0.0731799,0.0324459,10.42
2,87,2014,2101,0.0809950,0.0369256,9.75
2,88,2014,2102,0.0896059,0.0420288,9.11
2,89,2014,2103,0.0990850,0.0478261,8.49
2,90,2014,2104,0.1095094,0.0544070,7.89
2,91,2014,2105,0.1209607,0.0618706,7.31
2,92,2014,2106,0.1335249,0.0703620,6.76
2,93,2014,2107,0.1472918,0.0800641,6.24
2,94,2014,2108,0.1623547,0.0911454,5.73
2,95,2014,2109,0.1788093,0.1037292,5.26
2,96,2014,2110,0.1967531,0.1179682,4.81
2,97,2014,2111,0.2162837,0.1341061,4.39
2,98,2014,2112,0.2374976,0.1524302,3.99
2,99,2014,2113,0.2604884,0.1732004,3.62
2,100,2014,2114,0.2853445,0.1966088,3.27
2,101,2014,2115,0.3121468,0.2228748,2.95
2,102,2014,2116,0.3409660,0.2523140,2.65
2,103,2014,2117,0.3718598,0.2852602,2.37
2,104,2014,2118,0.4048696,0.3219716,2.12
2,105,2014,2119,0.4400178,0.3625987,1.89
2,106,2014,2120,0.4773042,0.4072910,1.68
2,107,2014,2121,0.5167037,0.4562247,1.49
2,108,2014,2122,0.5581634,0.5094941,1.31
2,109,2014,2123,0.6016004,0.5670341,1.16
2,110,2014,2124,0.6469012,0.6286359,1.02
2,111,2014,2125,0.6939204,0.6940233,0.89
2,112,2014,2126,0.7424819,0.7628131,0.78
2,113,2014,2127,0.7923800,0.8344422,0.68
2,114,2014,2128,0.8433824,0.9082013,0.59
2,115,2014,2129,1.0000000,1.0000000,0.50
2,0,2015,2015,0.0078002,0.0070983,91.01
2,1,2015,2016,0.0005341,0.0004311,90.66
2,2,2015,2017,0.0002805,0.0002154,89.70
2,3,2015,2018,0.0001960,0.0001453,88.72
2,4,2015,2019,0.0001520,0.0001080,87.73
2,5,2015,2020,0.0001465,0.0001016,86.74
2,6,2015,2021,0.0001399,0.0000948,85.75
2,7,2015,2022,0.0001348,0.0000899,84.76
2,8,2015,2023,0.0001336,0.0000886,83.77
2,9,2015,2024,0.0001377,0.0000912,82.77
2,10,2015,2025,0.0001465,0.0000973,81.78
2,11,2015,2026,0.0001596,0.0001066,80.79
2,12,2015,2027,0.0001783,0.0001203,79.80
2,13,2015,2028,0.0002061,0.0001411,78.81
2,14,2015,2029,0.0002415,0.0001674,77.82
2,15,2015,2030,0.0002756,0.0001908,76.83
2,16,2015,2031,0.0003003,0.0002039,75.85
2,17,2015,2032,0.0003175,0.0002082,74.86
2,18,2015,2033,0.0003342,0.0002116,73.88
2,19,2015,2034,0.0003539,0.0002181,72.89
2,20,2015,2035,0.0003732,0.0002246,71.91
2,21,2015,2036,0.0003859,0.0002247,70.92
2,22,2015,2037,0.0003897,0.0002170,69.94
2,23,2015,2038,0.0003908,0.0002074,68.95
2,24,2015,2039,0.0003983,0.0002039,67.97
2,25,2015,2040,0.0004147,0.0002075,66.98
2,26,2015,2041,0.0004348,0.0002135,66.00
2,27,2015,2042,0.0004528,0.0002170,65.01
2,28,2015,2043,0.0004684,0.0002203,64.02
2,29,2015,2044,0.0004856,0.0002239,63.04
2,30,2015,2045,0.0005091,0.0002301,62.05
2,31,2015,2046,0.0005408,0.0002392,61.07
2,32,2015,2047,0.0005796,0.0002505,60.08
2,33,2015,2048,0.0006220,0.0002618,59.10
2,34,2015,2049,0.0006665,0.0002720,58.11
2,35,2015,2050,0.0007153,0.0002818,57.13
2,36,2015,2051,0.0007710,0.0002965,56.14
2,37,2015,2052,0.0008314,0.0003121,55.16
2,38,2015,2053,0.0008908,0.0003296,54.18
2,39,2015,2054,0.0009481,0.0003491,53.19
2,40,2015,2055,0.0010090,0.0003710,52.21
2,41,2015,2056,0.0010784,0.0003947,51.23
2,42,2015,2057,0.0011559,0.0004206,50.25
2,43,2015,2058,0.0012427,0.0004533,49.27
2,44,2015,2059,0.0013435,0.0004988,48.30
2,45,2015,2060,0.0014588,0.0005500,47.32
2,46,2015,2061,0.0015840,0.0006044,46.34
2,47,2015,2062,0.0017152,0.0006536,45.37
2,48,2015,2063,0.0018531,0.0007017,44.40
2,49,2015,2064,0.0020059,0.0007524,43.43
2,50,2015,2065,0.0021845,0.0008037,42.46
2,51,2015,2066,0.0023896,0.0008549,41.50
2,52,2015,2067,0.0026115,0.0009064,40.53
2,53,2015,2068,0.0028474,0.0009653,39.57
2,54,2015,2069,0.0031082,0.0010447,38.61
2,55,2015,2070,0.0034035,0.0011363,37.65
2,56,2015,2071,0.0037277,0.0012311,36.69
2,57,2015,2072,0.0040692,0.0013136,35.73
2,58,2015,2073,0.0044295,0.0013924,34.78
2,59,2015,2074,0.0048296,0.0014850,33.83
2,60,2015,2075,0.0052973,0.0016060,32.88
2,61,2015,2076,0.0058480,0.0017605,31.93
2,62,2015,2077,0.0064757,0.0019478,30.99
2,63,2015,2078,0.0071641,0.0021674,30.05
2,64,2015,2079,0.0078986,0.0024021,29.11
2,65,2015,2080,0.0086645,0.0026155,28.18
2,66,2015,2081,0.0094558,0.0028058,27.25
2,67,2015,2082,0.0103010,0.0030014,26.33
2,68,2015,2083,0.0112531,0.0032387,25.40
2,69,2015,2084,0.0123584,0.0035309,24.48
2,70,2015,2085,0.0136702,0.0039012,23.57
2,71,2015,2086,0.0152518,0.0044149,22.66
2,72,2015,2087,0.0170987,0.0050850,21.76
2,73,2015,2088,0.0190837,0.0058152,20.87
2,74,2015,2089,0.0210750,0.0065016,19.99
2,75,2015,2090,0.0231062,0.0071502,19.11
2,76,2015,2091,0.0253497,0.0079009,18.25
2,77,2015,2092,0.0279666,0.0088959,17.39
2,78,2015,2093,0.0310443,0.0102143,16.54
2,79,2015,2094,0.0345982,0.0118524,15.71
2,80,2015,2095,0.0395295,0.0147437,14.89
2,81,2015,2096,0.0438328,0.0167939,14.10
2,82,2015,2097,0.0485928,0.0191325,13.34
2,83,2015,2098,0.0538556,0.0218008,12.59
2,84,2015,2099,0.0596709,0.0248115,11.86
2,85,2015,2100,0.0660929,0.0282202,11.15
2,86,2015,2101,0.0731799,0.0321205,10.45
2,87,2015,2102,0.0809950,0.0365925,9.78
2,88,2015,2103,0.0896059,0.0416951,9.14
2,89,2015,2104,0.0990850,0.0474578,8.51
2,90,2015,2105,0.1095094,0.0539739,7.91
2,91,2015,2106,0.1209607,0.0613921,7.34
2,92,2015,2107,0.1335249,0.0698767,6.78
2,93,2015,2108,0.1472918,0.0795796,6.25
2,94,2015,2109,0.1623547,0.0906111,5.75
2,95,2015,2110,0.1788093,0.1031086,5.27
2,96,2015,2111,0.1967531,0.1172957,4.82
2,97,2015,2112,0.2162837,0.1334396,4.40
2,98,2015,2113,0.2374976,0.1517853,4.00
2,99,2015,2114,0.2604884,0.1725158,3.62
2,100,2015,2115,0.2853445,0.1958432,3.28
2,101,2015,2116,0.3121468,0.2220787,2.95
2,102,2015,2117,0.3409660,0.2515618,2.65
2,103,2015,2118,0.3718598,0.2845701,2.38
2,104,2015,2119,0.4048696,0.3212834,2.12
2,105,2015,2120,0.4400178,0.3618912,1.89
2,106,2015,2121,0.4773042,0.4066314,1.68
2,107,2015,2122,0.5167037,0.4556848,1.49
2,108,2015,2123,0.5581634,0.5090886,1.31
2,109,2015,2124,0.6016004,0.5667366,1.16
2,110,2015,2125,0.6469012,0.6284642,1.02
2,111,2015,2126,0.6939204,0.6940243,0.89
2,112,2015,2127,0.7424819,0.7629963,0.78
2,113,2015,2128,0.7923800,0.8347905,0.68
2,114,2015,2129,0.8433824,0.9087453,0.59
2,115,2015,2130,1.0000000,1.0000000,0.50
2,0,2016,2016,0.0078002,0.0067852,91.14
2,1,2016,2017,0.0005341,0.0004038,90.76
2,2,2016,2018,0.0002805,0.0002035,89.80
2,3,2016,2019,0.0001960,0.0001375,88.82
2,4,2016,2020,0.0001520,0.0001020,87.83
2,5,2016,2021,0.0001465,0.0000963,86.84
2,6,2016,2022,0.0001399,0.0000905,85.85
2,7,2016,2023,0.0001348,0.0000863,84.85
2,8,2016,2024,0.0001336,0.0000852,83.86
2,9,2016,2025,0.0001377,0.0000878,82.87
2,10,2016,2026,0.0001465,0.0000939,81.88
2,11,2016,2027,0.0001596,0.0001034,80.88
2,12,2016,2028,0.0001783,0.0001173,79.89
2,13,2016,2029,0.0002061,0.0001377,78.90
2,14,2016,2030,0.0002415,0.0001635,77.91
2,15,2016,2031,0.0002756,0.0001865,76.92
2,16,2016,2032,0.0003003,0.0001996,75.94
2,17,2016,2033,0.0003175,0.0002040,74.95
2,18,2016,2034,0.0003342,0.0002071,73.97
2,19,2016,2035,0.0003539,0.0002131,72.98
2,20,2016,2036,0.0003732,0.0002192,72.00
2,21,2016,2037,0.0003859,0.0002196,71.01
2,22,2016,2038,0.0003897,0.0002122,70.03
2,23,2016,2039,0.0003908,0.0002026,69.05
2,24,2016,2040,0.0003983,0.0001986,68.06
2,25,2016,2041,0.0004147,0.0002020,67.07
2,26,2016,2042,0.0004348,0.0002082,66.09
2,27,2016,2043,0.0004528,0.0002120,65.10
2,28,2016,2044,0.0004684,0.0002152,64.11
2,29,2016,2045,0.0004856,0.0002184,63.13
2,30,2016,2046,0.0005091,0.0002243,62.14
2,31,2016,2047,0.0005408,0.0002335,61.15
2,32,2016,2048,0.0005796,0.0002450,60.17
2,33,2016,2049,0.0006220,0.0002558,59.18
2,34,2016,2050,0.0006665,0.0002652,58.20
2,35,2016,2051,0.0007153,0.0002744,57.21
2,36,2016,2052,0.0007710,0.0002892,56.23
2,37,2016,2053,0.0008314,0.0003050,55.25
2,38,2016,2054,0.0008908,0.0003218,54.26
2,39,2016,2055,0.0009481,0.0003403,53.28
2,40,2016,2056,0.0010090,0.0003616,52.30
2,41,2016,2057,0.0010784,0.0003855,51.32
2,42,2016,2058,0.0011559,0.0004116,50.34
2,43,2016,2059,0.0012427,0.0004437,49.36
2,44,2016,2060,0.0013435,0.0004877,48.38
2,45,2016,2061,0.0014588,0.0005379,47.40
2,46,2016,2062,0.0015840,0.0005923,46.43
2,47,2016,2063,0.0017152,0.0006417,45.45
2,48,2016,2064,0.0018531,0.0006887,44.48
2,49,2016,2065,0.0020059,0.0007374,43.51
2,50,2016,2066,0.0021845,0.0007873,42.54
2,51,2016,2067,0.0023896,0.0008383,41.58
2,52,2016,2068,0.0026115,0.0008899,40.61
2,53,2016,2069,0.0028474,0.0009473,39.65
2,54,2016,2070,0.0031082,0.0010238,38.68
2,55,2016,2071,0.0034035,0.0011133,37.72
2,56,2016,2072,0.0037277,0.0012078,36.77
2,57,2016,2073,0.0040692,0.0012904,35.81
2,58,2016,2074,0.0044295,0.0013670,34.86
2,59,2016,2075,0.0048296,0.0014555,33.90
2,60,2016,2076,0.0052973,0.0015735,32.95
2,61,2016,2077,0.0058480,0.0017273,32.00
2,62,2016,2078,0.0064757,0.0019142,31.06
2,63,2016,2079,0.0071641,0.0021300,30.12
2,64,2016,2080,0.0078986,0.0023578,29.18
2,65,2016,2081,0.0086645,0.0025665,28.25
2,66,2016,2082,0.0094558,0.0027563,27.32
2,67,2016,2083,0.0103010,0.0029523,26.39
2,68,2016,2084,0.0112531,0.0031846,25.47
2,69,2016,2085,0.0123584,0.0034672,24.55
2,70,2016,2086,0.0136702,0.0038301,23.63
2,71,2016,2087,0.0152518,0.0043409,22.72
2,72,2016,2088,0.0170987,0.0050086,21.82
2,73,2016,2089,0.0190837,0.0057282,20.92
2,74,2016,2090,0.0210750,0.0063981,20.04
2,75,2016,2091,0.0231062,0.0070354,19.17
2,76,2016,2092,0.0253497,0.0077836,18.30
2,77,2016,2093,0.0279666,0.0087768,17.44
2,78,2016,2094,0.0310443,0.0100792,16.59
2,79,2016,2095,0.0345982,0.0116895,15.75
2,80,2016,2096,0.0395295,0.0145550,14.93
2,81,2016,2097,0.0438328,0.0165991,14.15
2,82,2016,2098,0.0485928,0.0189346,13.38
2,83,2016,2099,0.0538556,0.0215783,12.63
2,84,2016,2100,0.0596709,0.0245465,11.89
2,85,2016,2101,0.0660929,0.0279242,11.18
2,86,2016,2102,0.0731799,0.0318170,10.49
2,87,2016,2103,0.0809950,0.0362880,9.82
2,88,2016,2104,0.0896059,0.0413582,9.17
2,89,2016,2105,0.0990850,0.0470607,8.54
2,90,2016,2106,0.1095094,0.0535340,7.94
2,91,2016,2107,0.1209607,0.0609443,7.36
2,92,2016,2108,0.1335249,0.0694280,6.80
2,93,2016,2109,0.1472918,0.0790827,6.27
2,94,2016,2110,0.1623547,0.0900312,5.77
2,95,2016,2111,0.1788093,0.1024767,5.29
2,96,2016,2112,0.1967531,0.1166656,4.84
2,97,2016,2113,0.2162837,0.1328254,4.41
2,98,2016,2114,0.2374976,0.1511278,4.01
2,99,2016,2115,0.2604884,0.1717733,3.63
2,100,2016,2116,0.2853445,0.1950621,3.28
2,101,2016,2117,0.3121468,0.2213304,2.96
2,102,2016,2118,0.3409660,0.2508638,2.66
2,103,2016,2119,0.3718598,0.2838595,2.38
2,104,2016,2120,0.4048696,0.3205335,2.13
2,105,2016,2121,0.4400178,0.3611678,1.89
2,106,2016,2122,0.4773042,0.4060105,1.68
2,107,2016,2123,0.5167037,0.4551836,1.49
2,108,2016,2124,0.5581634,0.5086714,1.31
2,109,2016,2125,0.6016004,0.5664122,1.16
2,110,2016,2126,0.6469012,0.6282884,1.02
2,111,2016,2127,0.6939204,0.6940252,0.89
2,112,2016,2128,0.7424819,0.7631658,0.78
2,113,2016,2129,0.7923800,0.8351465,0.68
2,114,2016,2130,0.8433824,0.9093372,0.59
2,115,2016,2131,1.0000000,1.0000000,0.50
2,0,2017,2017,0.0078002,0.0065028,91.26
2,1,2017,2018,0.0005341,0.0003801,90.86
2,2,2017,2019,0.0002805,0.0001919,89.90
2,3,2017,2020,0.0001960,0.0001296,88.91
2,4,2017,2021,0.0001520,0.0000961,87.92
2,5,2017,2022,0.0001465,0.0000915,86.93
2,6,2017,2023,0.0001399,0.0000866,85.94
2,7,2017,2024,0.0001348,0.0000828,84.95
2,8,2017,2025,0.0001336,0.0000817,83.95
2,9,2017,2026,0.0001377,0.0000844,82.96
2,10,2017,2027,0.0001465,0.0000908,81.97
2,11,2017,2028,0.0001596,0.0001005,80.98
2,12,2017,2029,0.0001783,0.0001142,79.98
2,13,2017,2030,0.0002061,0.0001342,78.99
2,14,2017,2031,0.0002415,0.0001596,78.00
2,15,2017,2032,0.0002756,0.0001826,77.02
2,16,2017,2033,0.0003003,0.0001958,76.03
2,17,2017,2034,0.0003175,0.0001999,75.04
2,18,2017,2035,0.0003342,0.0002024,74.06
2,19,2017,2036,0.0003539,0.0002080,73.07
2,20,2017,2037,0.0003732,0.0002143,72.09
2,21,2017,2038,0.0003859,0.0002150,71.11
2,22,2017,2039,0.0003897,0.0002075,70.12
2,23,2017,2040,0.0003908,0.0001974,69.13
2,24,2017,2041,0.0003983,0.0001934,68.15
2,25,2017,2042,0.0004147,0.0001969,67.16
2,26,2017,2043,0.0004348,0.0002034,66.17
2,27,2017,2044,0.0004528,0.0002071,65.19
2,28,2017,2045,0.0004684,0.0002098,64.20
2,29,2017,2046,0.0004856,0.0002128,63.21
2,30,2017,2047,0.0005091,0.0002189,62.23
2,31,2017,2048,0.0005408,0.0002283,61.24
2,32,2017,2049,0.0005796,0.0002394,60.26
2,33,2017,2050,0.0006220,0.0002494,59.27
2,34,2017,2051,0.0006665,0.0002583,58.28
2,35,2017,2052,0.0007153,0.0002677,57.30
2,36,2017,2053,0.0007710,0.0002826,56.31
2,37,2017,2054,0.0008314,0.0002977,55.33
2,38,2017,2055,0.0008908,0.0003136,54.35
2,39,2017,2056,0.0009481,0.0003315,53.36
2,40,2017,2057,0.0010090,0.0003530,52.38
2,41,2017,2058,0.0010784,0.0003772,51.40
2,42,2017,2059,0.0011559,0.0004027,50.42
2,43,2017,2060,0.0012427,0.0004335,49.44
2,44,2017,2061,0.0013435,0.0004766,48.46
2,45,2017,2062,0.0014588,0.0005268,47.48
2,46,2017,2063,0.0015840,0.0005813,46.51
2,47,2017,2064,0.0017152,0.0006296,45.53
2,48,2017,2065,0.0018531,0.0006748,44.56
2,49,2017,2066,0.0020059,0.0007223,43.59
2,50,2017,2067,0.0021845,0.0007721,42.62
2,51,2017,2068,0.0023896,0.0008232,41.66
2,52,2017,2069,0.0026115,0.0008734,40.69
2,53,2017,2070,0.0028474,0.0009282,39.73
2,54,2017,2071,0.0031082,0.0010028,38.76
2,55,2017,2072,0.0034035,0.0010920,37.80
2,56,2017,2073,0.0037277,0.0011865,36.84
2,57,2017,2074,0.0040692,0.0012671,35.88
2,58,2017,2075,0.0044295,0.0013400,34.93
2,59,2017,2076,0.0048296,0.0014259,33.97
2,60,2017,2077,0.0052973,0.0015435,33.02
2,61,2017,2078,0.0058480,0.0016971,32.07
2,62,2017,2079,0.0064757,0.0018805,31.13
2,63,2017,2080,0.0071641,0.0020899,30.18
2,64,2017,2081,0.0078986,0.0023132,29.25
2,65,2017,2082,0.0086645,0.0025212,28.31
2,66,2017,2083,0.0094558,0.0027113,27.38
2,67,2017,2084,0.0103010,0.0029028,26.46
2,68,2017,2085,0.0112531,0.0031267,25.53
2,69,2017,2086,0.0123584,0.0034031,24.61
2,70,2017,2087,0.0136702,0.0037642,23.69
2,71,2017,2088,0.0152518,0.0042733,22.78
2,72,2017,2089,0.0170987,0.0049313,21.88
2,73,2017,2090,0.0190837,0.0056349,20.98
2,74,2017,2091,0.0210750,0.0062937,20.10
2,75,2017,2092,0.0231062,0.0069290,19.22
2,76,2017,2093,0.0253497,0.0076763,18.35
2,77,2017,2094,0.0279666,0.0086559,17.49
2,78,2017,2095,0.0310443,0.0099338,16.64
2,79,2017,2096,0.0345982,0.0115250,15.80
2,80,2017,2097,0.0395295,0.0143793,14.98
2,81,2017,2098,0.0438328,0.0164204,14.19
2,82,2017,2099,0.0485928,0.0187334,13.42
2,83,2017,2100,0.0538556,0.0213383,12.67
2,84,2017,2101,0.0596709,0.0242781,11.93
2,85,2017,2102,0.0660929,0.0276485,11.22
2,86,2017,2103,0.0731799,0.0315397,10.52
2,87,2017,2104,0.0809950,0.0359806,9.85
2,88,2017,2105,0.0896059,0.0409951,9.20
2,89,2017,2106,0.0990850,0.0466575,8.57
2,90,2017,2107,0.1095094,0.0531224,7.96
2,91,2017,2108,0.1209607,0.0605306,7.38
2,92,2017,2109,0.1335249,0.0689681,6.82
2,93,2017,2110,0.1472918,0.0785437,6.29
2,94,2017,2111,0.1623547,0.0894411,5.79
2,95,2017,2112,0.1788093,0.1018850,5.31
2,96,2017,2113,0.1967531,0.1160852,4.85
2,97,2017,2114,0.2162837,0.1321996,4.42
2,98,2017,2115,0.2374976,0.1504150,4.02
2,99,2017,2116,0.2604884,0.1710161,3.64
2,100,2017,2117,0.2853445,0.1943283,3.29
2,101,2017,2118,0.3121468,0.2206363,2.97
2,102,2017,2119,0.3409660,0.2501453,2.66
2,103,2017,2120,0.3718598,0.2830856,2.39
2,104,2017,2121,0.4048696,0.3197672,2.13
2,105,2017,2122,0.4400178,0.3604871,1.90
2,106,2017,2123,0.4773042,0.4054343,1.68
2,107,2017,2124,0.5167037,0.4546681,1.49
2,108,2017,2125,0.5581634,0.5082166,1.32
2,109,2017,2126,0.6016004,0.5660801,1.16
2,110,2017,2127,0.6469012,0.6281229,1.02
2,111,2017,2128,0.6939204,0.6940261,0.89
2,112,2017,2129,0.7424819,0.7633390,0.78
2,113,2017,2130,0.7923800,0.8355340,0.68
2,114,2017,2131,0.8433824,0.9099434,0.59
2,115,2017,2132,1.0000000,1.0000000,0.50
2,0,2018,2018,0.0078001,0.0062515,91.39
2,1,2018,2019,0.0005341,0.0003572,90.96
2,2,2018,2020,0.0002805,0.0001800,89.99
2,3,2018,2021,0.0001960,0.0001219,89.01
2,4,2018,2022,0.0001520,0.0000910,88.02
2,5,2018,2023,0.0001465,0.0000873,87.03
2,6,2018,2024,0.0001399,0.0000828,86.03
2,7,2018,2025,0.0001348,0.0000791,85.04
2,8,2018,2026,0.0001336,0.0000783,84.05
2,9,2018,2027,0.0001377,0.0000814,83.05
2,10,2018,2028,0.0001465,0.0000880,82.06
2,11,2018,2029,0.0001596,0.0000977,81.07
2,12,2018,2030,0.0001783,0.0001110,80.08
2,13,2018,2031,0.0002061,0.0001307,79.08
2,14,2018,2032,0.0002415,0.0001560,78.10
2,15,2018,2033,0.0002756,0.0001790,77.11
2,16,2018,2034,0.0003003,0.0001919,76.12
2,17,2018,2035,0.0003175,0.0001954,75.14
2,18,2018,2036,0.0003342,0.0001976,74.15
2,19,2018,2037,0.0003539,0.0002034,73.16
2,20,2018,2038,0.0003732,0.0002099,72.18
2,21,2018,2039,0.0003859,0.0002103,71.19
2,22,2018,2040,0.0003897,0.0002024,70.21
2,23,2018,2041,0.0003908,0.0001923,69.22
2,24,2018,2042,0.0003983,0.0001885,68.24
2,25,2018,2043,0.0004147,0.0001924,67.25
2,26,2018,2044,0.0004348,0.0001987,66.26
2,27,2018,2045,0.0004528,0.0002019,65.28
2,28,2018,2046,0.0004684,0.0002044,64.29
2,29,2018,2047,0.0004856,0.0002076,63.30
2,30,2018,2048,0.0005091,0.0002140,62.31
2,31,2018,2049,0.0005408,0.0002231,61.33
2,32,2018,2050,0.0005796,0.0002334,60.34
2,33,2018,2051,0.0006220,0.0002430,59.36
2,34,2018,2052,0.0006665,0.0002520,58.37
2,35,2018,2053,0.0007153,0.0002615,57.38
2,36,2018,2054,0.0007710,0.0002759,56.40
2,37,2018,2055,0.0008314,0.0002900,55.41
2,38,2018,2056,0.0008908,0.0003053,54.43
2,39,2018,2057,0.0009481,0.0003235,53.45
2,40,2018,2058,0.0010090,0.0003453,52.46
2,41,2018,2059,0.0010784,0.0003689,51.48
2,42,2018,2060,0.0011559,0.0003932,50.50
2,43,2018,2061,0.0012427,0.0004232,49.52
2,44,2018,2062,0.0013435,0.0004664,48.54
2,45,2018,2063,0.0014588,0.0005167,47.56
2,46,2018,2064,0.0015840,0.0005702,46.59
2,47,2018,2065,0.0017152,0.0006168,45.61
2,48,2018,2066,0.0018531,0.0006609,44.64
2,49,2018,2067,0.0020059,0.0007084,43.67
2,50,2018,2068,0.0021845,0.0007584,42.70
2,51,2018,2069,0.0023896,0.0008081,41.73
2,52,2018,2070,0.0026115,0.0008558,40.77
2,53,2018,2071,0.0028474,0.0009089,39.80
2,54,2018,2072,0.0031082,0.0009833,38.84
2,55,2018,2073,0.0034035,0.0010726,37.88
2,56,2018,2074,0.0037277,0.0011652,36.92
2,57,2018,2075,0.0040692,0.0012422,35.96
2,58,2018,2076,0.0044295,0.0013128,35.00
2,59,2018,2077,0.0048296,0.0013986,34.05
2,60,2018,2078,0.0052973,0.0015163,33.09
2,61,2018,2079,0.0058480,0.0016668,32.14
2,62,2018,2080,0.0064757,0.0018444,31.20
2,63,2018,2081,0.0071641,0.0020496,30.25
2,64,2018,2082,0.0078986,0.0022720,29.31
2,65,2018,2083,0.0086645,0.0024800,28.38
2,66,2018,2084,0.0094558,0.0026659,27.45
2,67,2018,2085,0.0103010,0.0028499,26.52
2,68,2018,2086,0.0112531,0.0030685,25.60
2,69,2018,2087,0.0123584,0.0033438,24.67
2,70,2018,2088,0.0136702,0.0037042,23.75
2,71,2018,2089,0.0152518,0.0042050,22.84
2,72,2018,2090,0.0170987,0.0048483,21.93
2,73,2018,2091,0.0190837,0.0055409,21.04
2,74,2018,2092,0.0210750,0.0061970,20.15
2,75,2018,2093,0.0231062,0.0068315,19.28
2,76,2018,2094,0.0253497,0.0075673,18.41
2,77,2018,2095,0.0279666,0.0085258,17.54
2,78,2018,2096,0.0310443,0.0097872,16.69
2,79,2018,2097,0.0345982,0.0113722,15.85
2,80,2018,2098,0.0395295,0.0142182,15.03
2,81,2018,2099,0.0438328,0.0162388,14.23
2,82,2018,2100,0.0485928,0.0185164,13.46
2,83,2018,2101,0.0538556,0.0210953,12.71
2,84,2018,2102,0.0596709,0.0240281,11.97
2,85,2018,2103,0.0660929,0.0273966,11.25
2,86,2018,2104,0.0731799,0.0312599,10.55
2,87,2018,2105,0.0809950,0.0356494,9.88
2,88,2018,2106,0.0896059,0.0406266,9.23
2,89,2018,2107,0.0990850,0.0462804,8.59
2,90,2018,2108,0.1095094,0.0527423,7.99
2,91,2018,2109,0.1209607,0.0601067,7.40
2,92,2018,2110,0.1335249,0.0684694,6.85
2,93,2018,2111,0.1472918,0.0779954,6.31
2,94,2018,2112,0.1623547,0.0888886,5.80
2,95,2018,2113,0.1788093,0.1013402,5.32
2,96,2018,2114,0.1967531,0.1154940,4.87
2,97,2018,2115,0.2162837,0.1315214,4.44
2,98,2018,2116,0.2374976,0.1496884,4.03
2,99,2018,2117,0.2604884,0.1703050,3.65
2,100,2018,2118,0.2853445,0.1936478,3.30
2,101,2018,2119,0.3121468,0.2199222,2.97
2,102,2018,2120,0.3409660,0.2493630,2.67
2,103,2018,2121,0.3718598,0.2822949,2.39
2,104,2018,2122,0.4048696,0.3190463,2.13
2,105,2018,2123,0.4400178,0.3598556,1.90
2,106,2018,2124,0.4773042,0.4048418,1.69
2,107,2018,2125,0.5167037,0.4541062,1.49
2,108,2018,2126,0.5581634,0.5077512,1.32
2,109,2018,2127,0.6016004,0.5657675,1.16
2,110,2018,2128,0.6469012,0.6279699,1.02
2,111,2018,2129,0.6939204,0.6940269,0.89
2,112,2018,2130,0.7424819,0.7635275,0.78
2,113,2018,2131,0.7923800,0.8359308,0.68
2,114,2018,2132,0.8433824,0.9105147,0.59
2,115,2018,2133,1.0000000,1.0000000,0.50
2,0,2019,2019,0.0078001,0.0060037,91.50
2,1,2019,2020,0.0005341,0.0003338,91.06
2,2,2019,2021,0.0002805,0.0001686,90.09
2,3,2019,2022,0.0001960,0.0001151,89.10
2,4,2019,2023,0.0001520,0.0000864,88.11
2,5,2019,2024,0.0001465,0.0000832,87.12
2,6,2019,2025,0.0001399,0.0000789,86.13
2,7,2019,2026,0.0001348,0.0000755,85.13
2,8,2019,2027,0.0001336,0.0000752,84.14
2,9,2019,2028,0.0001377,0.0000786,83.15
2,10,2019,2029,0.0001465,0.0000853,82.15
2,11,2019,2030,0.0001596,0.0000946,81.16
2,12,2019,2031,0.0001783,0.0001078,80.17
2,13,2019,2032,0.0002061,0.0001275,79.18
2,14,2019,2033,0.0002415,0.0001528,78.19
2,15,2019,2034,0.0002756,0.0001755,77.20
2,16,2019,2035,0.0003003,0.0001878,76.21
2,17,2019,2036,0.0003175,0.0001910,75.23
2,18,2019,2037,0.0003342,0.0001933,74.24
2,19,2019,2038,0.0003539,0.0001991,73.25
2,20,2019,2039,0.0003732,0.0002054,72.27
2,21,2019,2040,0.0003859,0.0002053,71.28
2,22,2019,2041,0.0003897,0.0001973,70.30
2,23,2019,2042,0.0003908,0.0001875,69.31
2,24,2019,2043,0.0003983,0.0001841,68.32
2,25,2019,2044,0.0004147,0.0001879,67.34
2,26,2019,2045,0.0004348,0.0001937,66.35
2,27,2019,2046,0.0004528,0.0001967,65.36
2,28,2019,2047,0.0004684,0.0001994,64.37
2,29,2019,2048,0.0004856,0.0002030,63.39
2,30,2019,2049,0.0005091,0.0002091,62.40
2,31,2019,2050,0.0005408,0.0002175,61.41
2,32,2019,2051,0.0005796,0.0002274,60.43
2,33,2019,2052,0.0006220,0.0002371,59.44
2,34,2019,2053,0.0006665,0.0002463,58.45
2,35,2019,2054,0.0007153,0.0002553,57.47
2,36,2019,2055,0.0007710,0.0002687,56.48
2,37,2019,2056,0.0008314,0.0002823,55.50
2,38,2019,2057,0.0008908,0.0002977,54.51
2,39,2019,2058,0.0009481,0.0003162,53.53
2,40,2019,2059,0.0010090,0.0003375,52.55
2,41,2019,2060,0.0010784,0.0003600,51.56
2,42,2019,2061,0.0011559,0.0003836,50.58
2,43,2019,2062,0.0012427,0.0004138,49.60
2,44,2019,2063,0.0013435,0.0004571,48.62
2,45,2019,2064,0.0014588,0.0005065,47.64
2,46,2019,2065,0.0015840,0.0005583,46.67
2,47,2019,2066,0.0017152,0.0006039,45.69
2,48,2019,2067,0.0018531,0.0006480,44.72
2,49,2019,2068,0.0020059,0.0006958,43.75
2,50,2019,2069,0.0021845,0.0007446,42.78
2,51,2019,2070,0.0023896,0.0007920,41.81
2,52,2019,2071,0.0026115,0.0008382,40.84
2,53,2019,2072,0.0028474,0.0008912,39.88
2,54,2019,2073,0.0031082,0.0009657,38.91
2,55,2019,2074,0.0034035,0.0010532,37.95
2,56,2019,2075,0.0037277,0.0011424,36.99
2,57,2019,2076,0.0040692,0.0012172,36.03
2,58,2019,2077,0.0044295,0.0012878,35.07
2,59,2019,2078,0.0048296,0.0013737,34.12
2,60,2019,2079,0.0052973,0.0014888,33.17
2,61,2019,2080,0.0058480,0.0016343,32.21
2,62,2019,2081,0.0064757,0.0018082,31.27
2,63,2019,2082,0.0071641,0.0020124,30.32
2,64,2019,2083,0.0078986,0.0022345,29.38
2,65,2019,2084,0.0086645,0.0024384,28.45
2,66,2019,2085,0.0094558,0.0026173,27.51
2,67,2019,2086,0.0103010,0.0027967,26.59
2,68,2019,2087,0.0112531,0.0030147,25.66
2,69,2019,2088,0.0123584,0.0032898,24.74
2,70,2019,2089,0.0136702,0.0036434,23.82
2,71,2019,2090,0.0152518,0.0041318,22.90
2,72,2019,2091,0.0170987,0.0047648,21.99
2,73,2019,2092,0.0190837,0.0054538,21.10
2,74,2019,2093,0.0210750,0.0061084,20.21
2,75,2019,2094,0.0231062,0.0067326,19.33
2,76,2019,2095,0.0253497,0.0074502,18.46
2,77,2019,2096,0.0279666,0.0083947,17.59
2,78,2019,2097,0.0310443,0.0096510,16.74
2,79,2019,2098,0.0345982,0.0112321,15.90
2,80,2019,2099,0.0395295,0.0140545,15.07
2,81,2019,2100,0.0438328,0.0160430,14.28
2,82,2019,2101,0.0485928,0.0182969,13.50
2,83,2019,2102,0.0538556,0.0208691,12.75
2,84,2019,2103,0.0596709,0.0237998,12.01
2,85,2019,2104,0.0660929,0.0271425,11.29
2,86,2019,2105,0.0731799,0.0309586,10.59
2,87,2019,2106,0.0809950,0.0353135,9.91
2,88,2019,2107,0.0896059,0.0402822,9.25
2,89,2019,2108,0.0990850,0.0459323,8.62
2,90,2019,2109,0.1095094,0.0523529,8.01
2,91,2019,2110,0.1209607,0.0596471,7.43
2,92,2019,2111,0.1335249,0.0679624,6.87
2,93,2019,2112,0.1472918,0.0774824,6.33
2,94,2019,2113,0.1623547,0.0883803,5.82
2,95,2019,2114,0.1788093,0.1007855,5.34
2,96,2019,2115,0.1967531,0.1148536,4.88
2,97,2019,2116,0.2162837,0.1308303,4.45
2,98,2019,2117,0.2374976,0.1490065,4.04
2,99,2019,2118,0.2604884,0.1696459,3.66
2,100,2019,2119,0.2853445,0.1929480,3.31
2,101,2019,2120,0.3121468,0.2191449,2.98
2,102,2019,2121,0.3409660,0.2485642,2.68
2,103,2019,2122,0.3718598,0.2815515,2.39
2,104,2019,2123,0.4048696,0.3183779,2.14
2,105,2019,2124,0.4400178,0.3592065,1.90
2,106,2019,2125,0.4773042,0.4041961,1.69
2,107,2019,2126,0.5167037,0.4535315,1.49
2,108,2019,2127,0.5581634,0.5073132,1.32
2,109,2019,2128,0.6016004,0.5654785,1.16
2,110,2019,2129,0.6469012,0.6278135,1.02
2,111,2019,2130,0.6939204,0.6940279,0.89
2,112,2019,2131,0.7424819,0.7637205,0.78
2,113,2019,2132,0.7923800,0.8363048,0.68
2,114,2019,2133,0.8433824,0.9110445,0.59
2,115,2019,2134,1.0000000,1.0000000,0.50
2,0,2020,2020,0.0078001,0.0057449,91.62
2,1,2020,2021,0.0005341,0.0003115,91.15
2,2,2020,2022,0.0002805,0.0001585,90.18
2,3,2020,2023,0.0001960,0.0001091,89.19
2,4,2020,2024,0.0001520,0.0000820,88.20
2,5,2020,2025,0.0001465,0.0000790,87.21
2,6,2020,2026,0.0001399,0.0000750,86.22
2,7,2020,2027,0.0001348,0.0000723,85.22
2,8,2020,2028,0.0001336,0.0000725,84.23
2,9,2020,2029,0.0001377,0.0000759,83.24
2,10,2020,2030,0.0001465,0.0000824,82.24
2,11,2020,2031,0.0001596,0.0000916,81.25
2,12,2020,2032,0.0001783,0.0001049,80.26
2,13,2020,2033,0.0002061,0.0001246,79.27
2,14,2020,2034,0.0002415,0.0001495,78.28
2,15,2020,2035,0.0002756,0.0001716,77.29
2,16,2020,2036,0.0003003,0.0001836,76.30
2,17,2020,2037,0.0003175,0.0001869,75.31
2,18,2020,2038,0.0003342,0.0001893,74.33
2,19,2020,2039,0.0003539,0.0001949,73.34
2,20,2020,2040,0.0003732,0.0002006,72.36
2,21,2020,2041,0.0003859,0.0002004,71.37
2,22,2020,2042,0.0003897,0.0001927,70.39
2,23,2020,2043,0.0003908,0.0001833,69.40
2,24,2020,2044,0.0003983,0.0001798,68.41
2,25,2020,2045,0.0004147,0.0001831,67.42
2,26,2020,2046,0.0004348,0.0001887,66.44
2,27,2020,2047,0.0004528,0.0001919,65.45
2,28,2020,2048,0.0004684,0.0001949,64.46
2,29,2020,2049,0.0004856,0.0001983,63.47
2,30,2020,2050,0.0005091,0.0002038,62.49
2,31,2020,2051,0.0005408,0.0002120,61.50
2,32,2020,2052,0.0005796,0.0002220,60.51
2,33,2020,2053,0.0006220,0.0002317,59.52
2,34,2020,2054,0.0006665,0.0002404,58.54
2,35,2020,2055,0.0007153,0.0002486,57.55
2,36,2020,2056,0.0007710,0.0002616,56.57
2,37,2020,2057,0.0008314,0.0002752,55.58
2,38,2020,2058,0.0008908,0.0002909,54.60
2,39,2020,2059,0.0009481,0.0003089,53.61
2,40,2020,2060,0.0010090,0.0003292,52.63
2,41,2020,2061,0.0010784,0.0003511,51.65
2,42,2020,2062,0.0011559,0.0003749,50.66
2,43,2020,2063,0.0012427,0.0004052,49.68
2,44,2020,2064,0.0013435,0.0004477,48.70
2,45,2020,2065,0.0014588,0.0004956,47.72
2,46,2020,2066,0.0015840,0.0005464,46.75
2,47,2020,2067,0.0017152,0.0005920,45.77
2,48,2020,2068,0.0018531,0.0006364,44.80
2,49,2020,2069,0.0020059,0.0006831,43.83
2,50,2020,2070,0.0021845,0.0007298,42.86
2,51,2020,2071,0.0023896,0.0007758,41.89
2,52,2020,2072,0.0026115,0.0008219,40.92
2,53,2020,2073,0.0028474,0.0008750,39.95
2,54,2020,2074,0.0031082,0.0009480,38.99
2,55,2020,2075,0.0034035,0.0010324,38.02
2,56,2020,2076,0.0037277,0.0011195,37.06
2,57,2020,2077,0.0040692,0.0011942,36.10
2,58,2020,2078,0.0044295,0.0012650,35.15
2,59,2020,2079,0.0048296,0.0013488,34.19
2,60,2020,2080,0.0052973,0.0014596,33.24
2,61,2020,2081,0.0058480,0.0016018,32.28
2,62,2020,2082,0.0064757,0.0017748,31.33
2,63,2020,2083,0.0071641,0.0019786,30.39
2,64,2020,2084,0.0078986,0.0021966,29.45
2,65,2020,2085,0.0086645,0.0023939,28.51
2,66,2020,2086,0.0094558,0.0025684,27.58
2,67,2020,2087,0.0103010,0.0027475,26.65
2,68,2020,2088,0.0112531,0.0029656,25.72
2,69,2020,2089,0.0123584,0.0032351,24.80
2,70,2020,2090,0.0136702,0.0035783,23.88
2,71,2020,2091,0.0152518,0.0040581,22.96
2,72,2020,2092,0.0170987,0.0046874,22.05
2,73,2020,2093,0.0190837,0.0053741,21.15
2,74,2020,2094,0.0210750,0.0060186,20.26
2,75,2020,2095,0.0231062,0.0066264,19.38
2,76,2020,2096,0.0253497,0.0073321,18.51
2,77,2020,2097,0.0279666,0.0082730,17.64
2,78,2020,2098,0.0310443,0.0095263,16.79
2,79,2020,2099,0.0345982,0.0110900,15.94
2,80,2020,2100,0.0395295,0.0138782,15.12
2,81,2020,2101,0.0438328,0.0158450,14.32
2,82,2020,2102,0.0485928,0.0180926,13.54
2,83,2020,2103,0.0538556,0.0206627,12.78
2,84,2020,2104,0.0596709,0.0235696,12.04
2,85,2020,2105,0.0660929,0.0268691,11.32
2,86,2020,2106,0.0731799,0.0306531,10.62
2,87,2020,2107,0.0809950,0.0349996,9.94
2,88,2020,2108,0.0896059,0.0399644,9.28
2,89,2020,2109,0.0990850,0.0455759,8.65
2,90,2020,2110,0.1095094,0.0519311,8.04
2,91,2020,2111,0.1209607,0.0591802,7.45
2,92,2020,2112,0.1335249,0.0674881,6.89
2,93,2020,2113,0.1472918,0.0770105,6.35
2,94,2020,2114,0.1623547,0.0878629,5.84
2,95,2020,2115,0.1788093,0.1001849,5.35
2,96,2020,2116,0.1967531,0.1142014,4.89
2,97,2020,2117,0.2162837,0.1301820,4.46
2,98,2020,2118,0.2374976,0.1483745,4.05
2,99,2020,2119,0.2604884,0.1689683,3.67
2,100,2020,2120,0.2853445,0.1921867,3.32
2,101,2020,2121,0.3121468,0.2183516,2.99
2,102,2020,2122,0.3409660,0.2478134,2.68
2,103,2020,2123,0.3718598,0.2808623,2.40
2,104,2020,2124,0.4048696,0.3176909,2.14
2,105,2020,2125,0.4400178,0.3584994,1.90
2,106,2020,2126,0.4773042,0.4035360,1.69
2,107,2020,2127,0.5167037,0.4529907,1.49
2,108,2020,2128,0.5581634,0.5069084,1.32
2,109,2020,2129,0.6016004,0.5651832,1.16
2,110,2020,2130,0.6469012,0.6276432,1.02
2,111,2020,2131,0.6939204,0.6940289,0.89
2,112,2020,2132,0.7424819,0.7639024,0.78
2,113,2020,2133,0.7923800,0.8366516,0.68
2,114,2020,2134,0.8433824,0.9115887,0.59
2,115,2020,2135,1.0000000,1.0000000,0.50
2,0,2021,2021,0.0078000,0.0054914,91.74
2,1,2021,2022,0.0005341,0.0002918,91.25
2,2,2021,2023,0.0002805,0.0001497,90.27
2,3,2021,2024,0.0001960,0.0001033,89.29
2,4,2021,2025,0.0001520,0.0000774,88.30
2,5,2021,2026,0.0001465,0.0000748,87.30
2,6,2021,2027,0.0001399,0.0000716,86.31
2,7,2021,2028,0.0001348,0.0000694,85.32
2,8,2021,2029,0.0001336,0.0000697,84.32
2,9,2021,2030,0.0001377,0.0000731,83.33
2,10,2021,2031,0.0001465,0.0000795,82.33
2,11,2021,2032,0.0001596,0.0000889,81.34
2,12,2021,2033,0.0001783,0.0001022,80.35
2,13,2021,2034,0.0002061,0.0001217,79.36
2,14,2021,2035,0.0002415,0.0001461,78.36
2,15,2021,2036,0.0002756,0.0001678,77.38
2,16,2021,2037,0.0003003,0.0001798,76.39
2,17,2021,2038,0.0003175,0.0001832,75.40
2,18,2021,2039,0.0003342,0.0001853,74.42
2,19,2021,2040,0.0003539,0.0001904,73.43
2,20,2021,2041,0.0003732,0.0001959,72.44
2,21,2021,2042,0.0003859,0.0001958,71.46
2,22,2021,2043,0.0003897,0.0001885,70.47
2,23,2021,2044,0.0003908,0.0001790,69.49
2,24,2021,2045,0.0003983,0.0001752,68.50
2,25,2021,2046,0.0004147,0.0001783,67.51
2,26,2021,2047,0.0004348,0.0001841,66.52
2,27,2021,2048,0.0004528,0.0001875,65.53
2,28,2021,2049,0.0004684,0.0001904,64.55
2,29,2021,2050,0.0004856,0.0001933,63.56
2,30,2021,2051,0.0005091,0.0001986,62.57
2,31,2021,2052,0.0005408,0.0002068,61.58
2,32,2021,2053,0.0005796,0.0002170,60.59
2,33,2021,2054,0.0006220,0.0002263,59.61
2,34,2021,2055,0.0006665,0.0002343,58.62
2,35,2021,2056,0.0007153,0.0002420,57.64
2,36,2021,2057,0.0007710,0.0002550,56.65
2,37,2021,2058,0.0008314,0.0002689,55.66
2,38,2021,2059,0.0008908,0.0002840,54.68
2,39,2021,2060,0.0009481,0.0003011,53.69
2,40,2021,2061,0.0010090,0.0003209,52.71
2,41,2021,2062,0.0010784,0.0003430,51.73
2,42,2021,2063,0.0011559,0.0003669,50.74
2,43,2021,2064,0.0012427,0.0003966,49.76
2,44,2021,2065,0.0013435,0.0004377,48.78
2,45,2021,2066,0.0014588,0.0004846,47.80
2,46,2021,2067,0.0015840,0.0005354,46.83
2,47,2021,2068,0.0017152,0.0005812,45.85
2,48,2021,2069,0.0018531,0.0006247,44.88
2,49,2021,2070,0.0020059,0.0006695,43.90
2,50,2021,2071,0.0021845,0.0007150,42.93
2,51,2021,2072,0.0023896,0.0007609,41.96
2,52,2021,2073,0.0026115,0.0008070,41.00
2,53,2021,2074,0.0028474,0.0008588,40.03
2,54,2021,2075,0.0031082,0.0009290,39.06
2,55,2021,2076,0.0034035,0.0010115,38.10
2,56,2021,2077,0.0037277,0.0010983,37.14
2,57,2021,2078,0.0040692,0.0011732,36.18
2,58,2021,2079,0.0044295,0.0012421,35.22
2,59,2021,2080,0.0048296,0.0013221,34.26
2,60,2021,2081,0.0052973,0.0014302,33.31
2,61,2021,2082,0.0058480,0.0015717,32.35
2,62,2021,2083,0.0064757,0.0017444,31.40
2,63,2021,2084,0.0071641,0.0019445,30.46
2,64,2021,2085,0.0078986,0.0021562,29.52
2,65,2021,2086,0.0086645,0.0023492,28.58
2,66,2021,2087,0.0094558,0.0025233,27.64
2,67,2021,2088,0.0103010,0.0027026,26.71
2,68,2021,2089,0.0112531,0.0029159,25.78
2,69,2021,2090,0.0123584,0.0031765,24.86
2,70,2021,2091,0.0136702,0.0035128,23.94
2,71,2021,2092,0.0152518,0.0039898,23.02
2,72,2021,2093,0.0170987,0.0046167,22.11
2,73,2021,2094,0.0190837,0.0052933,21.21
2,74,2021,2095,0.0210750,0.0059221,20.32
2,75,2021,2096,0.0231062,0.0065193,19.44
2,76,2021,2097,0.0253497,0.0072226,18.56
2,77,2021,2098,0.0279666,0.0081616,17.69
2,78,2021,2099,0.0310443,0.0093998,16.83
2,79,2021,2100,0.0345982,0.0109371,15.99
2,80,2021,2101,0.0395295,0.0137000,15.16
2,81,2021,2102,0.0438328,0.0156608,14.36
2,82,2021,2103,0.0485928,0.0179062,13.58
2,83,2021,2104,0.0538556,0.0204546,12.82
2,84,2021,2105,0.0596709,0.0233220,12.08
2,85,2021,2106,0.0660929,0.0265919,11.36
2,86,2021,2107,0.0731799,0.0303678,10.65
2,87,2021,2108,0.0809950,0.0347101,9.97
2,88,2021,2109,0.0896059,0.0396391,9.31
2,89,2021,2110,0.0990850,0.0451900,8.68
2,90,2021,2111,0.1095094,0.0515026,8.06
2,91,2021,2112,0.1209607,0.0587436,7.47
2,92,2021,2113,0.1335249,0.0670521,6.91
2,93,2021,2114,0.1472918,0.0765304,6.37
2,94,2021,2115,0.1623547,0.0873029,5.86
2,95,2021,2116,0.1788093,0.0995735,5.37
2,96,2021,2117,0.1967531,0.1135898,4.91
2,97,2021,2118,0.2162837,0.1295815,4.47
2,98,2021,2119,0.2374976,0.1477252,4.06
2,99,2021,2120,0.2604884,0.1682314,3.68
2,100,2021,2121,0.2853445,0.1914099,3.32
2,101,2021,2122,0.3121468,0.2176062,2.99
2,102,2021,2123,0.3409660,0.2471177,2.69
2,103,2021,2124,0.3718598,0.2801543,2.40
2,104,2021,2125,0.4048696,0.3169430,2.14
2,105,2021,2126,0.4400178,0.3577767,1.91
2,106,2021,2127,0.4773042,0.4029150,1.69
2,107,2021,2128,0.5167037,0.4524910,1.50
2,108,2021,2129,0.5581634,0.5064948,1.32
2,109,2021,2130,0.6016004,0.5648620,1.16
2,110,2021,2131,0.6469012,0.6274690,1.02
2,111,2021,2132,0.6939204,0.6940298,0.89
2,112,2021,2133,0.7424819,0.7640711,0.78
2,113,2021,2134,0.7923800,0.8370079,0.68
2,114,2021,2135,0.8433824,0.9121819,0.59
2,115,2021,2136,1.0000000,1.0000000,0.50
2,0,2022,2022,0.0078000,0.0052628,91.86
2,1,2022,2023,0.0005341,0.0002747,91.34
2,2,2022,2024,0.0002805,0.0001412,90.37
2,3,2022,2025,0.0001960,0.0000973,89.38
2,4,2022,2026,0.0001520,0.0000730,88.39
2,5,2022,2027,0.0001465,0.0000711,87.39
2,6,2022,2028,0.0001399,0.0000685,86.40
2,7,2022,2029,0.0001348,0.0000666,85.41
2,8,2022,2030,0.0001336,0.0000669,84.41
2,9,2022,2031,0.0001377,0.0000703,83.42
2,10,2022,2032,0.0001465,0.0000769,82.42
2,11,2022,2033,0.0001596,0.0000864,81.43
2,12,2022,2034,0.0001783,0.0000996,80.44
2,13,2022,2035,0.0002061,0.0001186,79.44
2,14,2022,2036,0.0002415,0.0001427,78.45
2,15,2022,2037,0.0002756,0.0001643,77.46
2,16,2022,2038,0.0003003,0.0001764,76.48
2,17,2022,2039,0.0003175,0.0001794,75.49
2,18,2022,2040,0.0003342,0.0001810,74.50
2,19,2022,2041,0.0003539,0.0001859,73.52
2,20,2022,2042,0.0003732,0.0001915,72.53
2,21,2022,2043,0.0003859,0.0001917,71.54
2,22,2022,2044,0.0003897,0.0001843,70.56
2,23,2022,2045,0.0003908,0.0001745,69.57
2,24,2022,2046,0.0003983,0.0001706,68.58
2,25,2022,2047,0.0004147,0.0001739,67.59
2,26,2022,2048,0.0004348,0.0001799,66.61
2,27,2022,2049,0.0004528,0.0001831,65.62
2,28,2022,2050,0.0004684,0.0001856,64.63
2,29,2022,2051,0.0004856,0.0001883,63.64
2,30,2022,2052,0.0005091,0.0001938,62.65
2,31,2022,2053,0.0005408,0.0002022,61.67
2,32,2022,2054,0.0005796,0.0002119,60.68
2,33,2022,2055,0.0006220,0.0002205,59.69
2,34,2022,2056,0.0006665,0.0002281,58.70
2,35,2022,2057,0.0007153,0.0002359,57.72
2,36,2022,2058,0.0007710,0.0002491,56.73
2,37,2022,2059,0.0008314,0.0002625,55.74
2,38,2022,2060,0.0008908,0.0002768,54.76
2,39,2022,2061,0.0009481,0.0002934,53.77
2,40,2022,2062,0.0010090,0.0003133,52.79
2,41,2022,2063,0.0010784,0.0003356,51.81
2,42,2022,2064,0.0011559,0.0003589,50.82
2,43,2022,2065,0.0012427,0.0003873,49.84
2,44,2022,2066,0.0013435,0.0004276,48.86
2,45,2022,2067,0.0014588,0.0004746,47.88
2,46,2022,2068,0.0015840,0.0005255,46.90
2,47,2022,2069,0.0017152,0.0005704,45.93
2,48,2022,2070,0.0018531,0.0006122,44.95
2,49,2022,2071,0.0020059,0.0006559,43.98
2,50,2022,2072,0.0021845,0.0007013,43.01
2,51,2022,2073,0.0023896,0.0007473,42.04
2,52,2022,2074,0.0026115,0.0007922,41.07
2,53,2022,2075,0.0028474,0.0008415,40.10
2,54,2022,2076,0.0031082,0.0009100,39.14
2,55,2022,2077,0.0034035,0.0009922,38.17
2,56,2022,2078,0.0037277,0.0010791,37.21
2,57,2022,2079,0.0040692,0.0011521,36.25
2,58,2022,2080,0.0044295,0.0012176,35.29
2,59,2022,2081,0.0048296,0.0012954,34.33
2,60,2022,2082,0.0052973,0.0014030,33.38
2,61,2022,2083,0.0058480,0.0015444,32.42
2,62,2022,2084,0.0064757,0.0017137,31.47
2,63,2022,2085,0.0071641,0.0019080,30.52
2,64,2022,2086,0.0078986,0.0021155,29.58
2,65,2022,2087,0.0086645,0.0023078,28.64
2,66,2022,2088,0.0094558,0.0024820,27.71
2,67,2022,2089,0.0103010,0.0026572,26.78
2,68,2022,2090,0.0112531,0.0028627,25.85
2,69,2022,2091,0.0123584,0.0031176,24.92
2,70,2022,2092,0.0136702,0.0034522,24.00
2,71,2022,2093,0.0152518,0.0039275,23.08
2,72,2022,2094,0.0170987,0.0045450,22.17
2,73,2022,2095,0.0190837,0.0052065,21.27
2,74,2022,2096,0.0210750,0.0058249,20.37
2,75,2022,2097,0.0231062,0.0064200,19.49
2,76,2022,2098,0.0253497,0.0071224,18.61
2,77,2022,2099,0.0279666,0.0080487,17.74
2,78,2022,2100,0.0310443,0.0092638,16.88
2,79,2022,2101,0.0345982,0.0107827,16.04
2,80,2022,2102,0.0395295,0.0135343,15.21
2,81,2022,2103,0.0438328,0.0154929,14.41
2,82,2022,2104,0.0485928,0.0177184,13.63
2,83,2022,2105,0.0538556,0.0202308,12.86
2,84,2022,2106,0.0596709,0.0230711,12.12
2,85,2022,2107,0.0660929,0.0263332,11.39
2,86,2022,2108,0.0731799,0.0301048,10.69
2,87,2022,2109,0.0809950,0.0344139,10.00
2,88,2022,2110,0.0896059,0.0392869,9.34
2,89,2022,2111,0.0990850,0.0447981,8.70
2,90,2022,2112,0.1095094,0.0511022,8.09
2,91,2022,2113,0.1209607,0.0583423,7.50
2,92,2022,2114,0.1335249,0.0666086,6.93
2,93,2022,2115,0.1472918,0.0760110,6.39
2,94,2022,2116,0.1623547,0.0867330,5.87
2,95,2022,2117,0.1788093,0.0990003,5.38
2,96,2022,2118,0.1967531,0.1130235,4.92
2,97,2022,2119,0.2162837,0.1289646,4.48
2,98,2022,2120,0.2374976,0.1470193,4.07
2,99,2022,2121,0.2604884,0.1674800,3.69
2,100,2022,2122,0.2853445,0.1906804,3.33
2,101,2022,2123,0.3121468,0.2169158,3.00
2,102,2022,2124,0.3409660,0.2464032,2.69
2,103,2022,2125,0.3718598,0.2793838,2.41
2,104,2022,2126,0.4048696,0.3161786,2.15
2,105,2022,2127,0.4400178,0.3570970,1.91
2,106,2022,2128,0.4773042,0.4023414,1.69
2,107,2022,2129,0.5167037,0.4519806,1.50
2,108,2022,2130,0.5581634,0.5060449,1.32
2,109,2022,2131,0.6016004,0.5645332,1.16
2,110,2022,2132,0.6469012,0.6273049,1.02
2,111,2022,2133,0.6939204,0.6940306,0.89
2,112,2022,2134,0.7424819,0.7642444,0.78
2,113,2022,2135,0.7923800,0.8373962,0.68
2,114,2022,2136,0.8433824,0.9127893,0.59
2,115,2022,2137,1.0000000,1.0000000,0.50
2,0,2023,2023,0.0078000,0.0050594,91.97
2,1,2023,2024,0.0005341,0.0002581,91.43
2,2,2023,2025,0.0002805,0.0001325,90.46
2,3,2023,2026,0.0001960,0.0000916,89.47
2,4,2023,2027,0.0001520,0.0000690,88.48
2,5,2023,2028,0.0001465,0.0000679,87.48
2,6,2023,2029,0.0001399,0.0000655,86.49
2,7,2023,2030,0.0001348,0.0000637,85.49
2,8,2023,2031,0.0001336,0.0000641,84.50
2,9,2023,2032,0.0001377,0.0000677,83.50
2,10,2023,2033,0.0001465,0.0000745,82.51
2,11,2023,2034,0.0001596,0.0000840,81.52
2,12,2023,2035,0.0001783,0.0000968,80.52
2,13,2023,2036,0.0002061,0.0001156,79.53
2,14,2023,2037,0.0002415,0.0001395,78.54
2,15,2023,2038,0.0002756,0.0001611,77.55
2,16,2023,2039,0.0003003,0.0001729,76.56
2,17,2023,2040,0.0003175,0.0001755,75.58
2,18,2023,2041,0.0003342,0.0001768,74.59
2,19,2023,2042,0.0003539,0.0001817,73.60
2,20,2023,2043,0.0003732,0.0001875,72.62
2,21,2023,2044,0.0003859,0.0001876,71.63
2,22,2023,2045,0.0003897,0.0001798,70.64
2,23,2023,2046,0.0003908,0.0001700,69.66
2,24,2023,2047,0.0003983,0.0001664,68.67
2,25,2023,2048,0.0004147,0.0001699,67.68
2,26,2023,2049,0.0004348,0.0001757,66.69
2,27,2023,2050,0.0004528,0.0001784,65.70
2,28,2023,2051,0.0004684,0.0001807,64.71
2,29,2023,2052,0.0004856,0.0001837,63.73
2,30,2023,2053,0.0005091,0.0001894,62.74
2,31,2023,2054,0.0005408,0.0001975,61.75
2,32,2023,2055,0.0005796,0.0002065,60.76
2,33,2023,2056,0.0006220,0.0002148,59.77
2,34,2023,2057,0.0006665,0.0002224,58.79
2,35,2023,2058,0.0007153,0.0002304,57.80
2,36,2023,2059,0.0007710,0.0002432,56.81
2,37,2023,2060,0.0008314,0.0002557,55.83
2,38,2023,2061,0.0008908,0.0002695,54.84
2,39,2023,2062,0.0009481,0.0002863,53.85
2,40,2023,2063,0.0010090,0.0003064,52.87
2,41,2023,2064,0.0010784,0.0003281,51.89
2,42,2023,2065,0.0011559,0.0003504,50.90
2,43,2023,2066,0.0012427,0.0003781,49.92
2,44,2023,2067,0.0013435,0.0004184,48.94
2,45,2023,2068,0.0014588,0.0004654,47.96
2,46,2023,2069,0.0015840,0.0005155,46.98
2,47,2023,2070,0.0017152,0.0005588,46.01
2,48,2023,2071,0.0018531,0.0005996,45.03
2,49,2023,2072,0.0020059,0.0006434,44.06
2,50,2023,2073,0.0021845,0.0006889,43.09
2,51,2023,2074,0.0023896,0.0007336,42.12
2,52,2023,2075,0.0026115,0.0007762,41.15
2,53,2023,2076,0.0028474,0.0008241,40.18
2,54,2023,2077,0.0031082,0.0008924,39.21
2,55,2023,2078,0.0034035,0.0009747,38.24
2,56,2023,2079,0.0037277,0.0010598,37.28
2,57,2023,2080,0.0040692,0.0011296,36.32
2,58,2023,2081,0.0044295,0.0011930,35.36
2,59,2023,2082,0.0048296,0.0012707,34.40
2,60,2023,2083,0.0052973,0.0013783,33.45
2,61,2023,2084,0.0058480,0.0015168,32.49
2,62,2023,2085,0.0064757,0.0016809,31.54
2,63,2023,2086,0.0071641,0.0018713,30.59
2,64,2023,2087,0.0078986,0.0020779,29.65
2,65,2023,2088,0.0086645,0.0022700,28.71
2,66,2023,2089,0.0094558,0.0024404,27.77
2,67,2023,2090,0.0103010,0.0026085,26.84
2,68,2023,2091,0.0112531,0.0028093,25.91
2,69,2023,2092,0.0123584,0.0030631,24.98
2,70,2023,2093,0.0136702,0.0033969,24.06
2,71,2023,2094,0.0152518,0.0038643,23.14
2,72,2023,2095,0.0170987,0.0044680,22.22
2,73,2023,2096,0.0190837,0.0051191,21.32
2,74,2023,2097,0.0210750,0.0057348,20.43
2,75,2023,2098,0.0231062,0.0063293,19.54
2,76,2023,2099,0.0253497,0.0070209,18.66
2,77,2023,2100,0.0279666,0.0079275,17.79
2,78,2023,2101,0.0310443,0.0091266,16.93
2,79,2023,2102,0.0345982,0.0106394,16.08
2,80,2023,2103,0.0395295,0.0133832,15.25
2,81,2023,2104,0.0438328,0.0153238,14.45
2,82,2023,2105,0.0485928,0.0175166,13.67
2,83,2023,2106,0.0538556,0.0200042,12.90
2,84,2023,2107,0.0596709,0.0228371,12.16
2,85,2023,2108,0.0660929,0.0260948,11.43
2,86,2023,2109,0.0731799,0.0298357,10.72
2,87,2023,2110,0.0809950,0.0340934,10.03
2,88,2023,2111,0.0896059,0.0389295,9.37
2,89,2023,2112,0.0990850,0.0444320,8.73
2,90,2023,2113,0.1095094,0.0507343,8.11
2,91,2023,2114,0.1209607,0.0579344,7.52
2,92,2023,2115,0.1335249,0.0661291,6.95
2,93,2023,2116,0.1472918,0.0754826,6.41
2,94,2023,2117,0.1623547,0.0861991,5.89
2,95,2023,2118,0.1788093,0.0984699,5.40
2,96,2023,2119,0.1967531,0.1124421,4.94
2,97,2023,2120,0.2162837,0.1282944,4.50
2,98,2023,2121,0.2374976,0.1462997,4.09
2,99,2023,2122,0.2604884,0.1667746,3.70
2,100,2023,2123,0.2853445,0.1900050,3.34
2,101,2023,2124,0.3121468,0.2162071,3.01
2,102,2023,2125,0.3409660,0.2456260,2.70
2,103,2023,2126,0.3718598,0.2785967,2.41
2,104,2023,2127,0.4048696,0.3154602,2.15
2,105,2023,2128,0.4400178,0.3564695,1.91
2,106,2023,2129,0.4773042,0.4017557,1.70
2,107,2023,2130,0.5167037,0.4514257,1.50
2,108,2023,2131,0.5581634,0.5055846,1.32
2,109,2023,2132,0.6016004,0.5642235,1.16
2,110,2023,2133,0.6469012,0.6271527,1.02
2,111,2023,2134,0.6939204,0.6940315,0.89
2,112,2023,2135,0.7424819,0.7644333,0.78
2,113,2023,2136,0.7923800,0.8377939,0.68
2,114,2023,2137,0.8433824,0.9133617,0.59
2,115,2023,2138,1.0000000,1.0000000,0.50
2,0,2024,2024,0.0078000,0.0048589,92.08
2,1,2024,2025,0.0005341,0.0002413,91.52
2,2,2024,2026,0.0002805,0.0001241,90.55
2,3,2024,2027,0.0001960,0.0000865,89.56
2,4,2024,2028,0.0001520,0.0000656,88.57
2,5,2024,2029,0.0001465,0.0000647,87.57
2,6,2024,2030,0.0001399,0.0000624,86.58
2,7,2024,2031,0.0001348,0.0000608,85.58
2,8,2024,2032,0.0001336,0.0000616,84.59
2,9,2024,2033,0.0001377,0.0000655,83.59
2,10,2024,2034,0.0001465,0.0000722,82.60
2,11,2024,2035,0.0001596,0.0000814,81.60
2,12,2024,2036,0.0001783,0.0000941,80.61
2,13,2024,2037,0.0002061,0.0001128,79.62
2,14,2024,2038,0.0002415,0.0001366,78.63
2,15,2024,2039,0.0002756,0.0001579,77.64
2,16,2024,2040,0.0003003,0.0001692,76.65
2,17,2024,2041,0.0003175,0.0001715,75.66
2,18,2024,2042,0.0003342,0.0001729,74.68
2,19,2024,2043,0.0003539,0.0001779,73.69
2,20,2024,2044,0.0003732,0.0001836,72.70
2,21,2024,2045,0.0003859,0.0001832,71.71
2,22,2024,2046,0.0003897,0.0001754,70.73
2,23,2024,2047,0.0003908,0.0001659,69.74
2,24,2024,2048,0.0003983,0.0001625,68.75
2,25,2024,2049,0.0004147,0.0001659,67.76
2,26,2024,2050,0.0004348,0.0001712,66.77
2,27,2024,2051,0.0004528,0.0001738,65.79
2,28,2024,2052,0.0004684,0.0001763,64.80
2,29,2024,2053,0.0004856,0.0001795,63.81
2,30,2024,2054,0.0005091,0.0001850,62.82
2,31,2024,2055,0.0005408,0.0001925,61.83
2,32,2024,2056,0.0005796,0.0002012,60.84
2,33,2024,2057,0.0006220,0.0002095,59.85
2,34,2024,2058,0.0006665,0.0002173,58.87
2,35,2024,2059,0.0007153,0.0002249,57.88
2,36,2024,2060,0.0007710,0.0002369,56.89
2,37,2024,2061,0.0008314,0.0002489,55.91
2,38,2024,2062,0.0008908,0.0002629,54.92
2,39,2024,2063,0.0009481,0.0002798,53.93
2,40,2024,2064,0.0010090,0.0002995,52.95
2,41,2024,2065,0.0010784,0.0003202,51.96
2,42,2024,2066,0.0011559,0.0003418,50.98
2,43,2024,2067,0.0012427,0.0003696,50.00
2,44,2024,2068,0.0013435,0.0004101,49.02
2,45,2024,2069,0.0014588,0.0004563,48.04
2,46,2024,2070,0.0015840,0.0005049,47.06
2,47,2024,2071,0.0017152,0.0005472,46.08
2,48,2024,2072,0.0018531,0.0005880,45.11
2,49,2024,2073,0.0020059,0.0006320,44.13
2,50,2024,2074,0.0021845,0.0006764,43.16
2,51,2024,2075,0.0023896,0.0007191,42.19
2,52,2024,2076,0.0026115,0.0007603,41.22
2,53,2024,2077,0.0028474,0.0008081,40.25
2,54,2024,2078,0.0031082,0.0008765,39.28
2,55,2024,2079,0.0034035,0.0009571,38.32
2,56,2024,2080,0.0037277,0.0010391,37.35
2,57,2024,2081,0.0040692,0.0011070,36.39
2,58,2024,2082,0.0044295,0.0011704,35.43
2,59,2024,2083,0.0048296,0.0012482,34.47
2,60,2024,2084,0.0052973,0.0013535,33.51
2,61,2024,2085,0.0058480,0.0014874,32.56
2,62,2024,2086,0.0064757,0.0016480,31.61
2,63,2024,2087,0.0071641,0.0018375,30.66
2,64,2024,2088,0.0078986,0.0020436,29.71
2,65,2024,2089,0.0086645,0.0022319,28.77
2,66,2024,2090,0.0094558,0.0023957,27.84
2,67,2024,2091,0.0103010,0.0025597,26.90
2,68,2024,2092,0.0112531,0.0027598,25.97
2,69,2024,2093,0.0123584,0.0030133,25.04
2,70,2024,2094,0.0136702,0.0033408,24.12
2,71,2024,2095,0.0152518,0.0037965,23.19
2,72,2024,2096,0.0170987,0.0043906,22.28
2,73,2024,2097,0.0190837,0.0050381,21.38
2,74,2024,2098,0.0210750,0.0056524,20.48
2,75,2024,2099,0.0231062,0.0062373,19.60
2,76,2024,2100,0.0253497,0.0069119,18.72
2,77,2024,2101,0.0279666,0.0078052,17.84
2,78,2024,2102,0.0310443,0.0089993,16.98
2,79,2024,2103,0.0345982,0.0105089,16.13
2,80,2024,2104,0.0395295,0.0132312,15.29
2,81,2024,2105,0.0438328,0.0151421,14.49
2,82,2024,2106,0.0485928,0.0173123,13.71
2,83,2024,2107,0.0538556,0.0197929,12.94
2,84,2024,2108,0.0596709,0.0226215,12.19
2,85,2024,2109,0.0660929,0.0258511,11.46
2,86,2024,2110,0.0731799,0.0295448,10.75
2,87,2024,2111,0.0809950,0.0337683,10.07
2,88,2024,2112,0.0896059,0.0385958,9.40
2,89,2024,2113,0.0990850,0.0440958,8.76
2,90,2024,2114,0.1095094,0.0503604,8.14
2,91,2024,2115,0.1209607,0.0574935,7.54
2,92,2024,2116,0.1335249,0.0656415,6.97
2,93,2024,2117,0.1472918,0.0749878,6.43
2,94,2024,2118,0.1623547,0.0857052,5.91
2,95,2024,2119,0.1788093,0.0979255,5.42
2,96,2024,2120,0.1967531,0.1118105,4.95
2,97,2024,2121,0.2162837,0.1276115,4.51
2,98,2024,2122,0.2374976,0.1456246,4.10
2,99,2024,2123,0.2604884,0.1661217,3.71
2,100,2024,2124,0.2853445,0.1893119,3.35
2,101,2024,2125,0.3121468,0.2154363,3.01
2,102,2024,2126,0.3409660,0.2448323,2.70
2,103,2024,2127,0.3718598,0.2778572,2.42
2,104,2024,2128,0.4048696,0.3147971,2.16
2,105,2024,2129,0.4400178,0.3558289,1.92
2,106,2024,2130,0.4773042,0.4011191,1.70
2,107,2024,2131,0.5167037,0.4508581,1.50
2,108,2024,2132,0.5581634,0.5051512,1.32
2,109,2024,2133,0.6016004,0.5639364,1.16
2,110,2024,2134,0.6469012,0.6269964,1.02
2,111,2024,2135,0.6939204,0.6940325,0.89
2,112,2024,2136,0.7424819,0.7646267,0.78
2,113,2024,2137,0.7923800,0.8381686,0.68
2,114,2024,2138,0.8433824,0.9138926,0.59
2,115,2024,2139,1.0000000,1.0000000,0.50
2,0,2025,2025,0.0077999,0.0046495,92.19
2,1,2025,2026,0.0005341,0.0002251,91.62
2,2,2025,2027,0.0002805,0.0001167,90.64
2,3,2025,2028,0.0001960,0.0000820,89.65
2,4,2025,2029,0.0001520,0.0000622,88.65
2,5,2025,2030,0.0001465,0.0000614,87.66
2,6,2025,2031,0.0001399,0.0000594,86.66
2,7,2025,2032,0.0001348,0.0000582,85.67
2,8,2025,2033,0.0001336,0.0000593,84.67
2,9,2025,2034,0.0001377,0.0000632,83.68
2,10,2025,2035,0.0001465,0.0000698,82.68
2,11,2025,2036,0.0001596,0.0000789,81.69
2,12,2025,2037,0.0001783,0.0000915,80.70
2,13,2025,2038,0.0002061,0.0001102,79.70
2,14,2025,2039,0.0002415,0.0001337,78.71
2,15,2025,2040,0.0002756,0.0001545,77.72
2,16,2025,2041,0.0003003,0.0001655,76.74
2,17,2025,2042,0.0003175,0.0001678,75.75
2,18,2025,2043,0.0003342,0.0001694,74.76
2,19,2025,2044,0.0003539,0.0001742,73.77
2,20,2025,2045,0.0003732,0.0001794,72.79
2,21,2025,2046,0.0003859,0.0001789,71.80
2,22,2025,2047,0.0003897,0.0001713,70.81
2,23,2025,2048,0.0003908,0.0001621,69.82
2,24,2025,2049,0.0003983,0.0001587,68.84
2,25,2025,2050,0.0004147,0.0001616,67.85
2,26,2025,2051,0.0004348,0.0001667,66.86
2,27,2025,2052,0.0004528,0.0001695,65.87
2,28,2025,2053,0.0004684,0.0001723,64.88
2,29,2025,2054,0.0004856,0.0001753,63.89
2,30,2025,2055,0.0005091,0.0001802,62.90
2,31,2025,2056,0.0005408,0.0001874,61.91
2,32,2025,2057,0.0005796,0.0001962,60.92
2,33,2025,2058,0.0006220,0.0002047,59.94
2,34,2025,2059,0.0006665,0.0002122,58.95
2,35,2025,2060,0.0007153,0.0002191,57.96
2,36,2025,2061,0.0007710,0.0002306,56.97
2,37,2025,2062,0.0008314,0.0002427,55.99
2,38,2025,2063,0.0008908,0.0002568,55.00
2,39,2025,2064,0.0009481,0.0002733,54.01
2,40,2025,2065,0.0010090,0.0002921,53.03
2,41,2025,2066,0.0010784,0.0003122,52.04
2,42,2025,2067,0.0011559,0.0003340,51.06
2,43,2025,2068,0.0012427,0.0003620,50.08
2,44,2025,2069,0.0013435,0.0004017,49.09
2,45,2025,2070,0.0014588,0.0004465,48.11
2,46,2025,2071,0.0015840,0.0004942,47.14
2,47,2025,2072,0.0017152,0.0005365,46.16
2,48,2025,2073,0.0018531,0.0005775,45.18
2,49,2025,2074,0.0020059,0.0006205,44.21
2,50,2025,2075,0.0021845,0.0006631,43.24
2,51,2025,2076,0.0023896,0.0007044,42.26
2,52,2025,2077,0.0026115,0.0007456,41.29
2,53,2025,2078,0.0028474,0.0007935,40.32
2,54,2025,2079,0.0031082,0.0008605,39.36
2,55,2025,2080,0.0034035,0.0009383,38.39
2,56,2025,2081,0.0037277,0.0010184,37.42
2,57,2025,2082,0.0040692,0.0010861,36.46
2,58,2025,2083,0.0044295,0.0011497,35.50
2,59,2025,2084,0.0048296,0.0012256,34.54
2,60,2025,2085,0.0052973,0.0013269,33.58
2,61,2025,2086,0.0058480,0.0014579,32.63
2,62,2025,2087,0.0064757,0.0016176,31.67
2,63,2025,2088,0.0071641,0.0018066,30.72
2,64,2025,2089,0.0078986,0.0020090,29.78
2,65,2025,2090,0.0086645,0.0021910,28.84
2,66,2025,2091,0.0094558,0.0023509,27.90
2,67,2025,2092,0.0103010,0.0025144,26.97
2,68,2025,2093,0.0112531,0.0027146,26.03
2,69,2025,2094,0.0123584,0.0029629,25.10
2,70,2025,2095,0.0136702,0.0032807,24.17
2,71,2025,2096,0.0152518,0.0037284,23.25
2,72,2025,2097,0.0170987,0.0043189,22.34
2,73,2025,2098,0.0190837,0.0049641,21.43
2,74,2025,2099,0.0210750,0.0055690,20.54
2,75,2025,2100,0.0231062,0.0061386,19.65
2,76,2025,2101,0.0253497,0.0068021,18.77
2,77,2025,2102,0.0279666,0.0076918,17.89
2,78,2025,2103,0.0310443,0.0088835,17.03
2,79,2025,2104,0.0345982,0.0103777,16.18
2,80,2025,2105,0.0395295,0.0130680,15.34
2,81,2025,2106,0.0438328,0.0149583,14.54
2,82,2025,2107,0.0485928,0.0171219,13.75
2,83,2025,2108,0.0538556,0.0195983,12.98
2,84,2025,2109,0.0596709,0.0224012,12.23
2,85,2025,2110,0.0660929,0.0255875,11.50
2,86,2025,2111,0.0731799,0.0292497,10.79
2,87,2025,2112,0.0809950,0.0334649,10.10
2,88,2025,2113,0.0896059,0.0382895,9.43
2,89,2025,2114,0.0990850,0.0437543,8.78
2,90,2025,2115,0.1095094,0.0499565,8.16
2,91,2025,2116,0.1209607,0.0570454,7.57
2,92,2025,2117,0.1335249,0.0651851,6.99
2,93,2025,2118,0.1472918,0.0745303,6.45
2,94,2025,2119,0.1623547,0.0851984,5.93
2,95,2025,2120,0.1788093,0.0973344,5.43
2,96,2025,2121,0.1967531,0.1111674,4.96
2,97,2025,2122,0.2162837,0.1269711,4.52
2,98,2025,2123,0.2374976,0.1450000,4.11
2,99,2025,2124,0.2604884,0.1654520,3.72
2,100,2025,2125,0.2853445,0.1885585,3.36
2,101,2025,2126,0.3121468,0.2146497,3.02
2,102,2025,2127,0.3409660,0.2440869,2.71
2,103,2025,2128,0.3718598,0.2771748,2.42
2,104,2025,2129,0.4048696,0.3141204,2.16
2,105,2025,2130,0.4400178,0.3551328,1.92
2,106,2025,2131,0.4773042,0.4004680,1.70
2,107,2025,2132,0.5167037,0.4503237,1.50
2,108,2025,2133,0.5581634,0.5047494,1.32
2,109,2025,2134,0.6016004,0.5636416,1.16
2,110,2025,2135,0.6469012,0.6268260,1.02
2,111,2025,2136,0.6939204,0.6940335,0.89
2,112,2025,2137,0.7424819,0.7648089,0.78
2,113,2025,2138,0.7923800,0.8385162,0.68
2,114,2025,2139,0.8433824,0.9144378,0.59
2,115,2025,2140,1.0000000,1.0000000,0.50
2,0,2026,2026,0.0077999,0.0044443,92.29
2,1,2026,2027,0.0005341,0.0002109,91.70
2,2,2026,2028,0.0002805,0.0001103,90.72
2,3,2026,2029,0.0001960,0.0000776,89.73
2,4,2026,2030,0.0001520,0.0000588,88.74
2,5,2026,2031,0.0001465,0.0000582,87.75
2,6,2026,2032,0.0001399,0.0000567,86.75
2,7,2026,2033,0.0001348,0.0000559,85.76
2,8,2026,2034,0.0001336,0.0000571,84.76
2,9,2026,2035,0.0001377,0.0000609,83.77
2,10,2026,2036,0.0001465,0.0000674,82.77
2,11,2026,2037,0.0001596,0.0000765,81.78
2,12,2026,2038,0.0001783,0.0000893,80.78
2,13,2026,2039,0.0002061,0.0001077,79.79
2,14,2026,2040,0.0002415,0.0001307,78.80
2,15,2026,2041,0.0002756,0.0001511,77.81
2,16,2026,2042,0.0003003,0.0001620,76.82
2,17,2026,2043,0.0003175,0.0001645,75.83
2,18,2026,2044,0.0003342,0.0001658,74.84
2,19,2026,2045,0.0003539,0.0001702,73.86
2,20,2026,2046,0.0003732,0.0001751,72.87
2,21,2026,2047,0.0003859,0.0001749,71.88
2,22,2026,2048,0.0003897,0.0001676,70.89
2,23,2026,2049,0.0003908,0.0001583,69.91
2,24,2026,2050,0.0003983,0.0001545,68.92
2,25,2026,2051,0.0004147,0.0001573,67.93
2,26,2026,2052,0.0004348,0.0001626,66.94
2,27,2026,2053,0.0004528,0.0001656,65.95
2,28,2026,2054,0.0004684,0.0001682,64.96
2,29,2026,2055,0.0004856,0.0001708,63.97
2,30,2026,2056,0.0005091,0.0001755,62.98
2,31,2026,2057,0.0005408,0.0001828,61.99
2,32,2026,2058,0.0005796,0.0001918,61.00
2,33,2026,2059,0.0006220,0.0001999,60.02
2,34,2026,2060,0.0006665,0.0002067,59.03
2,35,2026,2061,0.0007153,0.0002133,58.04
2,36,2026,2062,0.0007710,0.0002249,57.05
2,37,2026,2063,0.0008314,0.0002371,56.07
2,38,2026,2064,0.0008908,0.0002507,55.08
2,39,2026,2065,0.0009481,0.0002664,54.09
2,40,2026,2066,0.0010090,0.0002847,53.11
2,41,2026,2067,0.0010784,0.0003049,52.12
2,42,2026,2068,0.0011559,0.0003269,51.14
2,43,2026,2069,0.0012427,0.0003543,50.15
2,44,2026,2070,0.0013435,0.0003928,49.17
2,45,2026,2071,0.0014588,0.0004368,48.19
2,46,2026,2072,0.0015840,0.0004844,47.21
2,47,2026,2073,0.0017152,0.0005268,46.23
2,48,2026,2074,0.0018531,0.0005669,45.26
2,49,2026,2075,0.0020059,0.0006083,44.28
2,50,2026,2076,0.0021845,0.0006497,43.31
2,51,2026,2077,0.0023896,0.0006909,42.34
2,52,2026,2078,0.0026115,0.0007322,41.37
2,53,2026,2079,0.0028474,0.0007788,40.40
2,54,2026,2080,0.0031082,0.0008434,39.43
2,55,2026,2081,0.0034035,0.0009194,38.46
2,56,2026,2082,0.0037277,0.0009992,37.50
2,57,2026,2083,0.0040692,0.0010671,36.53
2,58,2026,2084,0.0044295,0.0011290,35.57
2,59,2026,2085,0.0048296,0.0012014,34.61
2,60,2026,2086,0.0052973,0.0013003,33.65
2,61,2026,2087,0.0058480,0.0014305,32.69
2,62,2026,2088,0.0064757,0.0015899,31.74
2,63,2026,2089,0.0071641,0.0017753,30.79
2,64,2026,2090,0.0078986,0.0019718,29.84
2,65,2026,2091,0.0086645,0.0021499,28.90
2,66,2026,2092,0.0094558,0.0023093,27.96
2,67,2026,2093,0.0103010,0.0024732,27.03
2,68,2026,2094,0.0112531,0.0026689,26.09
2,69,2026,2095,0.0123584,0.0029089,25.16
2,70,2026,2096,0.0136702,0.0032203,24.23
2,71,2026,2097,0.0152518,0.0036653,23.31
2,72,2026,2098,0.0170987,0.0042533,22.39
2,73,2026,2099,0.0190837,0.0048891,21.49
2,74,2026,2100,0.0210750,0.0054795,20.59
2,75,2026,2101,0.0231062,0.0060391,19.70
2,76,2026,2102,0.0253497,0.0067003,18.82
2,77,2026,2103,0.0279666,0.0075886,17.94
2,78,2026,2104,0.0310443,0.0087671,17.07
2,79,2026,2105,0.0345982,0.0102370,16.22
2,80,2026,2106,0.0395295,0.0129029,15.38
2,81,2026,2107,0.0438328,0.0147870,14.58
2,82,2026,2108,0.0485928,0.0169466,13.79
2,83,2026,2109,0.0538556,0.0193996,13.02
2,84,2026,2110,0.0596709,0.0221631,12.27
2,85,2026,2111,0.0660929,0.0253205,11.53
2,86,2026,2112,0.0731799,0.0289745,10.82
2,87,2026,2113,0.0809950,0.0331864,10.13
2,88,2026,2114,0.0896059,0.0379784,9.46
2,89,2026,2115,0.0990850,0.0433854,8.81
2,90,2026,2116,0.1095094,0.0495462,8.19
2,91,2026,2117,0.1209607,0.0566261,7.59
2,92,2026,2118,0.1335249,0.0647632,7.02
2,93,2026,2119,0.1472918,0.0740611,6.47
2,94,2026,2120,0.1623547,0.0846485,5.94
2,95,2026,2121,0.1788093,0.0967328,5.45
2,96,2026,2122,0.1967531,0.1105645,4.98
2,97,2026,2123,0.2162837,0.1263788,4.53
2,98,2026,2124,0.2374976,0.1443596,4.12
2,99,2026,2125,0.2604884,0.1647244,3.73
2,100,2026,2126,0.2853445,0.1877898,3.36
2,101,2026,2127,0.3121468,0.2139112,3.03
2,102,2026,2128,0.3409660,0.2433994,2.71
2,103,2026,2129,0.3718598,0.2764787,2.43
2,104,2026,2130,0.4048696,0.3133853,2.16
2,105,2026,2131,0.4400178,0.3544212,1.92
2,106,2026,2132,0.4773042,0.3998553,1.70
2,107,2026,2133,0.5167037,0.4498284,1.50
2,108,2026,2134,0.5581634,0.5043370,1.32
2,109,2026,2135,0.6016004,0.5633205,1.16
2,110,2026,2136,0.6469012,0.6266517,1.02
2,111,2026,2137,0.6939204,0.6940345,0.89
2,112,2026,2138,0.7424819,0.7649779,0.78
2,113,2026,2139,0.7923800,0.8388731,0.67
2,114,2026,2140,0.8433824,0.9150321,0.58
2,115,2026,2141,1.0000000,1.0000000,0.50
2,0,2027,2027,0.0077999,0.0042594,92.40
2,1,2027,2028,0.0005341,0.0001986,91.79
2,2,2027,2029,0.0002805,0.0001040,90.81
2,3,2027,2030,0.0001960,0.0000732,89.82
2,4,2027,2031,0.0001520,0.0000554,88.83
2,5,2027,2032,0.0001465,0.0000553,87.83
2,6,2027,2033,0.0001399,0.0000543,86.84
2,7,2027,2034,0.0001348,0.0000536,85.84
2,8,2027,2035,0.0001336,0.0000548,84.85
2,9,2027,2036,0.0001377,0.0000586,83.85
2,10,2027,2037,0.0001465,0.0000652,82.86
2,11,2027,2038,0.0001596,0.0000744,81.86
2,12,2027,2039,0.0001783,0.0000870,80.87
2,13,2027,2040,0.0002061,0.0001050,79.87
2,14,2027,2041,0.0002415,0.0001276,78.88
2,15,2027,2042,0.0002756,0.0001479,77.89
2,16,2027,2043,0.0003003,0.0001589,76.90
2,17,2027,2044,0.0003175,0.0001612,75.92
2,18,2027,2045,0.0003342,0.0001621,74.93
2,19,2027,2046,0.0003539,0.0001662,73.94
2,20,2027,2047,0.0003732,0.0001713,72.95
2,21,2027,2048,0.0003859,0.0001712,71.97
2,22,2027,2049,0.0003897,0.0001638,70.98
2,23,2027,2050,0.0003908,0.0001543,69.99
2,24,2027,2051,0.0003983,0.0001504,69.00
2,25,2027,2052,0.0004147,0.0001534,68.01
2,26,2027,2053,0.0004348,0.0001589,67.02
2,27,2027,2054,0.0004528,0.0001617,66.03
2,28,2027,2055,0.0004684,0.0001639,65.04
2,29,2027,2056,0.0004856,0.0001663,64.05
2,30,2027,2057,0.0005091,0.0001712,63.06
2,31,2027,2058,0.0005408,0.0001787,62.07
2,32,2027,2059,0.0005796,0.0001873,61.08
2,33,2027,2060,0.0006220,0.0001948,60.10
2,34,2027,2061,0.0006665,0.0002013,59.11
2,35,2027,2062,0.0007153,0.0002080,58.12
2,36,2027,2063,0.0007710,0.0002197,57.13
2,37,2027,2064,0.0008314,0.0002315,56.14
2,38,2027,2065,0.0008908,0.0002443,55.16
2,39,2027,2066,0.0009481,0.0002595,54.17
2,40,2027,2067,0.0010090,0.0002779,53.18
2,41,2027,2068,0.0010784,0.0002984,52.20
2,42,2027,2069,0.0011559,0.0003198,51.21
2,43,2027,2070,0.0012427,0.0003461,50.23
2,44,2027,2071,0.0013435,0.0003838,49.25
2,45,2027,2072,0.0014588,0.0004278,48.27
2,46,2027,2073,0.0015840,0.0004754,47.29
2,47,2027,2074,0.0017152,0.0005170,46.31
2,48,2027,2075,0.0018531,0.0005556,45.33
2,49,2027,2076,0.0020059,0.0005960,44.36
2,50,2027,2077,0.0021845,0.0006373,43.38
2,51,2027,2078,0.0023896,0.0006787,42.41
2,52,2027,2079,0.0026115,0.0007187,41.44
2,53,2027,2080,0.0028474,0.0007632,40.47
2,54,2027,2081,0.0031082,0.0008262,39.50
2,55,2027,2082,0.0034035,0.0009020,38.53
2,56,2027,2083,0.0037277,0.0009818,37.57
2,57,2027,2084,0.0040692,0.0010480,36.60
2,58,2027,2085,0.0044295,0.0011068,35.64
2,59,2027,2086,0.0048296,0.0011772,34.68
2,60,2027,2087,0.0052973,0.0012757,33.72
2,61,2027,2088,0.0058480,0.0014057,32.76
2,62,2027,2089,0.0064757,0.0015619,31.81
2,63,2027,2090,0.0071641,0.0017419,30.86
2,64,2027,2091,0.0078986,0.0019345,29.91
2,65,2027,2092,0.0086645,0.0021119,28.97
2,66,2027,2093,0.0094558,0.0022714,28.03
2,67,2027,2094,0.0103010,0.0024314,27.09
2,68,2027,2095,0.0112531,0.0026199,26.15
2,69,2027,2096,0.0123584,0.0028547,25.22
2,70,2027,2097,0.0136702,0.0031644,24.29
2,71,2027,2098,0.0152518,0.0036077,23.37
2,72,2027,2099,0.0170987,0.0041870,22.45
2,73,2027,2100,0.0190837,0.0048087,21.54
2,74,2027,2101,0.0210750,0.0053893,20.64
2,75,2027,2102,0.0231062,0.0059470,19.75
2,76,2027,2103,0.0253497,0.0066077,18.87
2,77,2027,2104,0.0279666,0.0074851,17.99
2,78,2027,2105,0.0310443,0.0086424,17.12
2,79,2027,2106,0.0345982,0.0100949,16.27
2,80,2027,2107,0.0395295,0.0127492,15.43
2,81,2027,2108,0.0438328,0.0146295,14.62
2,82,2027,2109,0.0485928,0.0167677,13.83
2,83,2027,2110,0.0538556,0.0191849,13.06
2,84,2027,2111,0.0596709,0.0219219,12.30
2,85,2027,2112,0.0660929,0.0250715,11.57
2,86,2027,2113,0.0731799,0.0287221,10.85
2,87,2027,2114,0.0809950,0.0329038,10.16
2,88,2027,2115,0.0896059,0.0376426,9.49
2,89,2027,2116,0.0990850,0.0430109,8.84
2,90,2027,2117,0.1095094,0.0491624,8.21
2,91,2027,2118,0.1209607,0.0562387,7.61
2,92,2027,2119,0.1335249,0.0643307,7.04
2,93,2027,2120,0.1472918,0.0735521,6.49
2,94,2027,2121,0.1623547,0.0840890,5.96
2,95,2027,2122,0.1788093,0.0961690,5.46
2,96,2027,2123,0.1967531,0.1100071,4.99
2,97,2027,2124,0.2162837,0.1257717,4.55
2,98,2027,2125,0.2374976,0.1436640,4.13
2,99,2027,2126,0.2604884,0.1639823,3.74
2,100,2027,2127,0.2853445,0.1870686,3.37
2,101,2027,2128,0.3121468,0.2132303,3.03
2,102,2027,2129,0.3409660,0.2426983,2.72
2,103,2027,2130,0.3718598,0.2757229,2.43
2,104,2027,2131,0.4048696,0.3126342,2.17
2,105,2027,2132,0.4400178,0.3537518,1.92
2,106,2027,2133,0.4773042,0.3992876,1.70
2,107,2027,2134,0.5167037,0.4493203,1.51
2,108,2027,2135,0.5581634,0.5038878,1.33
2,109,2027,2136,0.6016004,0.5629917,1.16
2,110,2027,2137,0.6469012,0.6264874,1.02
2,111,2027,2138,0.6939204,0.6940353,0.89
2,112,2027,2139,0.7424819,0.7651516,0.78
2,113,2027,2140,0.7923800,0.8392622,0.67
2,114,2027,2141,0.8433824,0.9156406,0.58
2,115,2027,2142,1.0000000,1.0000000,0.50
2,0,2028,2028,0.0077999,0.0040949,92.50
2,1,2028,2029,0.0005341,0.0001866,91.88
2,2,2028,2030,0.0002805,0.0000976,90.90
2,3,2028,2031,0.0001960,0.0000688,89.91
2,4,2028,2032,0.0001520,0.0000524,88.91
2,5,2028,2033,0.0001465,0.0000528,87.92
2,6,2028,2034,0.0001399,0.0000519,86.92
2,7,2028,2035,0.0001348,0.0000513,85.93
2,8,2028,2036,0.0001336,0.0000525,84.93
2,9,2028,2037,0.0001377,0.0000565,83.94
2,10,2028,2038,0.0001465,0.0000632,82.94
2,11,2028,2039,0.0001596,0.0000723,81.95
2,12,2028,2040,0.0001783,0.0000846,80.95
2,13,2028,2041,0.0002061,0.0001023,79.96
2,14,2028,2042,0.0002415,0.0001248,78.97
2,15,2028,2043,0.0002756,0.0001451,77.98
2,16,2028,2044,0.0003003,0.0001558,76.99
2,17,2028,2045,0.0003175,0.0001577,76.00
2,18,2028,2046,0.0003342,0.0001583,75.01
2,19,2028,2047,0.0003539,0.0001626,74.02
2,20,2028,2048,0.0003732,0.0001677,73.04
2,21,2028,2049,0.0003859,0.0001675,72.05
2,22,2028,2050,0.0003897,0.0001598,71.06
2,23,2028,2051,0.0003908,0.0001503,70.07
2,24,2028,2052,0.0003983,0.0001467,69.08
2,25,2028,2053,0.0004147,0.0001498,68.09
2,26,2028,2054,0.0004348,0.0001551,67.10
2,27,2028,2055,0.0004528,0.0001574,66.11
2,28,2028,2056,0.0004684,0.0001595,65.12
2,29,2028,2057,0.0004856,0.0001621,64.13
2,30,2028,2058,0.0005091,0.0001673,63.14
2,31,2028,2059,0.0005408,0.0001745,62.15
2,32,2028,2060,0.0005796,0.0001826,61.16
2,33,2028,2061,0.0006220,0.0001898,60.17
2,34,2028,2062,0.0006665,0.0001963,59.19
2,35,2028,2063,0.0007153,0.0002031,58.20
2,36,2028,2064,0.0007710,0.0002144,57.21
2,37,2028,2065,0.0008314,0.0002254,56.22
2,38,2028,2066,0.0008908,0.0002378,55.23
2,39,2028,2067,0.0009481,0.0002532,54.25
2,40,2028,2068,0.0010090,0.0002718,53.26
2,41,2028,2069,0.0010784,0.0002918,52.28
2,42,2028,2070,0.0011559,0.0003123,51.29
2,43,2028,2071,0.0012427,0.0003380,50.31
2,44,2028,2072,0.0013435,0.0003756,49.32
2,45,2028,2073,0.0014588,0.0004196,48.34
2,46,2028,2074,0.0015840,0.0004664,47.36
2,47,2028,2075,0.0017152,0.0005066,46.38
2,48,2028,2076,0.0018531,0.0005443,45.41
2,49,2028,2077,0.0020059,0.0005846,44.43
2,50,2028,2078,0.0021845,0.0006261,43.46
2,51,2028,2079,0.0023896,0.0006663,42.48
2,52,2028,2080,0.0026115,0.0007044,41.51
2,53,2028,2081,0.0028474,0.0007475,40.54
2,54,2028,2082,0.0031082,0.0008103,39.57
2,55,2028,2083,0.0034035,0.0008861,38.60
2,56,2028,2084,0.0037277,0.0009643,37.64
2,57,2028,2085,0.0040692,0.0010275,36.67
2,58,2028,2086,0.0044295,0.0010845,35.71
2,59,2028,2087,0.0048296,0.0011548,34.75
2,60,2028,2088,0.0052973,0.0012532,33.79
2,61,2028,2089,0.0058480,0.0013805,32.83
2,62,2028,2090,0.0064757,0.0015319,31.87
2,63,2028,2091,0.0071641,0.0017083,30.92
2,64,2028,2092,0.0078986,0.0019000,29.97
2,65,2028,2093,0.0086645,0.0020772,29.03
2,66,2028,2094,0.0094558,0.0022331,28.09
2,67,2028,2095,0.0103010,0.0023866,27.15
2,68,2028,2096,0.0112531,0.0025707,26.21
2,69,2028,2097,0.0123584,0.0028045,25.28
2,70,2028,2098,0.0136702,0.0031134,24.35
2,71,2028,2099,0.0152518,0.0035495,23.42
2,72,2028,2100,0.0170987,0.0041159,22.51
2,73,2028,2101,0.0190837,0.0047278,21.60
2,74,2028,2102,0.0210750,0.0053057,20.70
2,75,2028,2103,0.0231062,0.0058632,19.81
2,76,2028,2104,0.0253497,0.0065148,18.92
2,77,2028,2105,0.0279666,0.0073742,18.04
2,78,2028,2106,0.0310443,0.0085166,17.17
2,79,2028,2107,0.0345982,0.0099628,16.31
2,80,2028,2108,0.0395295,0.0126078,15.47
2,81,2028,2109,0.0438328,0.0144687,14.66
2,82,2028,2110,0.0485928,0.0165745,13.87
2,83,2028,2111,0.0538556,0.0189675,13.10
2,84,2028,2112,0.0596709,0.0216971,12.34
2,85,2028,2113,0.0660929,0.0248432,11.60
2,86,2028,2114,0.0731799,0.0284660,10.89
2,87,2028,2115,0.0809950,0.0325988,10.19
2,88,2028,2116,0.0896059,0.0373017,9.52
2,89,2028,2117,0.0990850,0.0426608,8.87
2,90,2028,2118,0.1095094,0.0488079,8.24
2,91,2028,2119,0.1209607,0.0558417,7.64
2,92,2028,2120,0.1335249,0.0638618,7.06
2,93,2028,2121,0.1472918,0.0730344,6.51
2,94,2028,2122,0.1623547,0.0835649,5.98
2,95,2028,2123,0.1788093,0.0956480,5.48
2,96,2028,2124,0.1967531,0.1094361,5.01
2,97,2028,2125,0.2162837,0.1251127,4.56
2,98,2028,2126,0.2374976,0.1429550,4.14
2,99,2028,2127,0.2604884,0.1632864,3.75
2,100,2028,2128,0.2853445,0.1864038,3.38
2,101,2028,2129,0.3121468,0.2125362,3.04
2,102,2028,2130,0.3409660,0.2419374,2.73
2,103,2028,2131,0.3718598,0.2749508,2.44
2,104,2028,2132,0.4048696,0.3119278,2.17
2,105,2028,2133,0.4400178,0.3531317,1.93
2,106,2028,2134,0.4773042,0.3987054,1.71
2,107,2028,2135,0.5167037,0.4487669,1.51
2,108,2028,2136,0.5581634,0.5034282,1.33
2,109,2028,2137,0.6016004,0.5626821,1.16
2,110,2028,2138,0.6469012,0.6263351,1.02
2,111,2028,2139,0.6939204,0.6940362,0.89
2,112,2028,2140,0.7424819,0.7653407,0.78
2,113,2028,2141,0.7923800,0.8396607,0.67
2,114,2028,2142,0.8433824,0.9162137,0.58
2,115,2028,2143,1.0000000,1.0000000,0.50
2,0,2029,2029,0.0077999,0.0039328,92.60
2,1,2029,2030,0.0005341,0.0001745,91.97
2,2,2029,2031,0.0002805,0.0000914,90.98
2,3,2029,2032,0.0001960,0.0000650,89.99
2,4,2029,2033,0.0001520,0.0000498,89.00
2,5,2029,2034,0.0001465,0.0000503,88.00
2,6,2029,2035,0.0001399,0.0000495,87.01
2,7,2029,2036,0.0001348,0.0000490,86.01
2,8,2029,2037,0.0001336,0.0000505,85.02
2,9,2029,2038,0.0001377,0.0000546,84.02
2,10,2029,2039,0.0001465,0.0000612,83.02
2,11,2029,2040,0.0001596,0.0000701,82.03
2,12,2029,2041,0.0001783,0.0000822,81.04
2,13,2029,2042,0.0002061,0.0000998,80.04
2,14,2029,2043,0.0002415,0.0001222,79.05
2,15,2029,2044,0.0002756,0.0001422,78.06
2,16,2029,2045,0.0003003,0.0001525,77.07
2,17,2029,2046,0.0003175,0.0001541,76.08
2,18,2029,2047,0.0003342,0.0001549,75.09
2,19,2029,2048,0.0003539,0.0001592,74.11
2,20,2029,2049,0.0003732,0.0001642,73.12
2,21,2029,2050,0.0003859,0.0001636,72.13
2,22,2029,2051,0.0003897,0.0001558,71.14
2,23,2029,2052,0.0003908,0.0001466,70.15
2,24,2029,2053,0.0003983,0.0001432,69.16
2,25,2029,2054,0.0004147,0.0001462,68.17
2,26,2029,2055,0.0004348,0.0001510,67.18
2,27,2029,2056,0.0004528,0.0001533,66.19
2,28,2029,2057,0.0004684,0.0001555,65.20
2,29,2029,2058,0.0004856,0.0001584,64.21
2,30,2029,2059,0.0005091,0.0001634,63.22
2,31,2029,2060,0.0005408,0.0001701,62.23
2,32,2029,2061,0.0005796,0.0001778,61.24
2,33,2029,2062,0.0006220,0.0001851,60.25
2,34,2029,2063,0.0006665,0.0001918,59.26
2,35,2029,2064,0.0007153,0.0001983,58.28
2,36,2029,2065,0.0007710,0.0002089,57.29
2,37,2029,2066,0.0008314,0.0002195,56.30
2,38,2029,2067,0.0008908,0.0002319,55.31
2,39,2029,2068,0.0009481,0.0002475,54.32
2,40,2029,2069,0.0010090,0.0002656,53.34
2,41,2029,2070,0.0010784,0.0002848,52.35
2,42,2029,2071,0.0011559,0.0003047,51.37
2,43,2029,2072,0.0012427,0.0003304,50.38
2,44,2029,2073,0.0013435,0.0003682,49.40
2,45,2029,2074,0.0014588,0.0004114,48.42
2,46,2029,2075,0.0015840,0.0004568,47.44
2,47,2029,2076,0.0017152,0.0004961,46.46
2,48,2029,2077,0.0018531,0.0005338,45.48
2,49,2029,2078,0.0020059,0.0005743,44.50
2,50,2029,2079,0.0021845,0.0006148,43.53
2,51,2029,2080,0.0023896,0.0006531,42.56
2,52,2029,2081,0.0026115,0.0006900,41.58
2,53,2029,2082,0.0028474,0.0007330,40.61
2,54,2029,2083,0.0031082,0.0007959,39.64
2,55,2029,2084,0.0034035,0.0008701,38.67
2,56,2029,2085,0.0037277,0.0009455,37.71
2,57,2029,2086,0.0040692,0.0010070,36.74
2,58,2029,2087,0.0044295,0.0010639,35.78
2,59,2029,2088,0.0048296,0.0011344,34.81
2,60,2029,2089,0.0052973,0.0012306,33.85
2,61,2029,2090,0.0058480,0.0013537,32.90
2,62,2029,2091,0.0064757,0.0015018,31.94
2,63,2029,2092,0.0071641,0.0016773,30.99
2,64,2029,2093,0.0078986,0.0018685,30.04
2,65,2029,2094,0.0086645,0.0020421,29.09
2,66,2029,2095,0.0094558,0.0021920,28.15
2,67,2029,2096,0.0103010,0.0023416,27.21
2,68,2029,2097,0.0112531,0.0025251,26.27
2,69,2029,2098,0.0123584,0.0027587,25.34
2,70,2029,2099,0.0136702,0.0030618,24.41
2,71,2029,2100,0.0152518,0.0034870,23.48
2,72,2029,2101,0.0170987,0.0040444,22.56
2,73,2029,2102,0.0190837,0.0046528,21.65
2,74,2029,2103,0.0210750,0.0052298,20.75
2,75,2029,2104,0.0231062,0.0057792,19.86
2,76,2029,2105,0.0253497,0.0064154,18.97
2,77,2029,2106,0.0279666,0.0072623,18.09
2,78,2029,2107,0.0310443,0.0083996,17.22
2,79,2029,2108,0.0345982,0.0098414,16.36
2,80,2029,2109,0.0395295,0.0124636,15.52
2,81,2029,2110,0.0438328,0.0142952,14.71
2,82,2029,2111,0.0485928,0.0163789,13.91
2,83,2029,2112,0.0538556,0.0187650,13.14
2,84,2029,2113,0.0596709,0.0214911,12.38
2,85,2029,2114,0.0660929,0.0246117,11.64
2,86,2029,2115,0.0731799,0.0281897,10.92
2,87,2029,2116,0.0809950,0.0322894,10.22
2,88,2029,2117,0.0896059,0.0369832,9.55
2,89,2029,2118,0.0990850,0.0423376,8.89
2,90,2029,2119,0.1095094,0.0484448,8.26
2,91,2029,2120,0.1209607,0.0554114,7.66
2,92,2029,2121,0.1335249,0.0633850,7.08
2,93,2029,2122,0.1472918,0.0725498,6.53
2,94,2029,2123,0.1623547,0.0830808,6.00
2,95,2029,2124,0.1788093,0.0951146,5.49
2,96,2029,2125,0.1967531,0.1088165,5.02
2,97,2029,2126,0.2162837,0.1244413,4.57
2,98,2029,2127,0.2374976,0.1422903,4.15
2,99,2029,2128,0.2604884,0.1626452,3.76
2,100,2029,2129,0.2853445,0.1857265,3.39
2,101,2029,2130,0.3121468,0.2117832,3.05
2,102,2029,2131,0.3409660,0.2411604,2.73
2,103,2029,2132,0.3718598,0.2742250,2.44
2,104,2029,2133,0.4048696,0.3112738,2.17
2,105,2029,2134,0.4400178,0.3524959,1.93
2,106,2029,2135,0.4773042,0.3980714,1.71
2,107,2029,2136,0.5167037,0.4482007,1.51
2,108,2029,2137,0.5581634,0.5029953,1.33
2,109,2029,2138,0.6016004,0.5623950,1.17
2,110,2029,2139,0.6469012,0.6261787,1.02
2,111,2029,2140,0.6939204,0.6940371,0.89
2,112,2029,2141,0.7424819,0.7655345,0.78
2,113,2029,2142,0.7923800,0.8400359,0.67
2,114,2029,2143,0.8433824,0.9167433,0.58
2,115,2029,2144,1.0000000,1.0000000,0.50
2,0,2030,2030,0.0077998,0.0037635,92.70
2,1,2030,2031,0.0005341,0.0001628,92.05
2,2,2030,2032,0.0002805,0.0000860,91.07
2,3,2030,2033,0.0001960,0.0000617,90.08
2,4,2030,2034,0.0001520,0.0000473,89.08
2,5,2030,2035,0.0001465,0.0000478,88.09
2,6,2030,2036,0.0001399,0.0000471,87.09
2,7,2030,2037,0.0001348,0.0000469,86.09
2,8,2030,2038,0.0001336,0.0000487,85.10
2,9,2030,2039,0.0001377,0.0000527,84.10
2,10,2030,2040,0.0001465,0.0000592,83.11
2,11,2030,2041,0.0001596,0.0000679,82.11
2,12,2030,2042,0.0001783,0.0000799,81.12
2,13,2030,2043,0.0002061,0.0000975,80.12
2,14,2030,2044,0.0002415,0.0001197,79.13
2,15,2030,2045,0.0002756,0.0001392,78.14
2,16,2030,2046,0.0003003,0.0001492,77.15
2,17,2030,2047,0.0003175,0.0001509,76.16
2,18,2030,2048,0.0003342,0.0001517,75.18
2,19,2030,2049,0.0003539,0.0001558,74.19
2,20,2030,2050,0.0003732,0.0001604,73.20
2,21,2030,2051,0.0003859,0.0001596,72.21
2,22,2030,2052,0.0003897,0.0001521,71.22
2,23,2030,2053,0.0003908,0.0001432,70.23
2,24,2030,2054,0.0003983,0.0001398,69.24
2,25,2030,2055,0.0004147,0.0001424,68.25
2,26,2030,2056,0.0004348,0.0001470,67.26
2,27,2030,2057,0.0004528,0.0001494,66.27
2,28,2030,2058,0.0004684,0.0001519,65.28
2,29,2030,2059,0.0004856,0.0001547,64.29
2,30,2030,2060,0.0005091,0.0001592,63.30
2,31,2030,2061,0.0005408,0.0001657,62.31
2,32,2030,2062,0.0005796,0.0001735,61.32
2,33,2030,2063,0.0006220,0.0001809,60.33
2,34,2030,2064,0.0006665,0.0001873,59.34
2,35,2030,2065,0.0007153,0.0001931,58.35
2,36,2030,2066,0.0007710,0.0002033,57.36
2,37,2030,2067,0.0008314,0.0002140,56.38
2,38,2030,2068,0.0008908,0.0002266,55.39
2,39,2030,2069,0.0009481,0.0002417,54.40
2,40,2030,2070,0.0010090,0.0002591,53.41
2,41,2030,2071,0.0010784,0.0002778,52.43
2,42,2030,2072,0.0011559,0.0002978,51.44
2,43,2030,2073,0.0012427,0.0003236,50.46
2,44,2030,2074,0.0013435,0.0003607,49.47
2,45,2030,2075,0.0014588,0.0004026,48.49
2,46,2030,2076,0.0015840,0.0004472,47.51
2,47,2030,2077,0.0017152,0.0004865,46.53
2,48,2030,2078,0.0018531,0.0005243,45.55
2,49,2030,2079,0.0020059,0.0005639,44.58
2,50,2030,2080,0.0021845,0.0006027,43.60
2,51,2030,2081,0.0023896,0.0006399,42.63
2,52,2030,2082,0.0026115,0.0006767,41.65
2,53,2030,2083,0.0028474,0.0007199,40.68
2,54,2030,2084,0.0031082,0.0007814,39.71
2,55,2030,2085,0.0034035,0.0008531,38.74
2,56,2030,2086,0.0037277,0.0009267,37.77
2,57,2030,2087,0.0040692,0.0009881,36.81
2,58,2030,2088,0.0044295,0.0010452,35.85
2,59,2030,2089,0.0048296,0.0011138,34.88
2,60,2030,2090,0.0052973,0.0012064,33.92
2,61,2030,2091,0.0058480,0.0013267,32.96
2,62,2030,2092,0.0064757,0.0014740,32.00
2,63,2030,2093,0.0071641,0.0016489,31.05
2,64,2030,2094,0.0078986,0.0018366,30.10
2,65,2030,2095,0.0086645,0.0020044,29.16
2,66,2030,2096,0.0094558,0.0021507,28.21
2,67,2030,2097,0.0103010,0.0023000,27.27
2,68,2030,2098,0.0112531,0.0024836,26.33
2,69,2030,2099,0.0123584,0.0027124,25.40
2,70,2030,2100,0.0136702,0.0030066,24.47
2,71,2030,2101,0.0152518,0.0034243,23.54
2,72,2030,2102,0.0170987,0.0039782,22.62
2,73,2030,2103,0.0190837,0.0045847,21.71
2,74,2030,2104,0.0210750,0.0051537,20.80
2,75,2030,2105,0.0231062,0.0056892,19.91
2,76,2030,2106,0.0253497,0.0063151,19.02
2,77,2030,2107,0.0279666,0.0071584,18.14
2,78,2030,2108,0.0310443,0.0082922,17.27
2,79,2030,2109,0.0345982,0.0097177,16.41
2,80,2030,2110,0.0395295,0.0123081,15.56
2,81,2030,2111,0.0438328,0.0141196,14.75
2,82,2030,2112,0.0485928,0.0161969,13.95
2,83,2030,2113,0.0538556,0.0185795,13.17
2,84,2030,2114,0.0596709,0.0212822,12.41
2,85,2030,2115,0.0660929,0.0243620,11.67
2,86,2030,2116,0.0731799,0.0279096,10.95
2,87,2030,2117,0.0809950,0.0320005,10.25
2,88,2030,2118,0.0896059,0.0366893,9.58
2,89,2030,2119,0.0990850,0.0420066,8.92
2,90,2030,2120,0.1095094,0.0480515,8.29
2,91,2030,2121,0.1209607,0.0549742,7.68
2,92,2030,2122,0.1335249,0.0629389,7.10
2,93,2030,2123,0.1472918,0.0721023,6.54
2,94,2030,2124,0.1623547,0.0825853,6.01
2,95,2030,2125,0.1788093,0.0945359,5.51
2,96,2030,2126,0.1967531,0.1081855,5.03
2,97,2030,2127,0.2162837,0.1238120,4.58
2,98,2030,2128,0.2374976,0.1416782,4.16
2,99,2030,2129,0.2604884,0.1619921,3.77
2,100,2030,2130,0.2853445,0.1849919,3.40
2,101,2030,2131,0.3121468,0.2110147,3.05
2,102,2030,2132,0.3409660,0.2404303,2.74
2,103,2030,2133,0.3718598,0.2735533,2.45
2,104,2030,2134,0.4048696,0.3106034,2.18
2,105,2030,2135,0.4400178,0.3518039,1.93
2,106,2030,2136,0.4773042,0.3974231,1.71
2,107,2030,2137,0.5167037,0.4476678,1.51
2,108,2030,2138,0.5581634,0.5025941,1.33
2,109,2030,2139,0.6016004,0.5621003,1.17
2,110,2030,2140,0.6469012,0.6260083,1.02
2,111,2030,2141,0.6939204,0.6940381,0.89
2,112,2030,2142,0.7424819,0.7657170,0.77
2,113,2030,2143,0.7923800,0.8403827,0.67
2,114,2030,2144,0.8433824,0.9172841,0.58
2,115,2030,2145,1.0000000,1.0000000,0.50
2,0,2031,2031,0.0077998,0.0035978,92.80
2,1,2031,2032,0.0005341,0.0001526,92.14
2,2,2031,2033,0.0002805,0.0000812,91.15
2,3,2031,2034,0.0001960,0.0000584,90.16
2,4,2031,2035,0.0001520,0.0000447,89.17
2,5,2031,2036,0.0001465,0.0000453,88.17
2,6,2031,2037,0.0001399,0.0000450,87.17
2,7,2031,2038,0.0001348,0.0000451,86.18
2,8,2031,2039,0.0001336,0.0000469,85.18
2,9,2031,2040,0.0001377,0.0000508,84.19
2,10,2031,2041,0.0001465,0.0000571,83.19
2,11,2031,2042,0.0001596,0.0000659,82.19
2,12,2031,2043,0.0001783,0.0000780,81.20
2,13,2031,2044,0.0002061,0.0000953,80.21
2,14,2031,2045,0.0002415,0.0001169,79.21
2,15,2031,2046,0.0002756,0.0001361,78.22
2,16,2031,2047,0.0003003,0.0001462,77.23
2,17,2031,2048,0.0003175,0.0001479,76.24
2,18,2031,2049,0.0003342,0.0001485,75.26
2,19,2031,2050,0.0003539,0.0001522,74.27
2,20,2031,2051,0.0003732,0.0001566,73.28
2,21,2031,2052,0.0003859,0.0001560,72.29
2,22,2031,2053,0.0003897,0.0001488,71.30
2,23,2031,2054,0.0003908,0.0001398,70.31
2,24,2031,2055,0.0003983,0.0001361,69.32
2,25,2031,2056,0.0004147,0.0001385,68.33
2,26,2031,2057,0.0004348,0.0001433,67.34
2,27,2031,2058,0.0004528,0.0001459,66.35
2,28,2031,2059,0.0004684,0.0001483,65.36
2,29,2031,2060,0.0004856,0.0001507,64.37
2,30,2031,2061,0.0005091,0.0001550,63.38
2,31,2031,2062,0.0005408,0.0001616,62.39
2,32,2031,2063,0.0005796,0.0001696,61.40
2,33,2031,2064,0.0006220,0.0001766,60.41
2,34,2031,2065,0.0006665,0.0001824,59.42
2,35,2031,2066,0.0007153,0.0001880,58.43
2,36,2031,2067,0.0007710,0.0001982,57.44
2,37,2031,2068,0.0008314,0.0002090,56.45
2,38,2031,2069,0.0008908,0.0002213,55.46
2,39,2031,2070,0.0009481,0.0002357,54.48
2,40,2031,2071,0.0010090,0.0002526,53.49
2,41,2031,2072,0.0010784,0.0002713,52.50
2,42,2031,2073,0.0011559,0.0002915,51.52
2,43,2031,2074,0.0012427,0.0003168,50.53
2,44,2031,2075,0.0013435,0.0003527,49.55
2,45,2031,2076,0.0014588,0.0003938,48.56
2,46,2031,2077,0.0015840,0.0004383,47.58
2,47,2031,2078,0.0017152,0.0004777,46.60
2,48,2031,2079,0.0018531,0.0005148,45.63
2,49,2031,2080,0.0020059,0.0005528,44.65
2,50,2031,2081,0.0021845,0.0005906,43.67
2,51,2031,2082,0.0023896,0.0006277,42.70
2,52,2031,2083,0.0026115,0.0006646,41.73
2,53,2031,2084,0.0028474,0.0007066,40.75
2,54,2031,2085,0.0031082,0.0007659,39.78
2,55,2031,2086,0.0034035,0.0008360,38.81
2,56,2031,2087,0.0037277,0.0009093,37.84
2,57,2031,2088,0.0040692,0.0009708,36.88
2,58,2031,2089,0.0044295,0.0010263,35.91
2,59,2031,2090,0.0048296,0.0010917,34.95
2,60,2031,2091,0.0052973,0.0011821,33.99
2,61,2031,2092,0.0058480,0.0013017,33.03
2,62,2031,2093,0.0064757,0.0014486,32.07
2,63,2031,2094,0.0071641,0.0016203,31.11
2,64,2031,2095,0.0078986,0.0018024,30.16
2,65,2031,2096,0.0086645,0.0019666,29.22
2,66,2031,2097,0.0094558,0.0021125,28.27
2,67,2031,2098,0.0103010,0.0022620,27.33
2,68,2031,2099,0.0112531,0.0024416,26.39
2,69,2031,2100,0.0123584,0.0026628,25.46
2,70,2031,2101,0.0136702,0.0029511,24.52
2,71,2031,2102,0.0152518,0.0033662,23.60
2,72,2031,2103,0.0170987,0.0039180,22.67
2,73,2031,2104,0.0190837,0.0045165,21.76
2,74,2031,2105,0.0210750,0.0050722,20.86
2,75,2031,2106,0.0231062,0.0055986,19.96
2,76,2031,2107,0.0253497,0.0062220,19.07
2,77,2031,2108,0.0279666,0.0070630,18.19
2,78,2031,2109,0.0310443,0.0081829,17.31
2,79,2031,2110,0.0345982,0.0095844,16.45
2,80,2031,2111,0.0395295,0.0121508,15.61
2,81,2031,2112,0.0438328,0.0139563,14.79
2,82,2031,2113,0.0485928,0.0160301,13.99
2,83,2031,2114,0.0538556,0.0183915,13.21
2,84,2031,2115,0.0596709,0.0210572,12.45
2,85,2031,2116,0.0660929,0.0241090,11.71
2,86,2031,2117,0.0731799,0.0276480,10.99
2,87,2031,2118,0.0809950,0.0317339,10.28
2,88,2031,2119,0.0896059,0.0363884,9.60
2,89,2031,2120,0.0990850,0.0416482,8.95
2,90,2031,2121,0.1095094,0.0476520,8.32
2,91,2031,2122,0.1209607,0.0545652,7.71
2,92,2031,2123,0.1335249,0.0625272,7.12
2,93,2031,2124,0.1472918,0.0716445,6.56
2,94,2031,2125,0.1623547,0.0820481,6.03
2,95,2031,2126,0.1788093,0.0939468,5.53
2,96,2031,2127,0.1967531,0.1075944,5.05
2,97,2031,2128,0.2162837,0.1232328,4.60
2,98,2031,2129,0.2374976,0.1410550,4.17
2,99,2031,2130,0.2604884,0.1612842,3.77
2,100,2031,2131,0.2853445,0.1842426,3.40
2,101,2031,2132,0.3121468,0.2102928,3.06
2,102,2031,2133,0.3409660,0.2397548,2.74
2,103,2031,2134,0.3718598,0.2728650,2.45
2,104,2031,2135,0.4048696,0.3098739,2.18
2,105,2031,2136,0.4400178,0.3510965,1.94
2,106,2031,2137,0.4773042,0.3968130,1.71
2,107,2031,2138,0.5167037,0.4471739,1.51
2,108,2031,2139,0.5581634,0.5021822,1.33
2,109,2031,2140,0.6016004,0.5617792,1.17
2,110,2031,2141,0.6469012,0.6258338,1.02
2,111,2031,2142,0.6939204,0.6940390,0.89
2,112,2031,2143,0.7424819,0.7658856,0.77
2,113,2031,2144,0.7923800,0.8407368,0.67
2,114,2031,2145,0.8433824,0.9178724,0.58
2,115,2031,2146,1.0000000,1.0000000,0.50
2,0,2032,2032,0.0077998,0.0034483,92.90
2,1,2032,2033,0.0005341,0.0001437,92.22
2,2,2032,2034,0.0002805,0.0000767,91.24
2,3,2032,2035,0.0001960,0.0000551,90.24
2,4,2032,2036,0.0001520,0.0000422,89.25
2,5,2032,2037,0.0001465,0.0000431,88.25
2,6,2032,2038,0.0001399,0.0000431,87.26
2,7,2032,2039,0.0001348,0.0000433,86.26
2,8,2032,2040,0.0001336,0.0000450,85.26
2,9,2032,2041,0.0001377,0.0000489,84.27
2,10,2032,2042,0.0001465,0.0000553,83.27
2,11,2032,2043,0.0001596,0.0000641,82.28
2,12,2032,2044,0.0001783,0.0000760,81.28
2,13,2032,2045,0.0002061,0.0000929,80.29
2,14,2032,2046,0.0002415,0.0001142,79.30
2,15,2032,2047,0.0002756,0.0001333,78.30
2,16,2032,2048,0.0003003,0.0001434,77.31
2,17,2032,2049,0.0003175,0.0001449,76.33
2,18,2032,2050,0.0003342,0.0001451,75.34
2,19,2032,2051,0.0003539,0.0001486,74.35
2,20,2032,2052,0.0003732,0.0001531,73.36
2,21,2032,2053,0.0003859,0.0001527,72.37
2,22,2032,2054,0.0003897,0.0001454,71.38
2,23,2032,2055,0.0003908,0.0001362,70.39
2,24,2032,2056,0.0003983,0.0001324,69.40
2,25,2032,2057,0.0004147,0.0001350,68.41
2,26,2032,2058,0.0004348,0.0001400,67.42
2,27,2032,2059,0.0004528,0.0001425,66.43
2,28,2032,2060,0.0004684,0.0001445,65.44
2,29,2032,2061,0.0004856,0.0001468,64.45
2,30,2032,2062,0.0005091,0.0001512,63.46
2,31,2032,2063,0.0005408,0.0001580,62.47
2,32,2032,2064,0.0005796,0.0001656,61.48
2,33,2032,2065,0.0006220,0.0001721,60.49
2,34,2032,2066,0.0006665,0.0001776,59.50
2,35,2032,2067,0.0007153,0.0001832,58.51
2,36,2032,2068,0.0007710,0.0001936,57.52
2,37,2032,2069,0.0008314,0.0002040,56.53
2,38,2032,2070,0.0008908,0.0002156,55.54
2,39,2032,2071,0.0009481,0.0002296,54.55
2,40,2032,2072,0.0010090,0.0002467,53.56
2,41,2032,2073,0.0010784,0.0002655,52.58
2,42,2032,2074,0.0011559,0.0002852,51.59
2,43,2032,2075,0.0012427,0.0003095,50.61
2,44,2032,2076,0.0013435,0.0003447,49.62
2,45,2032,2077,0.0014588,0.0003857,48.64
2,46,2032,2078,0.0015840,0.0004303,47.66
2,47,2032,2079,0.0017152,0.0004689,46.68
2,48,2032,2080,0.0018531,0.0005046,45.70
2,49,2032,2081,0.0020059,0.0005417,44.72
2,50,2032,2082,0.0021845,0.0005794,43.74
2,51,2032,2083,0.0023896,0.0006166,42.77
2,52,2032,2084,0.0026115,0.0006524,41.80
2,53,2032,2085,0.0028474,0.0006925,40.82
2,54,2032,2086,0.0031082,0.0007503,39.85
2,55,2032,2087,0.0034035,0.0008201,38.88
2,56,2032,2088,0.0037277,0.0008935,37.91
2,57,2032,2089,0.0040692,0.0009534,36.95
2,58,2032,2090,0.0044295,0.0010060,35.98
2,59,2032,2091,0.0048296,0.0010696,35.02
2,60,2032,2092,0.0052973,0.0011596,34.05
2,61,2032,2093,0.0058480,0.0012790,33.09
2,62,2032,2094,0.0064757,0.0014230,32.13
2,63,2032,2095,0.0071641,0.0015896,31.18
2,64,2032,2096,0.0078986,0.0017681,30.23
2,65,2032,2097,0.0086645,0.0019316,29.28
2,66,2032,2098,0.0094558,0.0020776,28.34
2,67,2032,2099,0.0103010,0.0022237,27.39
2,68,2032,2100,0.0112531,0.0023966,26.45
2,69,2032,2101,0.0123584,0.0026130,25.52
2,70,2032,2102,0.0136702,0.0028998,24.58
2,71,2032,2103,0.0152518,0.0033135,23.65
2,72,2032,2104,0.0170987,0.0038578,22.73
2,73,2032,2105,0.0190837,0.0044434,21.81
2,74,2032,2106,0.0210750,0.0049901,20.91
2,75,2032,2107,0.0231062,0.0055145,20.01
2,76,2032,2108,0.0253497,0.0061367,19.12
2,77,2032,2109,0.0279666,0.0069660,18.24
2,78,2032,2110,0.0310443,0.0080651,17.36
2,79,2032,2111,0.0345982,0.0094499,16.50
2,80,2032,2112,0.0395295,0.0120045,15.65
2,81,2032,2113,0.0438328,0.0138067,14.83
2,82,2032,2114,0.0485928,0.0158613,14.03
2,83,2032,2115,0.0538556,0.0181890,13.25
2,84,2032,2116,0.0596709,0.0208292,12.49
2,85,2032,2117,0.0660929,0.0238729,11.74
2,86,2032,2118,0.0731799,0.0274069,11.02
2,87,2032,2119,0.0809950,0.0314611,10.32
2,88,2032,2120,0.0896059,0.0360628,9.63
2,89,2032,2121,0.0990850,0.0412843,8.98
2,90,2032,2122,0.1095094,0.0472784,8.34
2,91,2032,2123,0.1209607,0.0541879,7.73
2,92,2032,2124,0.1335249,0.0621061,7.14
2,93,2032,2125,0.1472918,0.0711483,6.58
2,94,2032,2126,0.1623547,0.0815015,6.05
2,95,2032,2127,0.1788093,0.0933953,5.54
2,96,2032,2128,0.1967531,0.1070506,5.06
2,97,2032,2129,0.2162837,0.1226433,4.61
2,98,2032,2130,0.2374976,0.1403797,4.18
2,99,2032,2131,0.2604884,0.1605622,3.78
2,100,2032,2132,0.2853445,0.1835390,3.41
2,101,2032,2133,0.3121468,0.2096252,3.07
2,102,2032,2134,0.3409660,0.2390629,2.75
2,103,2032,2135,0.3718598,0.2721163,2.45
2,104,2032,2136,0.4048696,0.3091286,2.19
2,105,2032,2137,0.4400178,0.3504311,1.94
2,106,2032,2138,0.4773042,0.3962478,1.72
2,107,2032,2139,0.5167037,0.4466671,1.51
2,108,2032,2140,0.5581634,0.5017337,1.33
2,109,2032,2141,0.6016004,0.5614506,1.17
2,110,2032,2142,0.6469012,0.6256695,1.02
2,111,2032,2143,0.6939204,0.6940399,0.89
2,112,2032,2144,0.7424819,0.7660578,0.77
2,113,2032,2145,0.7923800,0.8411221,0.67
2,114,2032,2146,0.8433824,0.9184749,0.58
2,115,2032,2147,1.0000000,1.0000000,0.50
2,0,2033,2033,0.0077998,0.0033158,93.00
2,1,2033,2034,0.0005341,0.0001351,92.31
2,2,2033,2035,0.0002805,0.0000720,91.32
2,3,2033,2036,0.0001960,0.0000519,90.33
2,4,2033,2037,0.0001520,0.0000399,89.33
2,5,2033,2038,0.0001465,0.0000411,88.33
2,6,2033,2039,0.0001399,0.0000412,87.34
2,7,2033,2040,0.0001348,0.0000414,86.34
2,8,2033,2041,0.0001336,0.0000431,85.35
2,9,2033,2042,0.0001377,0.0000471,84.35
2,10,2033,2043,0.0001465,0.0000536,83.35
2,11,2033,2044,0.0001596,0.0000623,82.36
2,12,2033,2045,0.0001783,0.0000739,81.36
2,13,2033,2046,0.0002061,0.0000906,80.37
2,14,2033,2047,0.0002415,0.0001117,79.38
2,15,2033,2048,0.0002756,0.0001308,78.38
2,16,2033,2049,0.0003003,0.0001406,77.39
2,17,2033,2050,0.0003175,0.0001417,76.41
2,18,2033,2051,0.0003342,0.0001417,75.42
2,19,2033,2052,0.0003539,0.0001453,74.43
2,20,2033,2053,0.0003732,0.0001499,73.44
2,21,2033,2054,0.0003859,0.0001493,72.45
2,22,2033,2055,0.0003897,0.0001417,71.46
2,23,2033,2056,0.0003908,0.0001326,70.47
2,24,2033,2057,0.0003983,0.0001290,69.48
2,25,2033,2058,0.0004147,0.0001318,68.49
2,26,2033,2059,0.0004348,0.0001367,67.50
2,27,2033,2060,0.0004528,0.0001388,66.51
2,28,2033,2061,0.0004684,0.0001407,65.51
2,29,2033,2062,0.0004856,0.0001431,64.52
2,30,2033,2063,0.0005091,0.0001478,63.53
2,31,2033,2064,0.0005408,0.0001543,62.54
2,32,2033,2065,0.0005796,0.0001614,61.55
2,33,2033,2066,0.0006220,0.0001676,60.56
2,34,2033,2067,0.0006665,0.0001732,59.57
2,35,2033,2068,0.0007153,0.0001790,58.58
2,36,2033,2069,0.0007710,0.0001890,57.59
2,37,2033,2070,0.0008314,0.0001988,56.60
2,38,2033,2071,0.0008908,0.0002100,55.61
2,39,2033,2072,0.0009481,0.0002241,54.63
2,40,2033,2073,0.0010090,0.0002413,53.64
2,41,2033,2074,0.0010784,0.0002597,52.65
2,42,2033,2075,0.0011559,0.0002785,51.66
2,43,2033,2076,0.0012427,0.0003022,50.68
2,44,2033,2077,0.0013435,0.0003374,49.69
2,45,2033,2078,0.0014588,0.0003784,48.71
2,46,2033,2079,0.0015840,0.0004222,47.73
2,47,2033,2080,0.0017152,0.0004595,46.75
2,48,2033,2081,0.0018531,0.0004943,45.77
2,49,2033,2082,0.0020059,0.0005314,44.79
2,50,2033,2083,0.0021845,0.0005692,43.82
2,51,2033,2084,0.0023896,0.0006054,42.84
2,52,2033,2085,0.0026115,0.0006394,41.87
2,53,2033,2086,0.0028474,0.0006783,40.89
2,54,2033,2087,0.0031082,0.0007360,39.92
2,55,2033,2088,0.0034035,0.0008057,38.95
2,56,2033,2089,0.0037277,0.0008775,37.98
2,57,2033,2090,0.0040692,0.0009347,37.01
2,58,2033,2091,0.0044295,0.0009857,36.05
2,59,2033,2092,0.0048296,0.0010492,35.08
2,60,2033,2093,0.0052973,0.0011391,34.12
2,61,2033,2094,0.0058480,0.0012560,33.16
2,62,2033,2095,0.0064757,0.0013955,32.20
2,63,2033,2096,0.0071641,0.0015587,31.24
2,64,2033,2097,0.0078986,0.0017364,30.29
2,65,2033,2098,0.0086645,0.0018997,29.34
2,66,2033,2099,0.0094558,0.0020424,28.40
2,67,2033,2100,0.0103010,0.0021826,27.45
2,68,2033,2101,0.0112531,0.0023514,26.51
2,69,2033,2102,0.0123584,0.0025669,25.57
2,70,2033,2103,0.0136702,0.0028532,24.64
2,71,2033,2104,0.0152518,0.0032608,23.71
2,72,2033,2105,0.0170987,0.0037934,22.78
2,73,2033,2106,0.0190837,0.0043699,21.87
2,74,2033,2107,0.0210750,0.0049139,20.96
2,75,2033,2108,0.0231062,0.0054373,20.06
2,76,2033,2109,0.0253497,0.0060498,19.17
2,77,2033,2110,0.0279666,0.0068616,18.28
2,78,2033,2111,0.0310443,0.0079463,17.41
2,79,2033,2112,0.0345982,0.0093249,16.54
2,80,2033,2113,0.0395295,0.0118707,15.69
2,81,2033,2114,0.0438328,0.0136553,14.88
2,82,2033,2115,0.0485928,0.0156794,14.07
2,83,2033,2116,0.0538556,0.0179839,13.29
2,84,2033,2117,0.0596709,0.0206165,12.53
2,85,2033,2118,0.0660929,0.0236552,11.78
2,86,2033,2119,0.0731799,0.0271602,11.05
2,87,2033,2120,0.0809950,0.0311660,10.35
2,88,2033,2121,0.0896059,0.0357323,9.66
2,89,2033,2122,0.0990850,0.0409442,9.00
2,90,2033,2123,0.1095094,0.0469339,8.37
2,91,2033,2124,0.1209607,0.0538022,7.75
2,92,2033,2125,0.1335249,0.0616499,7.17
2,93,2033,2126,0.1472918,0.0706436,6.60
2,94,2033,2127,0.1623547,0.0809899,6.07
2,95,2033,2128,0.1788093,0.0928881,5.56
2,96,2033,2129,0.1967531,0.1064973,5.08
2,97,2033,2130,0.2162837,0.1220049,4.62
2,98,2033,2131,0.2374976,0.1396914,4.19
2,99,2033,2132,0.2604884,0.1598848,3.79
2,100,2033,2133,0.2853445,0.1828886,3.42
2,101,2033,2134,0.3121468,0.2089416,3.07
2,102,2033,2135,0.3409660,0.2383107,2.75
2,103,2033,2136,0.3718598,0.2713517,2.46
2,104,2033,2137,0.4048696,0.3084276,2.19
2,105,2033,2138,0.4400178,0.3498147,1.94
2,106,2033,2139,0.4773042,0.3956680,1.72
2,107,2033,2140,0.5167037,0.4461153,1.51
2,108,2033,2141,0.5581634,0.5012747,1.33
2,109,2033,2142,0.6016004,0.5611413,1.17
2,110,2033,2143,0.6469012,0.6255178,1.02
2,111,2033,2144,0.6939204,0.6940407,0.89
2,112,2033,2145,0.7424819,0.7662451,0.77
2,113,2033,2146,0.7923800,0.8415166,0.67
2,114,2033,2147,0.8433824,0.9190426,0.58
2,115,2033,2148,1.0000000,1.0000000,0.50
2,0,2034,2034,0.0077998,0.0031857,93.09
2,1,2034,2035,0.0005341,0.0001264,92.39
2,2,2034,2036,0.0002805,0.0000675,91.40
2,3,2034,2037,0.0001960,0.0000490,90.41
2,4,2034,2038,0.0001520,0.0000380,89.41
2,5,2034,2039,0.0001465,0.0000392,88.42
2,6,2034,2040,0.0001399,0.0000393,87.42
2,7,2034,2041,0.0001348,0.0000395,86.42
2,8,2034,2042,0.0001336,0.0000414,85.43
2,9,2034,2043,0.0001377,0.0000456,84.43
2,10,2034,2044,0.0001465,0.0000520,83.43
2,11,2034,2045,0.0001596,0.0000605,82.44
2,12,2034,2046,0.0001783,0.0000718,81.44
2,13,2034,2047,0.0002061,0.0000884,80.45
2,14,2034,2048,0.0002415,0.0001095,79.46
2,15,2034,2049,0.0002756,0.0001282,78.46
2,16,2034,2050,0.0003003,0.0001375,77.47
2,17,2034,2051,0.0003175,0.0001385,76.48
2,18,2034,2052,0.0003342,0.0001386,75.49
2,19,2034,2053,0.0003539,0.0001422,74.51
2,20,2034,2054,0.0003732,0.0001466,73.52
2,21,2034,2055,0.0003859,0.0001457,72.53
2,22,2034,2056,0.0003897,0.0001381,71.54
2,23,2034,2057,0.0003908,0.0001292,70.55
2,24,2034,2058,0.0003983,0.0001260,69.56
2,25,2034,2059,0.0004147,0.0001287,68.56
2,26,2034,2060,0.0004348,0.0001331,67.57
2,27,2034,2061,0.0004528,0.0001351,66.58
2,28,2034,2062,0.0004684,0.0001372,65.59
2,29,2034,2063,0.0004856,0.0001398,64.60
2,30,2034,2064,0.0005091,0.0001443,63.61
2,31,2034,2065,0.0005408,0.0001503,62.62
2,32,2034,2066,0.0005796,0.0001572,61.63
2,33,2034,2067,0.0006220,0.0001635,60.64
2,34,2034,2068,0.0006665,0.0001692,59.65
2,35,2034,2069,0.0007153,0.0001747,58.66
2,36,2034,2070,0.0007710,0.0001841,57.67
2,37,2034,2071,0.0008314,0.0001935,56.68
2,38,2034,2072,0.0008908,0.0002048,55.69
2,39,2034,2073,0.0009481,0.0002190,54.70
2,40,2034,2074,0.0010090,0.0002358,53.71
2,41,2034,2075,0.0010784,0.0002535,52.72
2,42,2034,2076,0.0011559,0.0002718,51.74
2,43,2034,2077,0.0012427,0.0002955,50.75
2,44,2034,2078,0.0013435,0.0003307,49.77
2,45,2034,2079,0.0014588,0.0003710,48.78
2,46,2034,2080,0.0015840,0.0004135,47.80
2,47,2034,2081,0.0017152,0.0004500,46.82
2,48,2034,2082,0.0018531,0.0004848,45.84
2,49,2034,2083,0.0020059,0.0005221,44.86
2,50,2034,2084,0.0021845,0.0005590,43.89
2,51,2034,2085,0.0023896,0.0005935,42.91
2,52,2034,2086,0.0026115,0.0006263,41.94
2,53,2034,2087,0.0028474,0.0006652,40.96
2,54,2034,2088,0.0031082,0.0007229,39.99
2,55,2034,2089,0.0034035,0.0007912,39.02
2,56,2034,2090,0.0037277,0.0008604,38.05
2,57,2034,2091,0.0040692,0.0009160,37.08
2,58,2034,2092,0.0044295,0.0009670,36.11
2,59,2034,2093,0.0048296,0.0010306,35.15
2,60,2034,2094,0.0052973,0.0011184,34.18
2,61,2034,2095,0.0058480,0.0012314,33.22
2,62,2034,2096,0.0064757,0.0013679,32.26
2,63,2034,2097,0.0071641,0.0015302,31.31
2,64,2034,2098,0.0078986,0.0017074,30.35
2,65,2034,2099,0.0086645,0.0018675,29.40
2,66,2034,2100,0.0094558,0.0020047,28.46
2,67,2034,2101,0.0103010,0.0021413,27.51
2,68,2034,2102,0.0112531,0.0023097,26.57
2,69,2034,2103,0.0123584,0.0025252,25.63
2,70,2034,2104,0.0136702,0.0028066,24.70
2,71,2034,2105,0.0152518,0.0032044,23.76
2,72,2034,2106,0.0170987,0.0037285,22.84
2,73,2034,2107,0.0190837,0.0043017,21.92
2,74,2034,2108,0.0210750,0.0048441,21.01
2,75,2034,2109,0.0231062,0.0053589,20.11
2,76,2034,2110,0.0253497,0.0059564,19.22
2,77,2034,2111,0.0279666,0.0067563,18.33
2,78,2034,2112,0.0310443,0.0078360,17.45
2,79,2034,2113,0.0345982,0.0092106,16.59
2,80,2034,2114,0.0395295,0.0117353,15.74
2,81,2034,2115,0.0438328,0.0134924,14.92
2,82,2034,2116,0.0485928,0.0154954,14.12
2,83,2034,2117,0.0538556,0.0177927,13.33
2,84,2034,2118,0.0596709,0.0204205,12.56
2,85,2034,2119,0.0660929,0.0234328,11.81
2,86,2034,2120,0.0731799,0.0268935,11.08
2,87,2034,2121,0.0809950,0.0308667,10.38
2,88,2034,2122,0.0896059,0.0354236,9.69
2,89,2034,2123,0.0990850,0.0406307,9.03
2,90,2034,2124,0.1095094,0.0465819,8.39
2,91,2034,2125,0.1209607,0.0533845,7.78
2,92,2034,2126,0.1335249,0.0611862,7.19
2,93,2034,2127,0.1472918,0.0701716,6.62
2,94,2034,2128,0.1623547,0.0805196,6.08
2,95,2034,2129,0.1788093,0.0923722,5.57
2,96,2034,2130,0.1967531,0.1058983,5.09
2,97,2034,2131,0.2162837,0.1213544,4.63
2,98,2034,2132,0.2374976,0.1390457,4.20
2,99,2034,2133,0.2604884,0.1592587,3.80
2,100,2034,2134,0.2853445,0.1822228,3.43
2,101,2034,2135,0.3121468,0.2081988,3.08
2,102,2034,2136,0.3409660,0.2375427,2.76
2,103,2034,2137,0.3718598,0.2706328,2.46
2,104,2034,2138,0.4048696,0.3077787,2.19
2,105,2034,2139,0.4400178,0.3491827,1.94
2,106,2034,2140,0.4773042,0.3950368,1.72
2,107,2034,2141,0.5167037,0.4455507,1.52
2,108,2034,2142,0.5581634,0.5008428,1.33
2,109,2034,2143,0.6016004,0.5608555,1.17
2,110,2034,2144,0.6469012,0.6253628,1.02
2,111,2034,2145,0.6939204,0.6940417,0.89
2,112,2034,2146,0.7424819,0.7664369,0.77
2,113,2034,2147,0.7923800,0.8418884,0.67
2,114,2034,2148,0.8433824,0.9195704,0.58
2,115,2034,2149,1.0000000,1.0000000,0.50
2,0,2035,2035,0.0077998,0.0030500,93.19
2,1,2035,2036,0.0005341,0.0001181,92.47
2,2,2035,2037,0.0002805,0.0000635,91.48
2,3,2035,2038,0.0001960,0.0000465,90.49
2,4,2035,2039,0.0001520,0.0000360,89.49
2,5,2035,2040,0.0001465,0.0000373,88.50
2,6,2035,2041,0.0001399,0.0000374,87.50
2,7,2035,2042,0.0001348,0.0000379,86.50
2,8,2035,2043,0.0001336,0.0000399,85.51
2,9,2035,2044,0.0001377,0.0000440,84.51
2,10,2035,2045,0.0001465,0.0000503,83.51
2,11,2035,2046,0.0001596,0.0000586,82.52
2,12,2035,2047,0.0001783,0.0000699,81.52
2,13,2035,2048,0.0002061,0.0000864,80.53
2,14,2035,2049,0.0002415,0.0001071,79.53
2,15,2035,2050,0.0002756,0.0001254,78.54
2,16,2035,2051,0.0003003,0.0001345,77.55
2,17,2035,2052,0.0003175,0.0001355,76.56
2,18,2035,2053,0.0003342,0.0001357,75.57
2,19,2035,2054,0.0003539,0.0001392,74.58
2,20,2035,2055,0.0003732,0.0001431,73.59
2,21,2035,2056,0.0003859,0.0001421,72.60
2,22,2035,2057,0.0003897,0.0001348,71.61
2,23,2035,2058,0.0003908,0.0001262,70.62
2,24,2035,2059,0.0003983,0.0001229,69.63
2,25,2035,2060,0.0004147,0.0001253,68.64
2,26,2035,2061,0.0004348,0.0001296,67.65
2,27,2035,2062,0.0004528,0.0001317,66.66
2,28,2035,2063,0.0004684,0.0001340,65.67
2,29,2035,2064,0.0004856,0.0001365,64.68
2,30,2035,2065,0.0005091,0.0001406,63.68
2,31,2035,2066,0.0005408,0.0001464,62.69
2,32,2035,2067,0.0005796,0.0001533,61.70
2,33,2035,2068,0.0006220,0.0001597,60.71
2,34,2035,2069,0.0006665,0.0001652,59.72
2,35,2035,2070,0.0007153,0.0001702,58.73
2,36,2035,2071,0.0007710,0.0001793,57.74
2,37,2035,2072,0.0008314,0.0001887,56.75
2,38,2035,2073,0.0008908,0.0002001,55.76
2,39,2035,2074,0.0009481,0.0002140,54.77
2,40,2035,2075,0.0010090,0.0002301,53.79
2,41,2035,2076,0.0010784,0.0002473,52.80
2,42,2035,2077,0.0011559,0.0002656,51.81
2,43,2035,2078,0.0012427,0.0002895,50.82
2,44,2035,2079,0.0013435,0.0003240,49.84
2,45,2035,2080,0.0014588,0.0003632,48.85
2,46,2035,2081,0.0015840,0.0004049,47.87
2,47,2035,2082,0.0017152,0.0004413,46.89
2,48,2035,2083,0.0018531,0.0004762,45.91
2,49,2035,2084,0.0020059,0.0005127,44.93
2,50,2035,2085,0.0021845,0.0005480,43.96
2,51,2035,2086,0.0023896,0.0005815,42.98
2,52,2035,2087,0.0026115,0.0006143,42.00
2,53,2035,2088,0.0028474,0.0006532,41.03
2,54,2035,2089,0.0031082,0.0007096,40.06
2,55,2035,2090,0.0034035,0.0007756,39.08
2,56,2035,2091,0.0037277,0.0008432,38.11
2,57,2035,2092,0.0040692,0.0008987,37.15
2,58,2035,2093,0.0044295,0.0009499,36.18
2,59,2035,2094,0.0048296,0.0010117,35.21
2,60,2035,2095,0.0052973,0.0010962,34.25
2,61,2035,2096,0.0058480,0.0012067,33.29
2,62,2035,2097,0.0064757,0.0013424,32.33
2,63,2035,2098,0.0071641,0.0015043,31.37
2,64,2035,2099,0.0078986,0.0016782,30.41
2,65,2035,2100,0.0086645,0.0018330,29.46
2,66,2035,2101,0.0094558,0.0019668,28.52
2,67,2035,2102,0.0103010,0.0021032,27.57
2,68,2035,2103,0.0112531,0.0022719,26.63
2,69,2035,2104,0.0123584,0.0024834,25.69
2,70,2035,2105,0.0136702,0.0027568,24.75
2,71,2035,2106,0.0152518,0.0031477,23.82
2,72,2035,2107,0.0170987,0.0036684,22.89
2,73,2035,2108,0.0190837,0.0042391,21.98
2,74,2035,2109,0.0210750,0.0047731,21.07
2,75,2035,2110,0.0231062,0.0052745,20.17
2,76,2035,2111,0.0253497,0.0058623,19.27
2,77,2035,2112,0.0279666,0.0066587,18.38
2,78,2035,2113,0.0310443,0.0077353,17.50
2,79,2035,2114,0.0345982,0.0090952,16.63
2,80,2035,2115,0.0395295,0.0115896,15.78
2,81,2035,2116,0.0438328,0.0133276,14.96
2,82,2035,2117,0.0485928,0.0153239,14.16
2,83,2035,2118,0.0538556,0.0176166,13.37
2,84,2035,2119,0.0596709,0.0202203,12.60
2,85,2035,2120,0.0660929,0.0231923,11.85
2,86,2035,2121,0.0731799,0.0266231,11.12
2,87,2035,2122,0.0809950,0.0305872,10.41
2,88,2035,2123,0.0896059,0.0351392,9.72
2,89,2035,2124,0.0990850,0.0403105,9.06
2,90,2035,2125,0.1095094,0.0462008,8.42
2,91,2035,2126,0.1209607,0.0529601,7.80
2,92,2035,2127,0.1335249,0.0607526,7.21
2,93,2035,2128,0.1472918,0.0697377,6.64
2,94,2035,2129,0.1623547,0.0800415,6.10
2,95,2035,2130,0.1788093,0.0918140,5.59
2,96,2035,2131,0.1967531,0.1052883,5.10
2,97,2035,2132,0.2162837,0.1207445,4.65
2,98,2035,2133,0.2374976,0.1384493,4.22
2,99,2035,2134,0.2604884,0.1586181,3.81
2,100,2035,2135,0.2853445,0.1814996,3.44
2,101,2035,2136,0.3121468,0.2074406,3.09
2,102,2035,2137,0.3409660,0.2368210,2.77
2,103,2035,2138,0.3718598,0.2699676,2.47
2,104,2035,2139,0.4048696,0.3071134,2.20
2,105,2035,2140,0.4400178,0.3484949,1.95
2,106,2035,2141,0.4773042,0.3943913,1.72
2,107,2035,2142,0.5167037,0.4450196,1.52
2,108,2035,2143,0.5581634,0.5004439,1.33
2,109,2035,2144,0.6016004,0.5605638,1.17
2,110,2035,2145,0.6469012,0.6251943,1.02
2,111,2035,2146,0.6939204,0.6940427,0.89
2,112,2035,2147,0.7424819,0.7666177,0.77
2,113,2035,2148,0.7923800,0.8422340,0.67
2,114,2035,2149,0.8433824,0.9201140,0.58
2,115,2035,2150,1.0000000,1.0000000,0.50
2,0,2036,2036,0.0077998,0.0029170,
2,1,2036,2037,0.0005341,0.0001107,
2,2,2036,2038,0.0002805,0.0000601,
2,3,2036,2039,0.0001960,0.0000441,
2,4,2036,2040,0.0001520,0.0000341,
2,5,2036,2041,0.0001465,0.0000353,
2,6,2036,2042,0.0001399,0.0000357,
2,7,2036,2043,0.0001348,0.0000364,
2,8,2036,2044,0.0001336,0.0000385,
2,9,2036,2045,0.0001377,0.0000424,
2,10,2036,2046,0.0001465,0.0000485,
2,11,2036,2047,0.0001596,0.0000569,
2,12,2036,2048,0.0001783,0.0000682,
2,13,2036,2049,0.0002061,0.0000844,
2,14,2036,2050,0.0002415,0.0001047,
2,15,2036,2051,0.0002756,0.0001226,
2,16,2036,2052,0.0003003,0.0001317,
2,17,2036,2053,0.0003175,0.0001328,
2,18,2036,2054,0.0003342,0.0001328,
2,19,2036,2055,0.0003539,0.0001359,
2,20,2036,2056,0.0003732,0.0001397,
2,21,2036,2057,0.0003859,0.0001389,
2,22,2036,2058,0.0003897,0.0001318,
2,23,2036,2059,0.0003908,0.0001232,
2,24,2036,2060,0.0003983,0.0001197,
2,25,2036,2061,0.0004147,0.0001219,
2,26,2036,2062,0.0004348,0.0001263,
2,27,2036,2063,0.0004528,0.0001287,
2,28,2036,2064,0.0004684,0.0001309,
2,29,2036,2065,0.0004856,0.0001330,
2,30,2036,2066,0.0005091,0.0001369,
2,31,2036,2067,0.0005408,0.0001428,
2,32,2036,2068,0.0005796,0.0001498,
2,33,2036,2069,0.0006220,0.0001560,
2,34,2036,2070,0.0006665,0.0001610,
2,35,2036,2071,0.0007153,0.0001657,
2,36,2036,2072,0.0007710,0.0001748,
2,37,2036,2073,0.0008314,0.0001844,
2,38,2036,2074,0.0008908,0.0001954,
2,39,2036,2075,0.0009481,0.0002087,
2,40,2036,2076,0.0010090,0.0002243,
2,41,2036,2077,0.0010784,0.0002416,
2,42,2036,2078,0.0011559,0.0002600,
2,43,2036,2079,0.0012427,0.0002834,
2,44,2036,2080,0.0013435,0.0003169,
2,45,2036,2081,0.0014588,0.0003553,
2,46,2036,2082,0.0015840,0.0003969,
2,47,2036,2083,0.0017152,0.0004334,
2,48,2036,2084,0.0018531,0.0004676,
2,49,2036,2085,0.0020059,0.0005026,
2,50,2036,2086,0.0021845,0.0005370,
2,51,2036,2087,0.0023896,0.0005704,
2,52,2036,2088,0.0026115,0.0006033,
2,53,2036,2089,0.0028474,0.0006412,
2,54,2036,2090,0.0031082,0.0006955,
2,55,2036,2091,0.0034035,0.0007600,
2,56,2036,2092,0.0037277,0.0008273,
2,57,2036,2093,0.0040692,0.0008829,
2,58,2036,2094,0.0044295,0.0009326,
2,59,2036,2095,0.0048296,0.0009916,
2,60,2036,2096,0.0052973,0.0010740,
2,61,2036,2097,0.0058480,0.0011838,
2,62,2036,2098,0.0064757,0.0013192,
2,63,2036,2099,0.0071641,0.0014780,
2,64,2036,2100,0.0078986,0.0016469,
2,65,2036,2101,0.0086645,0.0017983,
2,66,2036,2102,0.0094558,0.0019318,
2,67,2036,2103,0.0103010,0.0020686,
2,68,2036,2104,0.0112531,0.0022340,
2,69,2036,2105,0.0123584,0.0024387,
2,70,2036,2106,0.0136702,0.0027068,
2,71,2036,2107,0.0152518,0.0030951,
2,72,2036,2108,0.0170987,0.0036134,
2,73,2036,2109,0.0190837,0.0041756,
2,74,2036,2110,0.0210750,0.0046968,
2,75,2036,2111,0.0231062,0.0051895,
2,76,2036,2112,0.0253497,0.0057750,
2,77,2036,2113,0.0279666,0.0065695,
2,78,2036,2114,0.0310443,0.0076336,
2,79,2036,2115,0.0345982,0.0089711,
2,80,2036,2116,0.0395295,0.0114423,
2,81,2036,2117,0.0438328,0.0131740,
2,82,2036,2118,0.0485928,0.0151660,
2,83,2036,2119,0.0538556,0.0174368,
2,84,2036,2120,0.0596709,0.0200039,
2,85,2036,2121,0.0660929,0.0229486,
2,86,2036,2122,0.0731799,0.0263707,
2,87,2036,2123,0.0809950,0.0303297,
2,88,2036,2124,0.0896059,0.0348487,
2,89,2036,2125,0.0990850,0.0399640,
2,90,2036,2126,0.1095094,0.0458138,
2,91,2036,2127,0.1209607,0.0525634,
2,92,2036,2128,0.1335249,0.0603543,
2,93,2036,2129,0.1472918,0.0692969,
2,94,2036,2130,0.1623547,0.0795244,
2,95,2036,2131,0.1788093,0.0912458,
2,96,2036,2132,0.1967531,0.1047166,
2,97,2036,2133,0.2162837,0.1201814,
2,98,2036,2134,0.2374976,0.1378393,
2,99,2036,2135,0.2604884,0.1579226,
2,100,2036,2136,0.2853445,0.1807619,
2,101,2036,2137,0.3121468,0.2067285,
2,102,2036,2138,0.3409660,0.2361533,
2,103,2036,2139,0.3718598,0.2692859,
2,104,2036,2140,0.4048696,0.3063897,
2,105,2036,2141,0.4400178,0.3477918,
2,106,2036,2142,0.4773042,0.3937843,
2,107,2036,2143,0.5167037,0.4445293,
2,108,2036,2144,0.5581634,0.5000367,
2,109,2036,2145,0.6016004,0.5602466,
2,110,2036,2146,0.6469012,0.6250218,
2,111,2036,2147,0.6939204,0.6940436,
2,112,2036,2148,0.7424819,0.7667857,
2,113,2036,2149,0.7923800,0.8425900,
2,114,2036,2150,0.8433824,0.9207070,
2,0,2037,2037,0.0077997,0.0027970,
2,1,2037,2038,0.0005341,0.0001043,
2,2,2037,2039,0.0002805,0.0000567,
2,3,2037,2040,0.0001960,0.0000416,
2,4,2037,2041,0.0001520,0.0000321,
2,5,2037,2042,0.0001465,0.0000336,
2,6,2037,2043,0.0001399,0.0000342,
2,7,2037,2044,0.0001348,0.0000350,
2,8,2037,2045,0.0001336,0.0000369,
2,9,2037,2046,0.0001377,0.0000408,
2,10,2037,2047,0.0001465,0.0000470,
2,11,2037,2048,0.0001596,0.0000553,
2,12,2037,2049,0.0001783,0.0000665,
2,13,2037,2050,0.0002061,0.0000823,
2,14,2037,2051,0.0002415,0.0001022,
2,15,2037,2052,0.0002756,0.0001201,
2,16,2037,2053,0.0003003,0.0001292,
2,17,2037,2054,0.0003175,0.0001300,
2,18,2037,2055,0.0003342,0.0001297,
2,19,2037,2056,0.0003539,0.0001326,
2,20,2037,2057,0.0003732,0.0001365,
2,21,2037,2058,0.0003859,0.0001359,
2,22,2037,2059,0.0003897,0.0001288,
2,23,2037,2060,0.0003908,0.0001200,
2,24,2037,2061,0.0003983,0.0001165,
2,25,2037,2062,0.0004147,0.0001188,
2,26,2037,2063,0.0004348,0.0001234,
2,27,2037,2064,0.0004528,0.0001256,
2,28,2037,2065,0.0004684,0.0001275,
2,29,2037,2066,0.0004856,0.0001295,
2,30,2037,2067,0.0005091,0.0001335,
2,31,2037,2068,0.0005408,0.0001396,
2,32,2037,2069,0.0005796,0.0001463,
2,33,2037,2070,0.0006220,0.0001520,
2,34,2037,2071,0.0006665,0.0001568,
2,35,2037,2072,0.0007153,0.0001615,
2,36,2037,2073,0.0007710,0.0001708,
2,37,2037,2074,0.0008314,0.0001800,
2,38,2037,2075,0.0008908,0.0001905,
2,39,2037,2076,0.0009481,0.0002033,
2,40,2037,2077,0.0010090,0.0002190,
2,41,2037,2078,0.0010784,0.0002364,
2,42,2037,2079,0.0011559,0.0002544,
2,43,2037,2080,0.0012427,0.0002769,
2,44,2037,2081,0.0013435,0.0003098,
2,45,2037,2082,0.0014588,0.0003480,
2,46,2037,2083,0.0015840,0.0003896,
2,47,2037,2084,0.0017152,0.0004254,
2,48,2037,2085,0.0018531,0.0004583,
2,49,2037,2086,0.0020059,0.0004925,
2,50,2037,2087,0.0021845,0.0005269,
2,51,2037,2088,0.0023896,0.0005603,
2,52,2037,2089,0.0026115,0.0005922,
2,53,2037,2090,0.0028474,0.0006283,
2,54,2037,2091,0.0031082,0.0006813,
2,55,2037,2092,0.0034035,0.0007456,
2,56,2037,2093,0.0037277,0.0008128,
2,57,2037,2094,0.0040692,0.0008669,
2,58,2037,2095,0.0044295,0.0009141,
2,59,2037,2096,0.0048296,0.0009714,
2,60,2037,2097,0.0052973,0.0010535,
2,61,2037,2098,0.0058480,0.0011631,
2,62,2037,2099,0.0064757,0.0012957,
2,63,2037,2100,0.0071641,0.0014499,
2,64,2037,2101,0.0078986,0.0016155,
2,65,2037,2102,0.0086645,0.0017662,
2,66,2037,2103,0.0094558,0.0019001,
2,67,2037,2104,0.0103010,0.0020340,
2,68,2037,2105,0.0112531,0.0021935,
2,69,2037,2106,0.0123584,0.0023939,
2,70,2037,2107,0.0136702,0.0026604,
2,71,2037,2108,0.0152518,0.0030470,
2,72,2037,2109,0.0170987,0.0035575,
2,73,2037,2110,0.0190837,0.0041073,
2,74,2037,2111,0.0210750,0.0046199,
2,75,2037,2112,0.0231062,0.0051107,
2,76,2037,2113,0.0253497,0.0056953,
2,77,2037,2114,0.0279666,0.0064795,
2,78,2037,2115,0.0310443,0.0075243,
2,79,2037,2116,0.0345982,0.0088458,
2,80,2037,2117,0.0395295,0.0113051,
2,81,2037,2118,0.0438328,0.0130328,
2,82,2037,2119,0.0485928,0.0150048,
2,83,2037,2120,0.0538556,0.0172425,
2,84,2037,2121,0.0596709,0.0197847,
2,85,2037,2122,0.0660929,0.0227212,
2,86,2037,2123,0.0731799,0.0261383,
2,87,2037,2124,0.0809950,0.0300670,
2,88,2037,2125,0.0896059,0.0345345,
2,89,2037,2126,0.0990850,0.0396122,
2,90,2037,2127,0.1095094,0.0454523,
2,91,2037,2128,0.1209607,0.0521992,
2,92,2037,2129,0.1335249,0.0599497,
2,93,2037,2130,0.1472918,0.0688203,
2,94,2037,2131,0.1623547,0.0789982,
2,95,2037,2132,0.1788093,0.0907136,
2,96,2037,2133,0.1967531,0.1041890,
2,97,2037,2134,0.2162837,0.1196056,
2,98,2037,2135,0.2374976,0.1371773,
2,99,2037,2136,0.2604884,0.1572134,
2,100,2037,2137,0.2853445,0.1800693,
2,101,2037,2138,0.3121468,0.2060700,
2,102,2037,2139,0.3409660,0.2354694,
2,103,2037,2140,0.3718598,0.2685445,
2,104,2037,2141,0.4048696,0.3056502,
2,105,2037,2142,0.4400178,0.3471308,
2,106,2037,2143,0.4773042,0.3932240,
2,107,2037,2144,0.5167037,0.4440290,
2,108,2037,2145,0.5581634,0.4995942,
2,109,2037,2146,0.6016004,0.5599220,
2,110,2037,2147,0.6469012,0.6248592,
2,111,2037,2148,0.6939204,0.6940445,
2,112,2037,2149,0.7424819,0.7669588,
2,113,2037,2150,0.7923800,0.8429784,
2,0,2038,2038,0.0077997,0.0026902,
2,1,2038,2039,0.0005341,0.0000981,
2,2,2038,2040,0.0002805,0.0000532,
2,3,2038,2041,0.0001960,0.0000391,
2,4,2038,2042,0.0001520,0.0000304,
2,5,2038,2043,0.0001465,0.0000321,
2,6,2038,2044,0.0001399,0.0000327,
2,7,2038,2045,0.0001348,0.0000335,
2,8,2038,2046,0.0001336,0.0000354,
2,9,2038,2047,0.0001377,0.0000394,
2,10,2038,2048,0.0001465,0.0000456,
2,11,2038,2049,0.0001596,0.0000538,
2,12,2038,2050,0.0001783,0.0000646,
2,13,2038,2051,0.0002061,0.0000802,
2,14,2038,2052,0.0002415,0.0001000,
2,15,2038,2053,0.0002756,0.0001177,
2,16,2038,2054,0.0003003,0.0001266,
2,17,2038,2055,0.0003175,0.0001271,
2,18,2038,2056,0.0003342,0.0001266,
2,19,2038,2057,0.0003539,0.0001296,
2,20,2038,2058,0.0003732,0.0001336,
2,21,2038,2059,0.0003859,0.0001329,
2,22,2038,2060,0.0003897,0.0001256,
2,23,2038,2061,0.0003908,0.0001169,
2,24,2038,2062,0.0003983,0.0001135,
2,25,2038,2063,0.0004147,0.0001160,
2,26,2038,2064,0.0004348,0.0001205,
2,27,2038,2065,0.0004528,0.0001223,
2,28,2038,2066,0.0004684,0.0001241,
2,29,2038,2067,0.0004856,0.0001263,
2,30,2038,2068,0.0005091,0.0001305,
2,31,2038,2069,0.0005408,0.0001363,
2,32,2038,2070,0.0005796,0.0001426,
2,33,2038,2071,0.0006220,0.0001481,
2,34,2038,2072,0.0006665,0.0001529,
2,35,2038,2073,0.0007153,0.0001578,
2,36,2038,2074,0.0007710,0.0001667,
2,37,2038,2075,0.0008314,0.0001754,
2,38,2038,2076,0.0008908,0.0001855,
2,39,2038,2077,0.0009481,0.0001984,
2,40,2038,2078,0.0010090,0.0002143,
2,41,2038,2079,0.0010784,0.0002312,
2,42,2038,2080,0.0011559,0.0002485,
2,43,2038,2081,0.0012427,0.0002704,
2,44,2038,2082,0.0013435,0.0003032,
2,45,2038,2083,0.0014588,0.0003414,
2,46,2038,2084,0.0015840,0.0003823,
2,47,2038,2085,0.0017152,0.0004169,
2,48,2038,2086,0.0018531,0.0004490,
2,49,2038,2087,0.0020059,0.0004832,
2,50,2038,2088,0.0021845,0.0005176,
2,51,2038,2089,0.0023896,0.0005501,
2,52,2038,2090,0.0026115,0.0005804,
2,53,2038,2091,0.0028474,0.0006154,
2,54,2038,2092,0.0031082,0.0006682,
2,55,2038,2093,0.0034035,0.0007324,
2,56,2038,2094,0.0037277,0.0007982,
2,57,2038,2095,0.0040692,0.0008499,
2,58,2038,2096,0.0044295,0.0008955,
2,59,2038,2097,0.0048296,0.0009527,
2,60,2038,2098,0.0052973,0.0010348,
2,61,2038,2099,0.0058480,0.0011421,
2,62,2038,2100,0.0064757,0.0012706,
2,63,2038,2101,0.0071641,0.0014217,
2,64,2038,2102,0.0078986,0.0015864,
2,65,2038,2103,0.0086645,0.0017372,
2,66,2038,2104,0.0094558,0.0018683,
2,67,2038,2105,0.0103010,0.0019971,
2,68,2038,2106,0.0112531,0.0021529,
2,69,2038,2107,0.0123584,0.0023523,
2,70,2038,2108,0.0136702,0.0026180,
2,71,2038,2109,0.0152518,0.0029982,
2,72,2038,2110,0.0170987,0.0034974,
2,73,2038,2111,0.0190837,0.0040386,
2,74,2038,2112,0.0210750,0.0045487,
2,75,2038,2113,0.0231062,0.0050389,
2,76,2038,2114,0.0253497,0.0056149,
2,77,2038,2115,0.0279666,0.0063829,
2,78,2038,2116,0.0310443,0.0074141,
2,79,2038,2117,0.0345982,0.0087293,
2,80,2038,2118,0.0395295,0.0111790,
2,81,2038,2119,0.0438328,0.0128886,
2,82,2038,2120,0.0485928,0.0148308,
2,83,2038,2121,0.0538556,0.0170458,
2,84,2038,2122,0.0596709,0.0195804,
2,85,2038,2123,0.0660929,0.0225120,
2,86,2038,2124,0.0731799,0.0259012,
2,87,2038,2125,0.0809950,0.0297829,
2,88,2038,2126,0.0896059,0.0342158,
2,89,2038,2127,0.0990850,0.0392838,
2,90,2038,2128,0.1095094,0.0451204,
2,91,2038,2129,0.1209607,0.0518294,
2,92,2038,2130,0.1335249,0.0595125,
2,93,2038,2131,0.1472918,0.0683356,
2,94,2038,2132,0.1623547,0.0785055,
2,95,2038,2133,0.1788093,0.0902225,
2,96,2038,2134,0.1967531,0.1036497,
2,97,2038,2135,0.2162837,0.1189811,
2,98,2038,2136,0.2374976,0.1365025,
2,99,2038,2137,0.2604884,0.1565479,
2,100,2038,2138,0.2853445,0.1794290,
2,101,2038,2139,0.3121468,0.2053957,
2,102,2038,2140,0.3409660,0.2347260,
2,103,2038,2141,0.3718598,0.2677872,
2,104,2038,2142,0.4048696,0.3049552,
2,105,2038,2143,0.4400178,0.3465208,
2,106,2038,2144,0.4773042,0.3926525,
2,107,2038,2145,0.5167037,0.4434853,
2,108,2038,2146,0.5581634,0.4991413,
2,109,2038,2147,0.6016004,0.5596161,
2,110,2038,2148,0.6469012,0.6247081,
2,111,2038,2149,0.6939204,0.6940453,
2,112,2038,2150,0.7424819,0.7671476,
2,0,2039,2039,0.0077997,0.0025850,
2,1,2039,2040,0.0005341,0.0000918,
2,2,2039,2041,0.0002805,0.0000499,
2,3,2039,2042,0.0001960,0.0000370,
2,4,2039,2043,0.0001520,0.0000289,
2,5,2039,2044,0.0001465,0.0000306,
2,6,2039,2045,0.0001399,0.0000312,
2,7,2039,2046,0.0001348,0.0000320,
2,8,2039,2047,0.0001336,0.0000341,
2,9,2039,2048,0.0001377,0.0000381,
2,10,2039,2049,0.0001465,0.0000442,
2,11,2039,2050,0.0001596,0.0000521,
2,12,2039,2051,0.0001783,0.0000628,
2,13,2039,2052,0.0002061,0.0000782,
2,14,2039,2053,0.0002415,0.0000979,
2,15,2039,2054,0.0002756,0.0001153,
2,16,2039,2055,0.0003003,0.0001238,
2,17,2039,2056,0.0003175,0.0001242,
2,18,2039,2057,0.0003342,0.0001238,
2,19,2039,2058,0.0003539,0.0001269,
2,20,2039,2059,0.0003732,0.0001307,
2,21,2039,2060,0.0003859,0.0001297,
2,22,2039,2061,0.0003897,0.0001224,
2,23,2039,2062,0.0003908,0.0001140,
2,24,2039,2063,0.0003983,0.0001108,
2,25,2039,2064,0.0004147,0.0001132,
2,26,2039,2065,0.0004348,0.0001173,
2,27,2039,2066,0.0004528,0.0001190,
2,28,2039,2067,0.0004684,0.0001210,
2,29,2039,2068,0.0004856,0.0001234,
2,30,2039,2069,0.0005091,0.0001274,
2,31,2039,2070,0.0005408,0.0001329,
2,32,2039,2071,0.0005796,0.0001390,
2,33,2039,2072,0.0006220,0.0001445,
2,34,2039,2073,0.0006665,0.0001494,
2,35,2039,2074,0.0007153,0.0001541,
2,36,2039,2075,0.0007710,0.0001625,
2,37,2039,2076,0.0008314,0.0001708,
2,38,2039,2077,0.0008908,0.0001809,
2,39,2039,2078,0.0009481,0.0001940,
2,40,2039,2079,0.0010090,0.0002095,
2,41,2039,2080,0.0010784,0.0002257,
2,42,2039,2081,0.0011559,0.0002425,
2,43,2039,2082,0.0012427,0.0002645,
2,44,2039,2083,0.0013435,0.0002972,
2,45,2039,2084,0.0014588,0.0003348,
2,46,2039,2085,0.0015840,0.0003745,
2,47,2039,2086,0.0017152,0.0004083,
2,48,2039,2087,0.0018531,0.0004405,
2,49,2039,2088,0.0020059,0.0004747,
2,50,2039,2089,0.0021845,0.0005083,
2,51,2039,2090,0.0023896,0.0005392,
2,52,2039,2091,0.0026115,0.0005685,
2,53,2039,2092,0.0028474,0.0006034,
2,54,2039,2093,0.0031082,0.0006563,
2,55,2039,2094,0.0034035,0.0007191,
2,56,2039,2095,0.0037277,0.0007825,
2,57,2039,2096,0.0040692,0.0008327,
2,58,2039,2097,0.0044295,0.0008783,
2,59,2039,2098,0.0048296,0.0009357,
2,60,2039,2099,0.0052973,0.0010159,
2,61,2039,2100,0.0058480,0.0011196,
2,62,2039,2101,0.0064757,0.0012454,
2,63,2039,2102,0.0071641,0.0013957,
2,64,2039,2103,0.0078986,0.0015601,
2,65,2039,2104,0.0086645,0.0017081,
2,66,2039,2105,0.0094558,0.0018344,
2,67,2039,2106,0.0103010,0.0019599,
2,68,2039,2107,0.0112531,0.0021153,
2,69,2039,2108,0.0123584,0.0023143,
2,70,2039,2109,0.0136702,0.0025750,
2,71,2039,2110,0.0152518,0.0029457,
2,72,2039,2111,0.0170987,0.0034369,
2,73,2039,2112,0.0190837,0.0039748,
2,74,2039,2113,0.0210750,0.0044837,
2,75,2039,2114,0.0231062,0.0049664,
2,76,2039,2115,0.0253497,0.0055287,
2,77,2039,2116,0.0279666,0.0062855,
2,78,2039,2117,0.0310443,0.0073116,
2,79,2039,2118,0.0345982,0.0086223,
2,80,2039,2119,0.0395295,0.0110503,
2,81,2039,2120,0.0438328,0.0127330,
2,82,2039,2121,0.0485928,0.0146547,
2,83,2039,2122,0.0538556,0.0168625,
2,84,2039,2123,0.0596709,0.0193924,
2,85,2039,2124,0.0660929,0.0222986,
2,86,2039,2125,0.0731799,0.0256450,
2,87,2039,2126,0.0809950,0.0294948,
2,88,2039,2127,0.0896059,0.0339182,
2,89,2039,2128,0.0990850,0.0389824,
2,90,2039,2129,0.1095094,0.0447837,
2,91,2039,2130,0.1209607,0.0514299,
2,92,2039,2131,0.1335249,0.0590680,
2,93,2039,2132,0.1472918,0.0678820,
2,94,2039,2133,0.1623547,0.0780511,
2,95,2039,2134,0.1788093,0.0897208,
2,96,2039,2135,0.1967531,0.1030650,
2,97,2039,2136,0.2162837,0.1183447,
2,98,2039,2137,0.2374976,0.1358695,
2,99,2039,2138,0.2604884,0.1559329,
2,100,2039,2139,0.2853445,0.1787737,
2,101,2039,2140,0.3121468,0.2046629,
2,102,2039,2141,0.3409660,0.2339669,
2,103,2039,2142,0.3718598,0.2670759,
2,104,2039,2143,0.4048696,0.3043141,
2,105,2039,2144,0.4400178,0.3458989,
2,106,2039,2145,0.4773042,0.3920316,
2,107,2039,2146,0.5167037,0.4429291,
2,108,2039,2147,0.5581634,0.4987147,
2,109,2039,2148,0.6016004,0.5593320,
2,110,2039,2149,0.6469012,0.6245526,
2,111,2039,2150,0.6939204,0.6940463,
2,0,2040,2040,0.0077997,0.0024750,
2,1,2040,2041,0.0005341,0.0000857,
2,2,2040,2042,0.0002805,0.0000470,
2,3,2040,2043,0.0001960,0.0000351,
2,4,2040,2044,0.0001520,0.0000275,
2,5,2040,2045,0.0001465,0.0000291,
2,6,2040,2046,0.0001399,0.0000298,
2,7,2040,2047,0.0001348,0.0000306,
2,8,2040,2048,0.0001336,0.0000328,
2,9,2040,2049,0.0001377,0.0000368,
2,10,2040,2050,0.0001465,0.0000427,
2,11,2040,2051,0.0001596,0.0000505,
2,12,2040,2052,0.0001783,0.0000611,
2,13,2040,2053,0.0002061,0.0000764,
2,14,2040,2054,0.0002415,0.0000958,
2,15,2040,2055,0.0002756,0.0001128,
2,16,2040,2056,0.0003003,0.0001211,
2,17,2040,2057,0.0003175,0.0001215,
2,18,2040,2058,0.0003342,0.0001212,
2,19,2040,2059,0.0003539,0.0001241,
2,20,2040,2060,0.0003732,0.0001277,
2,21,2040,2061,0.0003859,0.0001265,
2,22,2040,2062,0.0003897,0.0001195,
2,23,2040,2063,0.0003908,0.0001113,
2,24,2040,2064,0.0003983,0.0001081,
2,25,2040,2065,0.0004147,0.0001102,
2,26,2040,2066,0.0004348,0.0001142,
2,27,2040,2067,0.0004528,0.0001161,
2,28,2040,2068,0.0004684,0.0001182,
2,29,2040,2069,0.0004856,0.0001205,
2,30,2040,2070,0.0005091,0.0001242,
2,31,2040,2071,0.0005408,0.0001294,
2,32,2040,2072,0.0005796,0.0001356,
2,33,2040,2073,0.0006220,0.0001412,
2,34,2040,2074,0.0006665,0.0001459,
2,35,2040,2075,0.0007153,0.0001501,
2,36,2040,2076,0.0007710,0.0001582,
2,37,2040,2077,0.0008314,0.0001666,
2,38,2040,2078,0.0008908,0.0001768,
2,39,2040,2079,0.0009481,0.0001896,
2,40,2040,2080,0.0010090,0.0002044,
2,41,2040,2081,0.0010784,0.0002202,
2,42,2040,2082,0.0011559,0.0002371,
2,43,2040,2083,0.0012427,0.0002591,
2,44,2040,2084,0.0013435,0.0002912,
2,45,2040,2085,0.0014588,0.0003277,
2,46,2040,2086,0.0015840,0.0003667,
2,47,2040,2087,0.0017152,0.0004004,
2,48,2040,2088,0.0018531,0.0004327,
2,49,2040,2089,0.0020059,0.0004661,
2,50,2040,2090,0.0021845,0.0004983,
2,51,2040,2091,0.0023896,0.0005283,
2,52,2040,2092,0.0026115,0.0005575,
2,53,2040,2093,0.0028474,0.0005925,
2,54,2040,2094,0.0031082,0.0006442,
2,55,2040,2095,0.0034035,0.0007049,
2,56,2040,2096,0.0037277,0.0007668,
2,57,2040,2097,0.0040692,0.0008169,
2,58,2040,2098,0.0044295,0.0008627,
2,59,2040,2099,0.0048296,0.0009186,
2,60,2040,2100,0.0052973,0.0009957,
2,61,2040,2101,0.0058480,0.0010971,
2,62,2040,2102,0.0064757,0.0012222,
2,63,2040,2103,0.0071641,0.0013721,
2,64,2040,2104,0.0078986,0.0015337,
2,65,2040,2105,0.0086645,0.0016771,
2,66,2040,2106,0.0094558,0.0018003,
2,67,2040,2107,0.0103010,0.0019256,
2,68,2040,2108,0.0112531,0.0020808,
2,69,2040,2109,0.0123584,0.0022758,
2,70,2040,2110,0.0136702,0.0025288,
2,71,2040,2111,0.0152518,0.0028930,
2,72,2040,2112,0.0170987,0.0033809,
2,73,2040,2113,0.0190837,0.0039168,
2,74,2040,2114,0.0210750,0.0044181,
2,75,2040,2115,0.0231062,0.0048886,
2,76,2040,2116,0.0253497,0.0054418,
2,77,2040,2117,0.0279666,0.0061950,
2,78,2040,2118,0.0310443,0.0072176,
2,79,2040,2119,0.0345982,0.0085132,
2,80,2040,2120,0.0395295,0.0109115,
2,81,2040,2121,0.0438328,0.0125757,
2,82,2040,2122,0.0485928,0.0144906,
2,83,2040,2123,0.0538556,0.0166940,
2,84,2040,2124,0.0596709,0.0192008,
2,85,2040,2125,0.0660929,0.0220681,
2,86,2040,2126,0.0731799,0.0253853,
2,87,2040,2127,0.0809950,0.0292260,
2,88,2040,2128,0.0896059,0.0336453,
2,89,2040,2129,0.0990850,0.0386767,
2,90,2040,2130,0.1095094,0.0444200,
2,91,2040,2131,0.1209607,0.0510240,
2,92,2040,2132,0.1335249,0.0586521,
2,93,2040,2133,0.1472918,0.0674638,
2,94,2040,2134,0.1623547,0.0775872,
2,95,2040,2135,0.1788093,0.0891771,
2,96,2040,2136,0.1967531,0.1024696,
2,97,2040,2137,0.2162837,0.1177481,
2,98,2040,2138,0.2374976,0.1352849,
2,99,2040,2139,0.2604884,0.1553037,
2,100,2040,2140,0.2853445,0.1780619,
2,101,2040,2141,0.3121468,0.2039151,
2,102,2040,2142,0.3409660,0.2332541,
2,103,2040,2143,0.3718598,0.2664199,
2,104,2040,2144,0.4048696,0.3036607,
2,105,2040,2145,0.4400178,0.3452234,
2,106,2040,2146,0.4773042,0.3913966,
2,107,2040,2147,0.5167037,0.4424053,
2,108,2040,2148,0.5581634,0.4983185,
2,109,2040,2149,0.6016004,0.5590395,
2,110,2040,2150,0.6469012,0.6243829,
2,0,2041,2041,0.0077997,0.0023672,
2,1,2041,2042,0.0005341,0.0000804,
2,2,2041,2043,0.0002805,0.0000444,
2,3,2041,2044,0.0001960,0.0000333,
2,4,2041,2045,0.0001520,0.0000260,
2,5,2041,2046,0.0001465,0.0000276,
2,6,2041,2047,0.0001399,0.0000284,
2,7,2041,2048,0.0001348,0.0000295,
2,8,2041,2049,0.0001336,0.0000316,
2,9,2041,2050,0.0001377,0.0000355,
2,10,2041,2051,0.0001465,0.0000412,
2,11,2041,2052,0.0001596,0.0000490,
2,12,2041,2053,0.0001783,0.0000596,
2,13,2041,2054,0.0002061,0.0000746,
2,14,2041,2055,0.0002415,0.0000936,
2,15,2041,2056,0.0002756,0.0001102,
2,16,2041,2057,0.0003003,0.0001185,
2,17,2041,2058,0.0003175,0.0001190,
2,18,2041,2059,0.0003342,0.0001186,
2,19,2041,2060,0.0003539,0.0001212,
2,20,2041,2061,0.0003732,0.0001246,
2,21,2041,2062,0.0003859,0.0001236,
2,22,2041,2063,0.0003897,0.0001168,
2,23,2041,2064,0.0003908,0.0001087,
2,24,2041,2065,0.0003983,0.0001053,
2,25,2041,2066,0.0004147,0.0001073,
2,26,2041,2067,0.0004348,0.0001113,
2,27,2041,2068,0.0004528,0.0001133,
2,28,2041,2069,0.0004684,0.0001154,
2,29,2041,2070,0.0004856,0.0001174,
2,30,2041,2071,0.0005091,0.0001210,
2,31,2041,2072,0.0005408,0.0001263,
2,32,2041,2073,0.0005796,0.0001325,
2,33,2041,2074,0.0006220,0.0001379,
2,34,2041,2075,0.0006665,0.0001422,
2,35,2041,2076,0.0007153,0.0001461,
2,36,2041,2077,0.0007710,0.0001543,
2,37,2041,2078,0.0008314,0.0001627,
2,38,2041,2079,0.0008908,0.0001727,
2,39,2041,2080,0.0009481,0.0001848,
2,40,2041,2081,0.0010090,0.0001993,
2,41,2041,2082,0.0010784,0.0002152,
2,42,2041,2083,0.0011559,0.0002321,
2,43,2041,2084,0.0012427,0.0002536,
2,44,2041,2085,0.0013435,0.0002848,
2,45,2041,2086,0.0014588,0.0003206,
2,46,2041,2087,0.0015840,0.0003594,
2,47,2041,2088,0.0017152,0.0003932,
2,48,2041,2089,0.0018531,0.0004248,
2,49,2041,2090,0.0020059,0.0004570,
2,50,2041,2091,0.0021845,0.0004883,
2,51,2041,2092,0.0023896,0.0005182,
2,52,2041,2093,0.0026115,0.0005475,
2,53,2041,2094,0.0028474,0.0005815,
2,54,2041,2095,0.0031082,0.0006313,
2,55,2041,2096,0.0034035,0.0006906,
2,56,2041,2097,0.0037277,0.0007523,
2,57,2041,2098,0.0040692,0.0008025,
2,58,2041,2099,0.0044295,0.0008470,
2,59,2041,2100,0.0048296,0.0009002,
2,60,2041,2101,0.0052973,0.0009755,
2,61,2041,2102,0.0058480,0.0010763,
2,62,2041,2103,0.0064757,0.0012011,
2,63,2041,2104,0.0071641,0.0013485,
2,64,2041,2105,0.0078986,0.0015056,
2,65,2041,2106,0.0086645,0.0016459,
2,66,2041,2107,0.0094558,0.0017688,
2,67,2041,2108,0.0103010,0.0018941,
2,68,2041,2109,0.0112531,0.0020459,
2,69,2041,2110,0.0123584,0.0022344,
2,70,2041,2111,0.0136702,0.0024823,
2,71,2041,2112,0.0152518,0.0028442,
2,72,2041,2113,0.0170987,0.0033299,
2,73,2041,2114,0.0190837,0.0038582,
2,74,2041,2115,0.0210750,0.0043479,
2,75,2041,2116,0.0231062,0.0048102,
2,76,2041,2117,0.0253497,0.0053611,
2,77,2041,2118,0.0279666,0.0061120,
2,78,2041,2119,0.0310443,0.0071218,
2,79,2041,2120,0.0345982,0.0083957,
2,80,2041,2121,0.0395295,0.0107712,
2,81,2041,2122,0.0438328,0.0124291,
2,82,2041,2123,0.0485928,0.0143398,
2,83,2041,2124,0.0538556,0.0165222,
2,84,2041,2125,0.0596709,0.0189939,
2,85,2041,2126,0.0660929,0.0218345,
2,86,2041,2127,0.0731799,0.0251431,
2,87,2041,2128,0.0809950,0.0289795,
2,88,2041,2129,0.0896059,0.0333686,
2,89,2041,2130,0.0990850,0.0383467,
2,90,2041,2131,0.1095094,0.0440506,
2,91,2041,2132,0.1209607,0.0506444,
2,92,2041,2133,0.1335249,0.0582690,
2,93,2041,2134,0.1472918,0.0670369,
2,94,2041,2135,0.1623547,0.0770845,
2,95,2041,2136,0.1788093,0.0886236,
2,96,2041,2137,0.1967531,0.1019115,
2,97,2041,2138,0.2162837,0.1171973,
2,98,2041,2139,0.2374976,0.1346870,
2,99,2041,2140,0.2604884,0.1546206,
2,100,2041,2141,0.2853445,0.1773358,
2,101,2041,2142,0.3121468,0.2032132,
2,102,2041,2143,0.3409660,0.2325972,
2,103,2041,2144,0.3718598,0.2657516,
2,104,2041,2145,0.4048696,0.3029512,
2,105,2041,2146,0.4400178,0.3445329,
2,106,2041,2147,0.4773042,0.3907988,
2,107,2041,2148,0.5167037,0.4419189,
2,108,2041,2149,0.5581634,0.4979107,
2,109,2041,2150,0.6016004,0.5587204,
2,0,2042,2042,0.0077997,0.0022701,
2,1,2042,2043,0.0005341,0.0000758,
2,2,2042,2044,0.0002805,0.0000420,
2,3,2042,2045,0.0001960,0.0000314,
2,4,2042,2046,0.0001520,0.0000246,
2,5,2042,2047,0.0001465,0.0000263,
2,6,2042,2048,0.0001399,0.0000272,
2,7,2042,2049,0.0001348,0.0000283,
2,8,2042,2050,0.0001336,0.0000304,
2,9,2042,2051,0.0001377,0.0000341,
2,10,2042,2052,0.0001465,0.0000399,
2,11,2042,2053,0.0001596,0.0000477,
2,12,2042,2054,0.0001783,0.0000580,
2,13,2042,2055,0.0002061,0.0000727,
2,14,2042,2056,0.0002415,0.0000913,
2,15,2042,2057,0.0002756,0.0001079,
2,16,2042,2058,0.0003003,0.0001162,
2,17,2042,2059,0.0003175,0.0001166,
2,18,2042,2060,0.0003342,0.0001159,
2,19,2042,2061,0.0003539,0.0001183,
2,20,2042,2062,0.0003732,0.0001218,
2,21,2042,2063,0.0003859,0.0001210,
2,22,2042,2064,0.0003897,0.0001141,
2,23,2042,2065,0.0003908,0.0001058,
2,24,2042,2066,0.0003983,0.0001024,
2,25,2042,2067,0.0004147,0.0001045,
2,26,2042,2068,0.0004348,0.0001087,
2,27,2042,2069,0.0004528,0.0001107,
2,28,2042,2070,0.0004684,0.0001124,
2,29,2042,2071,0.0004856,0.0001143,
2,30,2042,2072,0.0005091,0.0001180,
2,31,2042,2073,0.0005408,0.0001234,
2,32,2042,2074,0.0005796,0.0001294,
2,33,2042,2075,0.0006220,0.0001344,
2,34,2042,2076,0.0006665,0.0001385,
2,35,2042,2077,0.0007153,0.0001425,
2,36,2042,2078,0.0007710,0.0001507,
2,37,2042,2079,0.0008314,0.0001589,
2,38,2042,2080,0.0008908,0.0001683,
2,39,2042,2081,0.0009481,0.0001801,
2,40,2042,2082,0.0010090,0.0001946,
2,41,2042,2083,0.0010784,0.0002106,
2,42,2042,2084,0.0011559,0.0002271,
2,43,2042,2085,0.0012427,0.0002479,
2,44,2042,2086,0.0013435,0.0002784,
2,45,2042,2087,0.0014588,0.0003141,
2,46,2042,2088,0.0015840,0.0003529,
2,47,2042,2089,0.0017152,0.0003860,
2,48,2042,2090,0.0018531,0.0004163,
2,49,2042,2091,0.0020059,0.0004478,
2,50,2042,2092,0.0021845,0.0004790,
2,51,2042,2093,0.0023896,0.0005090,
2,52,2042,2094,0.0026115,0.0005374,
2,53,2042,2095,0.0028474,0.0005698,
2,54,2042,2096,0.0031082,0.0006184,
2,55,2042,2097,0.0034035,0.0006774,
2,56,2042,2098,0.0037277,0.0007390,
2,57,2042,2099,0.0040692,0.0007879,
2,58,2042,2100,0.0044295,0.0008301,
2,59,2042,2101,0.0048296,0.0008818,
2,60,2042,2102,0.0052973,0.0009568,
2,61,2042,2103,0.0058480,0.0010575,
2,62,2042,2104,0.0064757,0.0011801,
2,63,2042,2105,0.0071641,0.0013233,
2,64,2042,2106,0.0078986,0.0014773,
2,65,2042,2107,0.0086645,0.0016170,
2,66,2042,2108,0.0094558,0.0017399,
2,67,2042,2109,0.0103010,0.0018623,
2,68,2042,2110,0.0112531,0.0020085,
2,69,2042,2111,0.0123584,0.0021928,
2,70,2042,2112,0.0136702,0.0024394,
2,71,2042,2113,0.0152518,0.0027998,
2,72,2042,2114,0.0170987,0.0032785,
2,73,2042,2115,0.0190837,0.0037955,
2,74,2042,2116,0.0210750,0.0042771,
2,75,2042,2117,0.0231062,0.0047375,
2,76,2042,2118,0.0253497,0.0052871,
2,77,2042,2119,0.0279666,0.0060275,
2,78,2042,2120,0.0310443,0.0070187,
2,79,2042,2121,0.0345982,0.0082771,
2,80,2042,2122,0.0395295,0.0106407,
2,81,2042,2123,0.0438328,0.0122945,
2,82,2042,2124,0.0485928,0.0141862,
2,83,2042,2125,0.0538556,0.0163369,
2,84,2042,2126,0.0596709,0.0187843,
2,85,2042,2127,0.0660929,0.0216168,
2,86,2042,2128,0.0731799,0.0249212,
2,87,2042,2129,0.0809950,0.0287298,
2,88,2042,2130,0.0896059,0.0330700,
2,89,2042,2131,0.0990850,0.0380116,
2,90,2042,2132,0.1095094,0.0437053,
2,91,2042,2133,0.1209607,0.0502947,
2,92,2042,2134,0.1335249,0.0578780,
2,93,2042,2135,0.1472918,0.0665746,
2,94,2042,2136,0.1623547,0.0765731,
2,95,2042,2137,0.1788093,0.0881052,
2,96,2042,2138,0.1967531,0.1013965,
2,97,2042,2139,0.2162837,0.1166342,
2,98,2042,2140,0.2374976,0.1340382,
2,99,2042,2141,0.2604884,0.1539240,
2,100,2042,2142,0.2853445,0.1766545,
2,101,2042,2143,0.3121468,0.2025665,
2,102,2042,2144,0.3409660,0.2319280,
2,103,2042,2145,0.3718598,0.2650262,
2,104,2042,2146,0.4048696,0.3022262,
2,105,2042,2147,0.4400178,0.3438830,
2,106,2042,2148,0.4773042,0.3902439,
2,107,2042,2149,0.5167037,0.4414184,
2,108,2042,2150,0.5581634,0.4974660,
2,0,2043,2043,0.0077997,0.0021839,
2,1,2043,2044,0.0005341,0.0000713,
2,2,2043,2045,0.0002805,0.0000394,
2,3,2043,2046,0.0001960,0.0000296,
2,4,2043,2047,0.0001520,0.0000233,
2,5,2043,2048,0.0001465,0.0000251,
2,6,2043,2049,0.0001399,0.0000261,
2,7,2043,2050,0.0001348,0.0000270,
2,8,2043,2051,0.0001336,0.0000291,
2,9,2043,2052,0.0001377,0.0000329,
2,10,2043,2053,0.0001465,0.0000387,
2,11,2043,2054,0.0001596,0.0000463,
2,12,2043,2055,0.0001783,0.0000564,
2,13,2043,2056,0.0002061,0.0000708,
2,14,2043,2057,0.0002415,0.0000893,
2,15,2043,2058,0.0002756,0.0001058,
2,16,2043,2059,0.0003003,0.0001139,
2,17,2043,2060,0.0003175,0.0001139,
2,18,2043,2061,0.0003342,0.0001131,
2,19,2043,2062,0.0003539,0.0001156,
2,20,2043,2063,0.0003732,0.0001192,
2,21,2043,2064,0.0003859,0.0001183,
2,22,2043,2065,0.0003897,0.0001113,
2,23,2043,2066,0.0003908,0.0001030,
2,24,2043,2067,0.0003983,0.0000998,
2,25,2043,2068,0.0004147,0.0001021,
2,26,2043,2069,0.0004348,0.0001061,
2,27,2043,2070,0.0004528,0.0001078,
2,28,2043,2071,0.0004684,0.0001095,
2,29,2043,2072,0.0004856,0.0001115,
2,30,2043,2073,0.0005091,0.0001153,
2,31,2043,2074,0.0005408,0.0001206,
2,32,2043,2075,0.0005796,0.0001262,
2,33,2043,2076,0.0006220,0.0001309,
2,34,2043,2077,0.0006665,0.0001351,
2,35,2043,2078,0.0007153,0.0001392,
2,36,2043,2079,0.0007710,0.0001472,
2,37,2043,2080,0.0008314,0.0001548,
2,38,2043,2081,0.0008908,0.0001640,
2,39,2043,2082,0.0009481,0.0001758,
2,40,2043,2083,0.0010090,0.0001904,
2,41,2043,2084,0.0010784,0.0002060,
2,42,2043,2085,0.0011559,0.0002218,
2,43,2043,2086,0.0012427,0.0002421,
2,44,2043,2087,0.0013435,0.0002725,
2,45,2043,2088,0.0014588,0.0003081,
2,46,2043,2089,0.0015840,0.0003462,
2,47,2043,2090,0.0017152,0.0003782,
2,48,2043,2091,0.0018531,0.0004079,
2,49,2043,2092,0.0020059,0.0004393,
2,50,2043,2093,0.0021845,0.0004705,
2,51,2043,2094,0.0023896,0.0004997,
2,52,2043,2095,0.0026115,0.0005266,
2,53,2043,2096,0.0028474,0.0005580,
2,54,2043,2097,0.0031082,0.0006064,
2,55,2043,2098,0.0034035,0.0006654,
2,56,2043,2099,0.0037277,0.0007257,
2,57,2043,2100,0.0040692,0.0007724,
2,58,2043,2101,0.0044295,0.0008132,
2,59,2043,2102,0.0048296,0.0008649,
2,60,2043,2103,0.0052973,0.0009399,
2,61,2043,2104,0.0058480,0.0010387,
2,62,2043,2105,0.0064757,0.0011576,
2,63,2043,2106,0.0071641,0.0012980,
2,64,2043,2107,0.0078986,0.0014512,
2,65,2043,2108,0.0086645,0.0015906,
2,66,2043,2109,0.0094558,0.0017106,
2,67,2043,2110,0.0103010,0.0018281,
2,68,2043,2111,0.0112531,0.0019708,
2,69,2043,2112,0.0123584,0.0021544,
2,70,2043,2113,0.0136702,0.0024003,
2,71,2043,2114,0.0152518,0.0027550,
2,72,2043,2115,0.0170987,0.0032235,
2,73,2043,2116,0.0190837,0.0037323,
2,74,2043,2117,0.0210750,0.0042114,
2,75,2043,2118,0.0231062,0.0046709,
2,76,2043,2119,0.0253497,0.0052118,
2,77,2043,2120,0.0279666,0.0059366,
2,78,2043,2121,0.0310443,0.0069147,
2,79,2043,2122,0.0345982,0.0081669,
2,80,2043,2123,0.0395295,0.0105208,
2,81,2043,2124,0.0438328,0.0121575,
2,82,2043,2125,0.0485928,0.0140205,
2,83,2043,2126,0.0538556,0.0161492,
2,84,2043,2127,0.0596709,0.0185890,
2,85,2043,2128,0.0660929,0.0214174,
2,86,2043,2129,0.0731799,0.0246963,
2,87,2043,2130,0.0809950,0.0284604,
2,88,2043,2131,0.0896059,0.0327670,
2,89,2043,2132,0.0990850,0.0376986,
2,90,2043,2133,0.1095094,0.0433874,
2,91,2043,2134,0.1209607,0.0499381,
2,92,2043,2135,0.1335249,0.0574548,
2,93,2043,2136,0.1472918,0.0661045,
2,94,2043,2137,0.1623547,0.0760942,
2,95,2043,2138,0.1788093,0.0876269,
2,96,2043,2139,0.1967531,0.1008702,
2,97,2043,2140,0.2162837,0.1160233,
2,98,2043,2141,0.2374976,0.1333768,
2,99,2043,2142,0.2604884,0.1532707,
2,100,2043,2143,0.2853445,0.1760270,
2,101,2043,2144,0.3121468,0.2019081,
2,102,2043,2145,0.3409660,0.2312020,
2,103,2043,2146,0.3718598,0.2642852,
2,104,2043,2147,0.4048696,0.3015442,
2,105,2043,2148,0.4400178,0.3432800,
2,106,2043,2149,0.4773042,0.3896731,
2,107,2043,2150,0.5167037,0.4408728,
2,0,2044,2044,0.0077997,0.0020993,
2,1,2044,2045,0.0005341,0.0000668,
2,2,2044,2046,0.0002805,0.0000370,
2,3,2044,2047,0.0001960,0.0000280,
2,4,2044,2048,0.0001520,0.0000221,
2,5,2044,2049,0.0001465,0.0000239,
2,6,2044,2050,0.0001399,0.0000248,
2,7,2044,2051,0.0001348,0.0000258,
2,8,2044,2052,0.0001336,0.0000280,
2,9,2044,2053,0.0001377,0.0000318,
2,10,2044,2054,0.0001465,0.0000374,
2,11,2044,2055,0.0001596,0.0000449,
2,12,2044,2056,0.0001783,0.0000547,
2,13,2044,2057,0.0002061,0.0000691,
2,14,2044,2058,0.0002415,0.0000874,
2,15,2044,2059,0.0002756,0.0001036,
2,16,2044,2060,0.0003003,0.0001114,
2,17,2044,2061,0.0003175,0.0001113,
2,18,2044,2062,0.0003342,0.0001106,
2,19,2044,2063,0.0003539,0.0001132,
2,20,2044,2064,0.0003732,0.0001166,
2,21,2044,2065,0.0003859,0.0001155,
2,22,2044,2066,0.0003897,0.0001085,
2,23,2044,2067,0.0003908,0.0001004,
2,24,2044,2068,0.0003983,0.0000974,
2,25,2044,2069,0.0004147,0.0000996,
2,26,2044,2070,0.0004348,0.0001034,
2,27,2044,2071,0.0004528,0.0001049,
2,28,2044,2072,0.0004684,0.0001068,
2,29,2044,2073,0.0004856,0.0001089,
2,30,2044,2074,0.0005091,0.0001126,
2,31,2044,2075,0.0005408,0.0001175,
2,32,2044,2076,0.0005796,0.0001229,
2,33,2044,2077,0.0006220,0.0001277,
2,34,2044,2078,0.0006665,0.0001320,
2,35,2044,2079,0.0007153,0.0001360,
2,36,2044,2080,0.0007710,0.0001434,
2,37,2044,2081,0.0008314,0.0001508,
2,38,2044,2082,0.0008908,0.0001599,
2,39,2044,2083,0.0009481,0.0001719,
2,40,2044,2084,0.0010090,0.0001862,
2,41,2044,2085,0.0010784,0.0002011,
2,42,2044,2086,0.0011559,0.0002165,
2,43,2044,2087,0.0012427,0.0002367,
2,44,2044,2088,0.0013435,0.0002672,
2,45,2044,2089,0.0014588,0.0003021,
2,46,2044,2090,0.0015840,0.0003391,
2,47,2044,2091,0.0017152,0.0003704,
2,48,2044,2092,0.0018531,0.0004001,
2,49,2044,2093,0.0020059,0.0004315,
2,50,2044,2094,0.0021845,0.0004620,
2,51,2044,2095,0.0023896,0.0004897,
2,52,2044,2096,0.0026115,0.0005158,
2,53,2044,2097,0.0028474,0.0005471,
2,54,2044,2098,0.0031082,0.0005955,
2,55,2044,2099,0.0034035,0.0006532,
2,56,2044,2100,0.0037277,0.0007114,
2,57,2044,2101,0.0040692,0.0007568,
2,58,2044,2102,0.0044295,0.0007976,
2,59,2044,2103,0.0048296,0.0008495,
2,60,2044,2104,0.0052973,0.0009230,
2,61,2044,2105,0.0058480,0.0010186,
2,62,2044,2106,0.0064757,0.0011350,
2,63,2044,2107,0.0071641,0.0012746,
2,64,2044,2108,0.0078986,0.0014272,
2,65,2044,2109,0.0086645,0.0015638,
2,66,2044,2110,0.0094558,0.0016792,
2,67,2044,2111,0.0103010,0.0017937,
2,68,2044,2112,0.0112531,0.0019360,
2,69,2044,2113,0.0123584,0.0021194,
2,70,2044,2114,0.0136702,0.0023609,
2,71,2044,2115,0.0152518,0.0027071,
2,72,2044,2116,0.0170987,0.0031681,
2,73,2044,2117,0.0190837,0.0036737,
2,74,2044,2118,0.0210750,0.0041512,
2,75,2044,2119,0.0231062,0.0046031,
2,76,2044,2120,0.0253497,0.0051308,
2,77,2044,2121,0.0279666,0.0058450,
2,78,2044,2122,0.0310443,0.0068181,
2,79,2044,2123,0.0345982,0.0080658,
2,80,2044,2124,0.0395295,0.0103987,
2,81,2044,2125,0.0438328,0.0120097,
2,82,2044,2126,0.0485928,0.0138529,
2,83,2044,2127,0.0538556,0.0159745,
2,84,2044,2128,0.0596709,0.0184103,
2,85,2044,2129,0.0660929,0.0212155,
2,86,2044,2130,0.0731799,0.0244538,
2,87,2044,2131,0.0809950,0.0281871,
2,88,2044,2132,0.0896059,0.0324841,
2,89,2044,2133,0.0990850,0.0374105,
2,90,2044,2134,0.1095094,0.0430633,
2,91,2044,2135,0.1209607,0.0495523,
2,92,2044,2136,0.1335249,0.0570246,
2,93,2044,2137,0.1472918,0.0656644,
2,94,2044,2138,0.1623547,0.0756526,
2,95,2044,2139,0.1788093,0.0871383,
2,96,2044,2140,0.1967531,0.1002996,
2,97,2044,2141,0.2162837,0.1154010,
2,98,2044,2142,0.2374976,0.1327568,
2,99,2044,2143,0.2604884,0.1526693,
2,100,2044,2144,0.2853445,0.1753884,
2,101,2044,2145,0.3121468,0.2011941,
2,102,2044,2146,0.3409660,0.2304607,
2,103,2044,2147,0.3718598,0.2635885,
2,104,2044,2148,0.4048696,0.3009115,
2,105,2044,2149,0.4400178,0.3426599,
2,106,2044,2150,0.4773042,0.3890510,
2,0,2045,2045,0.0077997,0.0020111,
2,1,2045,2046,0.0005341,0.0000624,
2,2,2045,2047,0.0002805,0.0000349,
2,3,2045,2048,0.0001960,0.0000266,
2,4,2045,2049,0.0001520,0.0000210,
2,5,2045,2050,0.0001465,0.0000227,
2,6,2045,2051,0.0001399,0.0000237,
2,7,2045,2052,0.0001348,0.0000247,
2,8,2045,2053,0.0001336,0.0000270,
2,9,2045,2054,0.0001377,0.0000307,
2,10,2045,2055,0.0001465,0.0000362,
2,11,2045,2056,0.0001596,0.0000434,
2,12,2045,2057,0.0001783,0.0000532,
2,13,2045,2058,0.0002061,0.0000675,
2,14,2045,2059,0.0002415,0.0000855,
2,15,2045,2060,0.0002756,0.0001014,
2,16,2045,2061,0.0003003,0.0001089,
2,17,2045,2062,0.0003175,0.0001089,
2,18,2045,2063,0.0003342,0.0001083,
2,19,2045,2064,0.0003539,0.0001107,
2,20,2045,2065,0.0003732,0.0001138,
2,21,2045,2066,0.0003859,0.0001126,
2,22,2045,2067,0.0003897,0.0001058,
2,23,2045,2068,0.0003908,0.0000981,
2,24,2045,2069,0.0003983,0.0000951,
2,25,2045,2070,0.0004147,0.0000970,
2,26,2045,2071,0.0004348,0.0001006,
2,27,2045,2072,0.0004528,0.0001023,
2,28,2045,2073,0.0004684,0.0001043,
2,29,2045,2074,0.0004856,0.0001064,
2,30,2045,2075,0.0005091,0.0001098,
2,31,2045,2076,0.0005408,0.0001145,
2,32,2045,2077,0.0005796,0.0001200,
2,33,2045,2078,0.0006220,0.0001249,
2,34,2045,2079,0.0006665,0.0001289,
2,35,2045,2080,0.0007153,0.0001325,
2,36,2045,2081,0.0007710,0.0001397,
2,37,2045,2082,0.0008314,0.0001471,
2,38,2045,2083,0.0008908,0.0001563,
2,39,2045,2084,0.0009481,0.0001680,
2,40,2045,2085,0.0010090,0.0001817,
2,41,2045,2086,0.0010784,0.0001962,
2,42,2045,2087,0.0011559,0.0002116,
2,43,2045,2088,0.0012427,0.0002319,
2,44,2045,2089,0.0013435,0.0002618,
2,45,2045,2090,0.0014588,0.0002957,
2,46,2045,2091,0.0015840,0.0003320,
2,47,2045,2092,0.0017152,0.0003632,
2,48,2045,2093,0.0018531,0.0003929,
2,49,2045,2094,0.0020059,0.0004237,
2,50,2045,2095,0.0021845,0.0004529,
2,51,2045,2096,0.0023896,0.0004798,
2,52,2045,2097,0.0026115,0.0005057,
2,53,2045,2098,0.0028474,0.0005372,
2,54,2045,2099,0.0031082,0.0005845,
2,55,2045,2100,0.0034035,0.0006403,
2,56,2045,2101,0.0037277,0.0006971,
2,57,2045,2102,0.0040692,0.0007423,
2,58,2045,2103,0.0044295,0.0007835,
2,59,2045,2104,0.0048296,0.0008342,
2,60,2045,2105,0.0052973,0.0009049,
2,61,2045,2106,0.0058480,0.0009985,
2,62,2045,2107,0.0064757,0.0011142,
2,63,2045,2108,0.0071641,0.0012531,
2,64,2045,2109,0.0078986,0.0014030,
2,65,2045,2110,0.0086645,0.0015350,
2,66,2045,2111,0.0094558,0.0016477,
2,67,2045,2112,0.0103010,0.0017619,
2,68,2045,2113,0.0112531,0.0019044,
2,69,2045,2114,0.0123584,0.0020842,
2,70,2045,2115,0.0136702,0.0023188,
2,71,2045,2116,0.0152518,0.0026589,
2,72,2045,2117,0.0170987,0.0031167,
2,73,2045,2118,0.0190837,0.0036200,
2,74,2045,2119,0.0210750,0.0040900,
2,75,2045,2120,0.0231062,0.0045302,
2,76,2045,2121,0.0253497,0.0050493,
2,77,2045,2122,0.0279666,0.0057599,
2,78,2045,2123,0.0310443,0.0067295,
2,79,2045,2124,0.0345982,0.0079630,
2,80,2045,2125,0.0395295,0.0102672,
2,81,2045,2126,0.0438328,0.0118603,
2,82,2045,2127,0.0485928,0.0136969,
2,83,2045,2128,0.0538556,0.0158146,
2,84,2045,2129,0.0596709,0.0182293,
2,85,2045,2130,0.0660929,0.0209979,
2,86,2045,2131,0.0731799,0.0242081,
2,87,2045,2132,0.0809950,0.0279320,
2,88,2045,2133,0.0896059,0.0322237,
2,89,2045,2134,0.0990850,0.0371169,
2,90,2045,2135,0.1095094,0.0427128,
2,91,2045,2136,0.1209607,0.0491602,
2,92,2045,2137,0.1335249,0.0566221,
2,93,2045,2138,0.1472918,0.0652588,
2,94,2045,2139,0.1623547,0.0752017,
2,95,2045,2140,0.1788093,0.0866088,
2,96,2045,2141,0.1967531,0.0997185,
2,97,2045,2142,0.2162837,0.1148179,
2,98,2045,2143,0.2374976,0.1321864,
2,99,2045,2144,0.2604884,0.1520575,
2,100,2045,2145,0.2853445,0.1746962,
2,101,2045,2146,0.3121468,0.2004653,
2,102,2045,2147,0.3409660,0.2297640,
2,103,2045,2148,0.3718598,0.2629424,
2,104,2045,2149,0.4048696,0.3002611,
2,105,2045,2150,0.4400178,0.3419842,
2,0,2046,2046,0.0077996,0.0019245,
2,1,2046,2047,0.0005341,0.0000586,
2,2,2046,2048,0.0002805,0.0000330,
2,3,2046,2049,0.0001960,0.0000252,
2,4,2046,2050,0.0001520,0.0000199,
2,5,2046,2051,0.0001465,0.0000216,
2,6,2046,2052,0.0001399,0.0000226,
2,7,2046,2053,0.0001348,0.0000238,
2,8,2046,2054,0.0001336,0.0000259,
2,9,2046,2055,0.0001377,0.0000295,
2,10,2046,2056,0.0001465,0.0000349,
2,11,2046,2057,0.0001596,0.0000421,
2,12,2046,2058,0.0001783,0.0000519,
2,13,2046,2059,0.0002061,0.0000659,
2,14,2046,2060,0.0002415,0.0000835,
2,15,2046,2061,0.0002756,0.0000991,
2,16,2046,2062,0.0003003,0.0001066,
2,17,2046,2063,0.0003175,0.0001067,
2,18,2046,2064,0.0003342,0.0001059,
2,19,2046,2065,0.0003539,0.0001081,
2,20,2046,2066,0.0003732,0.0001111,
2,21,2046,2067,0.0003859,0.0001100,
2,22,2046,2068,0.0003897,0.0001035,
2,23,2046,2069,0.0003908,0.0000958,
2,24,2046,2070,0.0003983,0.0000926,
2,25,2046,2071,0.0004147,0.0000944,
2,26,2046,2072,0.0004348,0.0000981,
2,27,2046,2073,0.0004528,0.0001000,
2,28,2046,2074,0.0004684,0.0001018,
2,29,2046,2075,0.0004856,0.0001037,
2,30,2046,2076,0.0005091,0.0001069,
2,31,2046,2077,0.0005408,0.0001117,
2,32,2046,2078,0.0005796,0.0001173,
2,33,2046,2079,0.0006220,0.0001220,
2,34,2046,2080,0.0006665,0.0001256,
2,35,2046,2081,0.0007153,0.0001290,
2,36,2046,2082,0.0007710,0.0001362,
2,37,2046,2083,0.0008314,0.0001437,
2,38,2046,2084,0.0008908,0.0001527,
2,39,2046,2085,0.0009481,0.0001638,
2,40,2046,2086,0.0010090,0.0001772,
2,41,2046,2087,0.0010784,0.0001917,
2,42,2046,2088,0.0011559,0.0002072,
2,43,2046,2089,0.0012427,0.0002270,
2,44,2046,2090,0.0013435,0.0002560,
2,45,2046,2091,0.0014588,0.0002893,
2,46,2046,2092,0.0015840,0.0003254,
2,47,2046,2093,0.0017152,0.0003567,
2,48,2046,2094,0.0018531,0.0003857,
2,49,2046,2095,0.0020059,0.0004153,
2,50,2046,2096,0.0021845,0.0004437,
2,51,2046,2097,0.0023896,0.0004705,
2,52,2046,2098,0.0026115,0.0004966,
2,53,2046,2099,0.0028474,0.0005272,
2,54,2046,2100,0.0031082,0.0005728,
2,55,2046,2101,0.0034035,0.0006273,
2,56,2046,2102,0.0037277,0.0006838,
2,57,2046,2103,0.0040692,0.0007293,
2,58,2046,2104,0.0044295,0.0007694,
2,59,2046,2105,0.0048296,0.0008178,
2,60,2046,2106,0.0052973,0.0008868,
2,61,2046,2107,0.0058480,0.0009798,
2,62,2046,2108,0.0064757,0.0010951,
2,63,2046,2109,0.0071641,0.0012314,
2,64,2046,2110,0.0078986,0.0013770,
2,65,2046,2111,0.0086645,0.0015062,
2,66,2046,2112,0.0094558,0.0016185,
2,67,2046,2113,0.0103010,0.0017330,
2,68,2046,2114,0.0112531,0.0018725,
2,69,2046,2115,0.0123584,0.0020465,
2,70,2046,2116,0.0136702,0.0022765,
2,71,2046,2117,0.0152518,0.0026143,
2,72,2046,2118,0.0170987,0.0030696,
2,73,2046,2119,0.0190837,0.0035654,
2,74,2046,2120,0.0210750,0.0040242,
2,75,2046,2121,0.0231062,0.0044567,
2,76,2046,2122,0.0253497,0.0049736,
2,77,2046,2123,0.0279666,0.0056820,
2,78,2046,2124,0.0310443,0.0066396,
2,79,2046,2125,0.0345982,0.0078524,
2,80,2046,2126,0.0395295,0.0101343,
2,81,2046,2127,0.0438328,0.0117212,
2,82,2046,2128,0.0485928,0.0135541,
2,83,2046,2129,0.0538556,0.0156527,
2,84,2046,2130,0.0596709,0.0180344,
2,85,2046,2131,0.0660929,0.0207773,
2,86,2046,2132,0.0731799,0.0239787,
2,87,2046,2133,0.0809950,0.0276974,
2,88,2046,2134,0.0896059,0.0319585,
2,89,2046,2135,0.0990850,0.0367995,
2,90,2046,2136,0.1095094,0.0423568,
2,91,2046,2137,0.1209607,0.0487936,
2,92,2046,2138,0.1335249,0.0562513,
2,93,2046,2139,0.1472918,0.0648449,
2,94,2046,2140,0.1623547,0.0747133,
2,95,2046,2141,0.1788093,0.0860698,
2,96,2046,2142,0.1967531,0.0991742,
2,97,2046,2143,0.2162837,0.1142815,
2,98,2046,2144,0.2374976,0.1316062,
2,99,2046,2145,0.2604884,0.1513945,
2,100,2046,2146,0.2853445,0.1739900,
2,101,2046,2147,0.3121468,0.1997806,
2,102,2046,2148,0.3409660,0.2291182,
2,103,2046,2149,0.3718598,0.2622784,
2,104,2046,2150,0.4048696,0.2995528,
2,0,2047,2047,0.0077996,0.0018464,
2,1,2047,2048,0.0005341,0.0000552,
2,2,2047,2049,0.0002805,0.0000311,
2,3,2047,2050,0.0001960,0.0000238,
2,4,2047,2051,0.0001520,0.0000187,
2,5,2047,2052,0.0001465,0.0000205,
2,6,2047,2053,0.0001399,0.0000216,
2,7,2047,2054,0.0001348,0.0000228,
2,8,2047,2055,0.0001336,0.0000249,
2,9,2047,2056,0.0001377,0.0000284,
2,10,2047,2057,0.0001465,0.0000337,
2,11,2047,2058,0.0001596,0.0000409,
2,12,2047,2059,0.0001783,0.0000505,
2,13,2047,2060,0.0002061,0.0000642,
2,14,2047,2061,0.0002415,0.0000815,
2,15,2047,2062,0.0002756,0.0000970,
2,16,2047,2063,0.0003003,0.0001045,
2,17,2047,2064,0.0003175,0.0001045,
2,18,2047,2065,0.0003342,0.0001035,
2,19,2047,2066,0.0003539,0.0001055,
2,20,2047,2067,0.0003732,0.0001085,
2,21,2047,2068,0.0003859,0.0001076,
2,22,2047,2069,0.0003897,0.0001011,
2,23,2047,2070,0.0003908,0.0000933,
2,24,2047,2071,0.0003983,0.0000901,
2,25,2047,2072,0.0004147,0.0000920,
2,26,2047,2073,0.0004348,0.0000959,
2,27,2047,2074,0.0004528,0.0000976,
2,28,2047,2075,0.0004684,0.0000992,
2,29,2047,2076,0.0004856,0.0001010,
2,30,2047,2077,0.0005091,0.0001043,
2,31,2047,2078,0.0005408,0.0001092,
2,32,2047,2079,0.0005796,0.0001146,
2,33,2047,2080,0.0006220,0.0001189,
2,34,2047,2081,0.0006665,0.0001224,
2,35,2047,2082,0.0007153,0.0001258,
2,36,2047,2083,0.0007710,0.0001331,
2,37,2047,2084,0.0008314,0.0001404,
2,38,2047,2085,0.0008908,0.0001488,
2,39,2047,2086,0.0009481,0.0001597,
2,40,2047,2087,0.0010090,0.0001730,
2,41,2047,2088,0.0010784,0.0001876,
2,42,2047,2089,0.0011559,0.0002028,
2,43,2047,2090,0.0012427,0.0002218,
2,44,2047,2091,0.0013435,0.0002502,
2,45,2047,2092,0.0014588,0.0002834,
2,46,2047,2093,0.0015840,0.0003195,
2,47,2047,2094,0.0017152,0.0003501,
2,48,2047,2095,0.0018531,0.0003780,
2,49,2047,2096,0.0020059,0.0004069,
2,50,2047,2097,0.0021845,0.0004352,
2,51,2047,2098,0.0023896,0.0004621,
2,52,2047,2099,0.0026115,0.0004874,
2,53,2047,2100,0.0028474,0.0005165,
2,54,2047,2101,0.0031082,0.0005610,
2,55,2047,2102,0.0034035,0.0006153,
2,56,2047,2103,0.0037277,0.0006719,
2,57,2047,2104,0.0040692,0.0007163,
2,58,2047,2105,0.0044295,0.0007543,
2,59,2047,2106,0.0048296,0.0008013,
2,60,2047,2107,0.0052973,0.0008701,
2,61,2047,2108,0.0058480,0.0009628,
2,62,2047,2109,0.0064757,0.0010758,
2,63,2047,2110,0.0071641,0.0012082,
2,64,2047,2111,0.0078986,0.0013508,
2,65,2047,2112,0.0086645,0.0014795,
2,66,2047,2113,0.0094558,0.0015920,
2,67,2047,2114,0.0103010,0.0017039,
2,68,2047,2115,0.0112531,0.0018384,
2,69,2047,2116,0.0123584,0.0020087,
2,70,2047,2117,0.0136702,0.0022373,
2,71,2047,2118,0.0152518,0.0025734,
2,72,2047,2119,0.0170987,0.0030218,
2,73,2047,2120,0.0190837,0.0035067,
2,74,2047,2121,0.0210750,0.0039580,
2,75,2047,2122,0.0231062,0.0043886,
2,76,2047,2123,0.0253497,0.0049042,
2,77,2047,2124,0.0279666,0.0056029,
2,78,2047,2125,0.0310443,0.0065428,
2,79,2047,2126,0.0345982,0.0077407,
2,80,2047,2127,0.0395295,0.0100107,
2,81,2047,2128,0.0438328,0.0115941,
2,82,2047,2129,0.0485928,0.0134097,
2,83,2047,2130,0.0538556,0.0154785,
2,84,2047,2131,0.0596709,0.0178369,
2,85,2047,2132,0.0660929,0.0205717,
2,86,2047,2133,0.0731799,0.0237679,
2,87,2047,2134,0.0809950,0.0274586,
2,88,2047,2135,0.0896059,0.0316720,
2,89,2047,2136,0.0990850,0.0364773,
2,90,2047,2137,0.1095094,0.0420240,
2,91,2047,2138,0.1209607,0.0484559,
2,92,2047,2139,0.1335249,0.0558730,
2,93,2047,2140,0.1472918,0.0643966,
2,94,2047,2141,0.1623547,0.0742163,
2,95,2047,2142,0.1788093,0.0855652,
2,96,2047,2143,0.1967531,0.0986738,
2,97,2047,2144,0.2162837,0.1137362,
2,98,2047,2145,0.2374976,0.1309778,
2,99,2047,2146,0.2604884,0.1507184,
2,100,2047,2147,0.2853445,0.1733268,
2,101,2047,2148,0.3121468,0.1991461,
2,102,2047,2149,0.3409660,0.2284546,
2,103,2047,2150,0.3718598,0.2615556,
2,0,2048,2048,0.0077996,0.0017765,
2,1,2048,2049,0.0005341,0.0000520,
2,2,2048,2050,0.0002805,0.0000292,
2,3,2048,2051,0.0001960,0.0000224,
2,4,2048,2052,0.0001520,0.0000177,
2,5,2048,2053,0.0001465,0.0000196,
2,6,2048,2054,0.0001399,0.0000207,
2,7,2048,2055,0.0001348,0.0000218,
2,8,2048,2056,0.0001336,0.0000238,
2,9,2048,2057,0.0001377,0.0000274,
2,10,2048,2058,0.0001465,0.0000327,
2,11,2048,2059,0.0001596,0.0000398,
2,12,2048,2060,0.0001783,0.0000491,
2,13,2048,2061,0.0002061,0.0000625,
2,14,2048,2062,0.0002415,0.0000797,
2,15,2048,2063,0.0002756,0.0000951,
2,16,2048,2064,0.0003003,0.0001024,
2,17,2048,2065,0.0003175,0.0001021,
2,18,2048,2066,0.0003342,0.0001010,
2,19,2048,2067,0.0003539,0.0001031,
2,20,2048,2068,0.0003732,0.0001063,
2,21,2048,2069,0.0003859,0.0001053,
2,22,2048,2070,0.0003897,0.0000986,
2,23,2048,2071,0.0003908,0.0000908,
2,24,2048,2072,0.0003983,0.0000878,
2,25,2048,2073,0.0004147,0.0000899,
2,26,2048,2074,0.0004348,0.0000936,
2,27,2048,2075,0.0004528,0.0000951,
2,28,2048,2076,0.0004684,0.0000966,
2,29,2048,2077,0.0004856,0.0000985,
2,30,2048,2078,0.0005091,0.0001020,
2,31,2048,2079,0.0005408,0.0001067,
2,32,2048,2080,0.0005796,0.0001117,
2,33,2048,2081,0.0006220,0.0001158,
2,34,2048,2082,0.0006665,0.0001194,
2,35,2048,2083,0.0007153,0.0001229,
2,36,2048,2084,0.0007710,0.0001300,
2,37,2048,2085,0.0008314,0.0001368,
2,38,2048,2086,0.0008908,0.0001450,
2,39,2048,2087,0.0009481,0.0001558,
2,40,2048,2088,0.0010090,0.0001693,
2,41,2048,2089,0.0010784,0.0001835,
2,42,2048,2090,0.0011559,0.0001980,
2,43,2048,2091,0.0012427,0.0002166,
2,44,2048,2092,0.0013435,0.0002449,
2,45,2048,2093,0.0014588,0.0002780,
2,46,2048,2094,0.0015840,0.0003134,
2,47,2048,2095,0.0017152,0.0003430,
2,48,2048,2096,0.0018531,0.0003703,
2,49,2048,2097,0.0020059,0.0003991,
2,50,2048,2098,0.0021845,0.0004275,
2,51,2048,2099,0.0023896,0.0004536,
2,52,2048,2100,0.0026115,0.0004776,
2,53,2048,2101,0.0028474,0.0005058,
2,54,2048,2102,0.0031082,0.0005501,
2,55,2048,2103,0.0034035,0.0006044,
2,56,2048,2104,0.0037277,0.0006599,
2,57,2048,2105,0.0040692,0.0007024,
2,58,2048,2106,0.0044295,0.0007392,
2,59,2048,2107,0.0048296,0.0007862,
2,60,2048,2108,0.0052973,0.0008548,
2,61,2048,2109,0.0058480,0.0009456,
2,62,2048,2110,0.0064757,0.0010551,
2,63,2048,2111,0.0071641,0.0011848,
2,64,2048,2112,0.0078986,0.0013267,
2,65,2048,2113,0.0086645,0.0014552,
2,66,2048,2114,0.0094558,0.0015653,
2,67,2048,2115,0.0103010,0.0016728,
2,68,2048,2116,0.0112531,0.0018041,
2,69,2048,2117,0.0123584,0.0019736,
2,70,2048,2118,0.0136702,0.0022014,
2,71,2048,2119,0.0152518,0.0025319,
2,72,2048,2120,0.0170987,0.0029705,
2,73,2048,2121,0.0190837,0.0034477,
2,74,2048,2122,0.0210750,0.0038965,
2,75,2048,2123,0.0231062,0.0043263,
2,76,2048,2124,0.0253497,0.0048339,
2,77,2048,2125,0.0279666,0.0055178,
2,78,2048,2126,0.0310443,0.0064452,
2,79,2048,2127,0.0345982,0.0076369,
2,80,2048,2128,0.0395295,0.0098978,
2,81,2048,2129,0.0438328,0.0114656,
2,82,2048,2130,0.0485928,0.0132543,
2,83,2048,2131,0.0538556,0.0153021,
2,84,2048,2132,0.0596709,0.0176529,
2,85,2048,2133,0.0660929,0.0203827,
2,86,2048,2134,0.0731799,0.0235533,
2,87,2048,2135,0.0809950,0.0272005,
2,88,2048,2136,0.0896059,0.0313811,
2,89,2048,2137,0.0990850,0.0361762,
2,90,2048,2138,0.1095094,0.0417176,
2,91,2048,2139,0.1209607,0.0481115,
2,92,2048,2140,0.1335249,0.0554634,
2,93,2048,2141,0.1472918,0.0639407,
2,94,2048,2142,0.1623547,0.0737512,
2,95,2048,2143,0.1788093,0.0851014,
2,96,2048,2144,0.1967531,0.0981653,
2,97,2048,2145,0.2162837,0.1131459,
2,98,2048,2146,0.2374976,0.1303373,
2,99,2048,2147,0.2604884,0.1500838,
2,100,2048,2148,0.2853445,0.1727125,
2,101,2048,2149,0.3121468,0.1984946,
2,102,2048,2150,0.3409660,0.2277327,
2,0,2049,2049,0.0077996,0.0017071,
2,1,2049,2050,0.0005341,0.0000486,
2,2,2049,2051,0.0002805,0.0000274,
2,3,2049,2052,0.0001960,0.0000211,
2,4,2049,2053,0.0001520,0.0000169,
2,5,2049,2054,0.0001465,0.0000187,
2,6,2049,2055,0.0001399,0.0000197,
2,7,2049,2056,0.0001348,0.0000208,
2,8,2049,2057,0.0001336,0.0000229,
2,9,2049,2058,0.0001377,0.0000264,
2,10,2049,2059,0.0001465,0.0000317,
2,11,2049,2060,0.0001596,0.0000385,
2,12,2049,2061,0.0001783,0.0000477,
2,13,2049,2062,0.0002061,0.0000610,
2,14,2049,2063,0.0002415,0.0000780,
2,15,2049,2064,0.0002756,0.0000932,
2,16,2049,2065,0.0003003,0.0001002,
2,17,2049,2066,0.0003175,0.0000998,
2,18,2049,2067,0.0003342,0.0000987,
2,19,2049,2068,0.0003539,0.0001009,
2,20,2049,2069,0.0003732,0.0001040,
2,21,2049,2070,0.0003859,0.0001028,
2,22,2049,2071,0.0003897,0.0000961,
2,23,2049,2072,0.0003908,0.0000886,
2,24,2049,2073,0.0003983,0.0000857,
2,25,2049,2074,0.0004147,0.0000877,
2,26,2049,2075,0.0004348,0.0000912,
2,27,2049,2076,0.0004528,0.0000926,
2,28,2049,2077,0.0004684,0.0000942,
2,29,2049,2078,0.0004856,0.0000962,
2,30,2049,2079,0.0005091,0.0000996,
2,31,2049,2080,0.0005408,0.0001040,
2,32,2049,2081,0.0005796,0.0001088,
2,33,2049,2082,0.0006220,0.0001130,
2,34,2049,2083,0.0006665,0.0001167,
2,35,2049,2084,0.0007153,0.0001200,
2,36,2049,2085,0.0007710,0.0001267,
2,37,2049,2086,0.0008314,0.0001332,
2,38,2049,2087,0.0008908,0.0001414,
2,39,2049,2088,0.0009481,0.0001524,
2,40,2049,2089,0.0010090,0.0001655,
2,41,2049,2090,0.0010784,0.0001792,
2,42,2049,2091,0.0011559,0.0001933,
2,43,2049,2092,0.0012427,0.0002119,
2,44,2049,2093,0.0013435,0.0002401,
2,45,2049,2094,0.0014588,0.0002726,
2,46,2049,2095,0.0015840,0.0003070,
2,47,2049,2096,0.0017152,0.0003359,
2,48,2049,2097,0.0018531,0.0003631,
2,49,2049,2098,0.0020059,0.0003920,
2,50,2049,2099,0.0021845,0.0004197,
2,51,2049,2100,0.0023896,0.0004446,
2,52,2049,2101,0.0026115,0.0004677,
2,53,2049,2102,0.0028474,0.0004959,
2,54,2049,2103,0.0031082,0.0005403,
2,55,2049,2104,0.0034035,0.0005935,
2,56,2049,2105,0.0037277,0.0006471,
2,57,2049,2106,0.0040692,0.0006884,
2,58,2049,2107,0.0044295,0.0007252,
2,59,2049,2108,0.0048296,0.0007723,
2,60,2049,2109,0.0052973,0.0008394,
2,61,2049,2110,0.0058480,0.0009271,
2,62,2049,2111,0.0064757,0.0010343,
2,63,2049,2112,0.0071641,0.0011632,
2,64,2049,2113,0.0078986,0.0013047,
2,65,2049,2114,0.0086645,0.0014307,
2,66,2049,2115,0.0094558,0.0015367,
2,67,2049,2116,0.0103010,0.0016415,
2,68,2049,2117,0.0112531,0.0017724,
2,69,2049,2118,0.0123584,0.0019416,
2,70,2049,2119,0.0136702,0.0021650,
2,71,2049,2120,0.0152518,0.0024874,
2,72,2049,2121,0.0170987,0.0029189,
2,73,2049,2122,0.0190837,0.0033929,
2,74,2049,2123,0.0210750,0.0038403,
2,75,2049,2124,0.0231062,0.0042630,
2,76,2049,2125,0.0253497,0.0047583,
2,77,2049,2126,0.0279666,0.0054321,
2,78,2049,2127,0.0310443,0.0063546,
2,79,2049,2128,0.0345982,0.0075423,
2,80,2049,2129,0.0395295,0.0097836,
2,81,2049,2130,0.0438328,0.0113273,
2,82,2049,2131,0.0485928,0.0130971,
2,83,2049,2132,0.0538556,0.0151377,
2,84,2049,2133,0.0596709,0.0174838,
2,85,2049,2134,0.0660929,0.0201904,
2,86,2049,2135,0.0731799,0.0233217,
2,87,2049,2136,0.0809950,0.0269388,
2,88,2049,2137,0.0896059,0.0311095,
2,89,2049,2138,0.0990850,0.0358991,
2,90,2049,2139,0.1095094,0.0414053,
2,91,2049,2140,0.1209607,0.0477389,
2,92,2049,2141,0.1335249,0.0550471,
2,93,2049,2142,0.1472918,0.0635143,
2,94,2049,2143,0.1623547,0.0733240,
2,95,2049,2144,0.1788093,0.0846304,
2,96,2049,2145,0.1967531,0.0976150,
2,97,2049,2146,0.2162837,0.1125445,
2,98,2049,2147,0.2374976,0.1297363,
2,99,2049,2148,0.2604884,0.1494962,
2,100,2049,2149,0.2853445,0.1720819,
2,101,2049,2150,0.3121468,0.1977859,
2,0,2050,2050,0.0077996,0.0016344,
2,1,2050,2051,0.0005341,0.0000454,
2,2,2050,2052,0.0002805,0.0000258,
2,3,2050,2053,0.0001960,0.0000200,
2,4,2050,2054,0.0001520,0.0000160,
2,5,2050,2055,0.0001465,0.0000177,
2,6,2050,2056,0.0001399,0.0000187,
2,7,2050,2057,0.0001348,0.0000199,
2,8,2050,2058,0.0001336,0.0000220,
2,9,2050,2059,0.0001377,0.0000255,
2,10,2050,2060,0.0001465,0.0000306,
2,11,2050,2061,0.0001596,0.0000373,
2,12,2050,2062,0.0001783,0.0000464,
2,13,2050,2063,0.0002061,0.0000596,
2,14,2050,2064,0.0002415,0.0000764,
2,15,2050,2065,0.0002756,0.0000911,
2,16,2050,2066,0.0003003,0.0000979,
2,17,2050,2067,0.0003175,0.0000976,
2,18,2050,2068,0.0003342,0.0000966,
2,19,2050,2069,0.0003539,0.0000987,
2,20,2050,2070,0.0003732,0.0001015,
2,21,2050,2071,0.0003859,0.0001003,
2,22,2050,2072,0.0003897,0.0000938,
2,23,2050,2073,0.0003908,0.0000865,
2,24,2050,2074,0.0003983,0.0000837,
2,25,2050,2075,0.0004147,0.0000854,
2,26,2050,2076,0.0004348,0.0000888,
2,27,2050,2077,0.0004528,0.0000903,
2,28,2050,2078,0.0004684,0.0000921,
2,29,2050,2079,0.0004856,0.0000940,
2,30,2050,2080,0.0005091,0.0000971,
2,31,2050,2081,0.0005408,0.0001013,
2,32,2050,2082,0.0005796,0.0001062,
2,33,2050,2083,0.0006220,0.0001105,
2,34,2050,2084,0.0006665,0.0001140,
2,35,2050,2085,0.0007153,0.0001170,
2,36,2050,2086,0.0007710,0.0001234,
2,37,2050,2087,0.0008314,0.0001299,
2,38,2050,2088,0.0008908,0.0001382,
2,39,2050,2089,0.0009481,0.0001489,
2,40,2050,2090,0.0010090,0.0001615,
2,41,2050,2091,0.0010784,0.0001748,
2,42,2050,2092,0.0011559,0.0001889,
2,43,2050,2093,0.0012427,0.0002075,
2,44,2050,2094,0.0013435,0.0002352,
2,45,2050,2095,0.0014588,0.0002667,
2,46,2050,2096,0.0015840,0.0003005,
2,47,2050,2097,0.0017152,0.0003293,
2,48,2050,2098,0.0018531,0.0003566,
2,49,2050,2099,0.0020059,0.0003849,
2,50,2050,2100,0.0021845,0.0004114,
2,51,2050,2101,0.0023896,0.0004355,
2,52,2050,2102,0.0026115,0.0004586,
2,53,2050,2103,0.0028474,0.0004869,
2,54,2050,2104,0.0031082,0.0005305,
2,55,2050,2105,0.0034035,0.0005819,
2,56,2050,2106,0.0037277,0.0006343,
2,57,2050,2107,0.0040692,0.0006755,
2,58,2050,2108,0.0044295,0.0007125,
2,59,2050,2109,0.0048296,0.0007582,
2,60,2050,2110,0.0052973,0.0008228,
2,61,2050,2111,0.0058480,0.0009085,
2,62,2050,2112,0.0064757,0.0010151,
2,63,2050,2113,0.0071641,0.0011436,
2,64,2050,2114,0.0078986,0.0012826,
2,65,2050,2115,0.0086645,0.0014046,
2,66,2050,2116,0.0094558,0.0015080,
2,67,2050,2117,0.0103010,0.0016126,
2,68,2050,2118,0.0112531,0.0017434,
2,69,2050,2119,0.0123584,0.0019090,
2,70,2050,2120,0.0136702,0.0021259,
2,71,2050,2121,0.0152518,0.0024426,
2,72,2050,2122,0.0170987,0.0028710,
2,73,2050,2123,0.0190837,0.0033428,
2,74,2050,2124,0.0210750,0.0037832,
2,75,2050,2125,0.0231062,0.0041951,
2,76,2050,2126,0.0253497,0.0046821,
2,77,2050,2127,0.0279666,0.0053525,
2,78,2050,2128,0.0310443,0.0062719,
2,79,2050,2129,0.0345982,0.0074467,
2,80,2050,2130,0.0395295,0.0096608,
2,81,2050,2131,0.0438328,0.0111875,
2,82,2050,2132,0.0485928,0.0129506,
2,83,2050,2133,0.0538556,0.0149868,
2,84,2050,2134,0.0596709,0.0173119,
2,85,2050,2135,0.0660929,0.0199829,
2,86,2050,2136,0.0731799,0.0230868,
2,87,2050,2137,0.0809950,0.0266945,
2,88,2050,2138,0.0896059,0.0308597,
2,89,2050,2139,0.0990850,0.0356168,
2,90,2050,2140,0.1095094,0.0410675,
2,91,2050,2141,0.1209607,0.0473603,
2,92,2050,2142,0.1335249,0.0546579,
2,93,2050,2143,0.1472918,0.0631227,
2,94,2050,2144,0.1623547,0.0728902,
2,95,2050,2145,0.1788093,0.0841209,
2,96,2050,2146,0.1967531,0.0970546,
2,97,2050,2147,0.2162837,0.1119804,
2,98,2050,2148,0.2374976,0.1291801,
2,99,2050,2149,0.2604884,0.1488933,
2,100,2050,2150,0.2853445,0.1713962,
2,0,2051,2051,0.0077996,0.0015632,
2,1,2051,2052,0.0005341,0.0000426,
2,2,2051,2053,0.0002805,0.0000244,
2,3,2051,2054,0.0001960,0.0000190,
2,4,2051,2055,0.0001520,0.0000151,
2,5,2051,2056,0.0001465,0.0000168,
2,6,2051,2057,0.0001399,0.0000179,
2,7,2051,2058,0.0001348,0.0000191,
2,8,2051,2059,0.0001336,0.0000212,
2,9,2051,2060,0.0001377,0.0000246,
2,10,2051,2061,0.0001465,0.0000295,
2,11,2051,2062,0.0001596,0.0000362,
2,12,2051,2063,0.0001783,0.0000452,
2,13,2051,2064,0.0002061,0.0000582,
2,14,2051,2065,0.0002415,0.0000746,
2,15,2051,2066,0.0002756,0.0000890,
2,16,2051,2067,0.0003003,0.0000959,
2,17,2051,2068,0.0003175,0.0000956,
2,18,2051,2069,0.0003342,0.0000946,
2,19,2051,2070,0.0003539,0.0000964,
2,20,2051,2071,0.0003732,0.0000991,
2,21,2051,2072,0.0003859,0.0000980,
2,22,2051,2073,0.0003897,0.0000918,
2,23,2051,2074,0.0003908,0.0000845,
2,24,2051,2075,0.0003983,0.0000815,
2,25,2051,2076,0.0004147,0.0000832,
2,26,2051,2077,0.0004348,0.0000866,
2,27,2051,2078,0.0004528,0.0000882,
2,28,2051,2079,0.0004684,0.0000899,
2,29,2051,2080,0.0004856,0.0000916,
2,30,2051,2081,0.0005091,0.0000946,
2,31,2051,2082,0.0005408,0.0000989,
2,32,2051,2083,0.0005796,0.0001038,
2,33,2051,2084,0.0006220,0.0001079,
2,34,2051,2085,0.0006665,0.0001111,
2,35,2051,2086,0.0007153,0.0001139,
2,36,2051,2087,0.0007710,0.0001203,
2,37,2051,2088,0.0008314,0.0001270,
2,38,2051,2089,0.0008908,0.0001350,
2,39,2051,2090,0.0009481,0.0001452,
2,40,2051,2091,0.0010090,0.0001574,
2,41,2051,2092,0.0010784,0.0001708,
2,42,2051,2093,0.0011559,0.0001849,
2,43,2051,2094,0.0012427,0.0002031,
2,44,2051,2095,0.0013435,0.0002300,
2,45,2051,2096,0.0014588,0.0002609,
2,46,2051,2097,0.0015840,0.0002945,
2,47,2051,2098,0.0017152,0.0003234,
2,48,2051,2099,0.0018531,0.0003501,
2,49,2051,2100,0.0020059,0.0003772,
2,50,2051,2101,0.0021845,0.0004031,
2,51,2051,2102,0.0023896,0.0004271,
2,52,2051,2103,0.0026115,0.0004504,
2,53,2051,2104,0.0028474,0.0004780,
2,54,2051,2105,0.0031082,0.0005200,
2,55,2051,2106,0.0034035,0.0005703,
2,56,2051,2107,0.0037277,0.0006224,
2,57,2051,2108,0.0040692,0.0006637,
2,58,2051,2109,0.0044295,0.0006996,
2,59,2051,2110,0.0048296,0.0007432,
2,60,2051,2111,0.0052973,0.0008061,
2,61,2051,2112,0.0058480,0.0008914,
2,62,2051,2113,0.0064757,0.0009976,
2,63,2051,2114,0.0071641,0.0011238,
2,64,2051,2115,0.0078986,0.0012589,
2,65,2051,2116,0.0086645,0.0013783,
2,66,2051,2117,0.0094558,0.0014814,
2,67,2051,2118,0.0103010,0.0015861,
2,68,2051,2119,0.0112531,0.0017140,
2,69,2051,2120,0.0123584,0.0018741,
2,70,2051,2121,0.0136702,0.0020867,
2,71,2051,2122,0.0152518,0.0024011,
2,72,2051,2123,0.0170987,0.0028273,
2,73,2051,2124,0.0190837,0.0032921,
2,74,2051,2125,0.0210750,0.0037220,
2,75,2051,2126,0.0231062,0.0041266,
2,76,2051,2127,0.0253497,0.0046115,
2,77,2051,2128,0.0279666,0.0052800,
2,78,2051,2129,0.0310443,0.0061885,
2,79,2051,2130,0.0345982,0.0073440,
2,80,2051,2131,0.0395295,0.0095368,
2,81,2051,2132,0.0438328,0.0110573,
2,82,2051,2133,0.0485928,0.0128162,
2,83,2051,2134,0.0538556,0.0148334,
2,84,2051,2135,0.0596709,0.0171264,
2,85,2051,2136,0.0660929,0.0197726,
2,86,2051,2137,0.0731799,0.0228676,
2,87,2051,2138,0.0809950,0.0264699,
2,88,2051,2139,0.0896059,0.0306052,
2,89,2051,2140,0.0990850,0.0353115,
2,90,2051,2141,0.1095094,0.0407244,
2,91,2051,2142,0.1209607,0.0470065,
2,92,2051,2143,0.1335249,0.0543007,
2,93,2051,2144,0.1472918,0.0627253,
2,94,2051,2145,0.1623547,0.0724211,
2,95,2051,2146,0.1788093,0.0836022,
2,96,2051,2147,0.1967531,0.0965293,
2,97,2051,2148,0.2162837,0.1114586,
2,98,2051,2149,0.2374976,0.1286096,
2,99,2051,2150,0.2604884,0.1482381,
2,0,2052,2052,0.0077996,0.0014989,
2,1,2052,2053,0.0005341,0.0000401,
2,2,2052,2054,0.0002805,0.0000230,
2,3,2052,2055,0.0001960,0.0000179,
2,4,2052,2056,0.0001520,0.0000142,
2,5,2052,2057,0.0001465,0.0000159,
2,6,2052,2058,0.0001399,0.0000171,
2,7,2052,2059,0.0001348,0.0000183,
2,8,2052,2060,0.0001336,0.0000203,
2,9,2052,2061,0.0001377,0.0000236,
2,10,2052,2062,0.0001465,0.0000285,
2,11,2052,2063,0.0001596,0.0000352,
2,12,2052,2064,0.0001783,0.0000440,
2,13,2052,2065,0.0002061,0.0000567,
2,14,2052,2066,0.0002415,0.0000728,
2,15,2052,2067,0.0002756,0.0000871,
2,16,2052,2068,0.0003003,0.0000940,
2,17,2052,2069,0.0003175,0.0000936,
2,18,2052,2070,0.0003342,0.0000924,
2,19,2052,2071,0.0003539,0.0000941,
2,20,2052,2072,0.0003732,0.0000968,
2,21,2052,2073,0.0003859,0.0000959,
2,22,2052,2074,0.0003897,0.0000897,
2,23,2052,2075,0.0003908,0.0000823,
2,24,2052,2076,0.0003983,0.0000793,
2,25,2052,2077,0.0004147,0.0000811,
2,26,2052,2078,0.0004348,0.0000846,
2,27,2052,2079,0.0004528,0.0000861,
2,28,2052,2080,0.0004684,0.0000876,
2,29,2052,2081,0.0004856,0.0000892,
2,30,2052,2082,0.0005091,0.0000923,
2,31,2052,2083,0.0005408,0.0000967,
2,32,2052,2084,0.0005796,0.0001014,
2,33,2052,2085,0.0006220,0.0001052,
2,34,2052,2086,0.0006665,0.0001082,
2,35,2052,2087,0.0007153,0.0001111,
2,36,2052,2088,0.0007710,0.0001176,
2,37,2052,2089,0.0008314,0.0001240,
2,38,2052,2090,0.0008908,0.0001316,
2,39,2052,2091,0.0009481,0.0001415,
2,40,2052,2092,0.0010090,0.0001537,
2,41,2052,2093,0.0010784,0.0001671,
2,42,2052,2094,0.0011559,0.0001809,
2,43,2052,2095,0.0012427,0.0001985,
2,44,2052,2096,0.0013435,0.0002248,
2,45,2052,2097,0.0014588,0.0002555,
2,46,2052,2098,0.0015840,0.0002891,
2,47,2052,2099,0.0017152,0.0003173,
2,48,2052,2100,0.0018531,0.0003431,
2,49,2052,2101,0.0020059,0.0003696,
2,50,2052,2102,0.0021845,0.0003953,
2,51,2052,2103,0.0023896,0.0004195,
2,52,2052,2104,0.0026115,0.0004421,
2,53,2052,2105,0.0028474,0.0004685,
2,54,2052,2106,0.0031082,0.0005095,
2,55,2052,2107,0.0034035,0.0005596,
2,56,2052,2108,0.0037277,0.0006116,
2,57,2052,2109,0.0040692,0.0006518,
2,58,2052,2110,0.0044295,0.0006857,
2,59,2052,2111,0.0048296,0.0007281,
2,60,2052,2112,0.0052973,0.0007908,
2,61,2052,2113,0.0058480,0.0008759,
2,62,2052,2114,0.0064757,0.0009800,
2,63,2052,2115,0.0071641,0.0011027,
2,64,2052,2116,0.0078986,0.0012351,
2,65,2052,2117,0.0086645,0.0013540,
2,66,2052,2118,0.0094558,0.0014571,
2,67,2052,2119,0.0103010,0.0015592,
2,68,2052,2120,0.0112531,0.0016824,
2,69,2052,2121,0.0123584,0.0018391,
2,70,2052,2122,0.0136702,0.0020503,
2,71,2052,2123,0.0152518,0.0023632,
2,72,2052,2124,0.0170987,0.0027829,
2,73,2052,2125,0.0190837,0.0032375,
2,74,2052,2126,0.0210750,0.0036603,
2,75,2052,2127,0.0231062,0.0040632,
2,76,2052,2128,0.0253497,0.0045472,
2,77,2052,2129,0.0279666,0.0052069,
2,78,2052,2130,0.0310443,0.0060991,
2,79,2052,2131,0.0345982,0.0072404,
2,80,2052,2132,0.0395295,0.0094213,
2,81,2052,2133,0.0438328,0.0109379,
2,82,2052,2134,0.0485928,0.0126797,
2,83,2052,2135,0.0538556,0.0146680,
2,84,2052,2136,0.0596709,0.0169386,
2,85,2052,2137,0.0660929,0.0195765,
2,86,2052,2138,0.0731799,0.0226662,
2,87,2052,2139,0.0809950,0.0262411,
2,88,2052,2140,0.0896059,0.0303302,
2,89,2052,2141,0.0990850,0.0350017,
2,90,2052,2142,0.1095094,0.0404040,
2,91,2052,2143,0.1209607,0.0466819,
2,92,2052,2144,0.1335249,0.0539382,
2,93,2052,2145,0.1472918,0.0622957,
2,94,2052,2146,0.1623547,0.0719439,
2,95,2052,2147,0.1788093,0.0831162,
2,96,2052,2148,0.1967531,0.0960434,
2,97,2052,2149,0.2162837,0.1109236,
2,98,2052,2150,0.2374976,0.1279899,
2,0,2053,2053,0.0077996,0.0014414,
2,1,2053,2054,0.0005341,0.0000377,
2,2,2053,2055,0.0002805,0.0000216,
2,3,2053,2056,0.0001960,0.0000168,
2,4,2053,2057,0.0001520,0.0000135,
2,5,2053,2058,0.0001465,0.0000152,
2,6,2053,2059,0.0001399,0.0000164,
2,7,2053,2060,0.0001348,0.0000175,
2,8,2053,2061,0.0001336,0.0000195,
2,9,2053,2062,0.0001377,0.0000228,
2,10,2053,2063,0.0001465,0.0000277,
2,11,2053,2064,0.0001596,0.0000342,
2,12,2053,2065,0.0001783,0.0000428,
2,13,2053,2066,0.0002061,0.0000552,
2,14,2053,2067,0.0002415,0.0000711,
2,15,2053,2068,0.0002756,0.0000854,
2,16,2053,2069,0.0003003,0.0000921,
2,17,2053,2070,0.0003175,0.0000915,
2,18,2053,2071,0.0003342,0.0000902,
2,19,2053,2072,0.0003539,0.0000920,
2,20,2053,2073,0.0003732,0.0000948,
2,21,2053,2074,0.0003859,0.0000938,
2,22,2053,2075,0.0003897,0.0000875,
2,23,2053,2076,0.0003908,0.0000801,
2,24,2053,2077,0.0003983,0.0000773,
2,25,2053,2078,0.0004147,0.0000792,
2,26,2053,2079,0.0004348,0.0000826,
2,27,2053,2080,0.0004528,0.0000839,
2,28,2053,2081,0.0004684,0.0000854,
2,29,2053,2082,0.0004856,0.0000871,
2,30,2053,2083,0.0005091,0.0000902,
2,31,2053,2084,0.0005408,0.0000944,
2,32,2053,2085,0.0005796,0.0000989,
2,33,2053,2086,0.0006220,0.0001025,
2,34,2053,2087,0.0006665,0.0001056,
2,35,2053,2088,0.0007153,0.0001085,
2,36,2053,2089,0.0007710,0.0001148,
2,37,2053,2090,0.0008314,0.0001208,
2,38,2053,2091,0.0008908,0.0001282,
2,39,2053,2092,0.0009481,0.0001381,
2,40,2053,2093,0.0010090,0.0001504,
2,41,2053,2094,0.0010784,0.0001634,
2,42,2053,2095,0.0011559,0.0001767,
2,43,2053,2096,0.0012427,0.0001938,
2,44,2053,2097,0.0013435,0.0002200,
2,45,2053,2098,0.0014588,0.0002507,
2,46,2053,2099,0.0015840,0.0002836,
2,47,2053,2100,0.0017152,0.0003109,
2,48,2053,2101,0.0018531,0.0003360,
2,49,2053,2102,0.0020059,0.0003625,
2,50,2053,2103,0.0021845,0.0003884,
2,51,2053,2104,0.0023896,0.0004119,
2,52,2053,2105,0.0026115,0.0004334,
2,53,2053,2106,0.0028474,0.0004589,
2,54,2053,2107,0.0031082,0.0004998,
2,55,2053,2108,0.0034035,0.0005497,
2,56,2053,2109,0.0037277,0.0006006,
2,57,2053,2110,0.0040692,0.0006390,
2,58,2053,2111,0.0044295,0.0006718,
2,59,2053,2112,0.0048296,0.0007141,
2,60,2053,2113,0.0052973,0.0007768,
2,61,2053,2114,0.0058480,0.0008602,
2,62,2053,2115,0.0064757,0.0009613,
2,63,2053,2116,0.0071641,0.0010815,
2,64,2053,2117,0.0078986,0.0012131,
2,65,2053,2118,0.0086645,0.0013317,
2,66,2053,2119,0.0094558,0.0014324,
2,67,2053,2120,0.0103010,0.0015304,
2,68,2053,2121,0.0112531,0.0016507,
2,69,2053,2122,0.0123584,0.0018066,
2,70,2053,2123,0.0136702,0.0020171,
2,71,2053,2124,0.0152518,0.0023249,
2,72,2053,2125,0.0170987,0.0027353,
2,73,2053,2126,0.0190837,0.0031827,
2,74,2053,2127,0.0210750,0.0036031,
2,75,2053,2128,0.0231062,0.0040053,
2,76,2053,2129,0.0253497,0.0044823,
2,77,2053,2130,0.0279666,0.0051285,
2,78,2053,2131,0.0310443,0.0060088,
2,79,2053,2132,0.0345982,0.0071441,
2,80,2053,2133,0.0395295,0.0093155,
2,81,2053,2134,0.0438328,0.0108166,
2,82,2053,2135,0.0485928,0.0125325,
2,83,2053,2136,0.0538556,0.0145005,
2,84,2053,2137,0.0596709,0.0167634,
2,85,2053,2138,0.0660929,0.0193963,
2,86,2053,2139,0.0731799,0.0224611,
2,87,2053,2140,0.0809950,0.0259941,
2,88,2053,2141,0.0896059,0.0300511,
2,89,2053,2142,0.0990850,0.0347123,
2,90,2053,2143,0.1095094,0.0401100,
2,91,2053,2144,0.1209607,0.0463526,
2,92,2053,2145,0.1335249,0.0535466,
2,93,2053,2146,0.1472918,0.0618588,
2,94,2053,2147,0.1623547,0.0714969,
2,95,2053,2148,0.1788093,0.0826669,
2,96,2053,2149,0.1967531,0.0955455,
2,97,2053,2150,0.2162837,0.1103426,
2,0,2054,2054,0.0077996,0.0013841,
2,1,2054,2055,0.0005341,0.0000352,
2,2,2054,2056,0.0002805,0.0000202,
2,3,2054,2057,0.0001960,0.0000159,
2,4,2054,2058,0.0001520,0.0000128,
2,5,2054,2059,0.0001465,0.0000145,
2,6,2054,2060,0.0001399,0.0000156,
2,7,2054,2061,0.0001348,0.0000167,
2,8,2054,2062,0.0001336,0.0000187,
2,9,2054,2063,0.0001377,0.0000220,
2,10,2054,2064,0.0001465,0.0000268,
2,11,2054,2065,0.0001596,0.0000331,
2,12,2054,2066,0.0001783,0.0000416,
2,13,2054,2067,0.0002061,0.0000538,
2,14,2054,2068,0.0002415,0.0000697,
2,15,2054,2069,0.0002756,0.0000837,
2,16,2054,2070,0.0003003,0.0000901,
2,17,2054,2071,0.0003175,0.0000894,
2,18,2054,2072,0.0003342,0.0000882,
2,19,2054,2073,0.0003539,0.0000900,
2,20,2054,2074,0.0003732,0.0000928,
2,21,2054,2075,0.0003859,0.0000915,
2,22,2054,2076,0.0003897,0.0000853,
2,23,2054,2077,0.0003908,0.0000782,
2,24,2054,2078,0.0003983,0.0000755,
2,25,2054,2079,0.0004147,0.0000773,
2,26,2054,2080,0.0004348,0.0000805,
2,27,2054,2081,0.0004528,0.0000817,
2,28,2054,2082,0.0004684,0.0000833,
2,29,2054,2083,0.0004856,0.0000851,
2,30,2054,2084,0.0005091,0.0000881,
2,31,2054,2085,0.0005408,0.0000921,
2,32,2054,2086,0.0005796,0.0000964,
2,33,2054,2087,0.0006220,0.0001000,
2,34,2054,2088,0.0006665,0.0001032,
2,35,2054,2089,0.0007153,0.0001060,
2,36,2054,2090,0.0007710,0.0001119,
2,37,2054,2091,0.0008314,0.0001176,
2,38,2054,2092,0.0008908,0.0001250,
2,39,2054,2093,0.0009481,0.0001350,
2,40,2054,2094,0.0010090,0.0001470,
2,41,2054,2095,0.0010784,0.0001595,
2,42,2054,2096,0.0011559,0.0001724,
2,43,2054,2097,0.0012427,0.0001895,
2,44,2054,2098,0.0013435,0.0002156,
2,45,2054,2099,0.0014588,0.0002457,
2,46,2054,2100,0.0015840,0.0002777,
2,47,2054,2101,0.0017152,0.0003045,
2,48,2054,2102,0.0018531,0.0003295,
2,49,2054,2103,0.0020059,0.0003561,
2,50,2054,2104,0.0021845,0.0003814,
2,51,2054,2105,0.0023896,0.0004038,
2,52,2054,2106,0.0026115,0.0004246,
2,53,2054,2107,0.0028474,0.0004501,
2,54,2054,2108,0.0031082,0.0004909,
2,55,2054,2109,0.0034035,0.0005398,
2,56,2054,2110,0.0037277,0.0005889,
2,57,2054,2111,0.0040692,0.0006261,
2,58,2054,2112,0.0044295,0.0006590,
2,59,2054,2113,0.0048296,0.0007015,
2,60,2054,2114,0.0052973,0.0007628,
2,61,2054,2115,0.0058480,0.0008435,
2,62,2054,2116,0.0064757,0.0009424,
2,63,2054,2117,0.0071641,0.0010619,
2,64,2054,2118,0.0078986,0.0011930,
2,65,2054,2119,0.0086645,0.0013092,
2,66,2054,2120,0.0094558,0.0014060,
2,67,2054,2121,0.0103010,0.0015015,
2,68,2054,2122,0.0112531,0.0016214,
2,69,2054,2123,0.0123584,0.0017770,
2,70,2054,2124,0.0136702,0.0019835,
2,71,2054,2125,0.0152518,0.0022837,
2,72,2054,2126,0.0170987,0.0026875,
2,73,2054,2127,0.0190837,0.0031318,
2,74,2054,2128,0.0210750,0.0035511,
2,75,2054,2129,0.0231062,0.0039471,
2,76,2054,2130,0.0253497,0.0044128,
2,77,2054,2131,0.0279666,0.0050494,
2,78,2054,2132,0.0310443,0.0059249,
2,79,2054,2133,0.0345982,0.0070559,
2,80,2054,2134,0.0395295,0.0092080,
2,81,2054,2135,0.0438328,0.0106859,
2,82,2054,2136,0.0485928,0.0123835,
2,83,2054,2137,0.0538556,0.0143444,
2,84,2054,2138,0.0596709,0.0166026,
2,85,2054,2139,0.0660929,0.0192130,
2,86,2054,2140,0.0731799,0.0222398,
2,87,2054,2141,0.0809950,0.0257434,
2,88,2054,2142,0.0896059,0.0297907,
2,89,2054,2143,0.0990850,0.0344470,
2,90,2054,2144,0.1095094,0.0398121,
2,91,2054,2145,0.1209607,0.0459971,
2,92,2054,2146,0.1335249,0.0531485,
2,93,2054,2147,0.1472918,0.0614498,
2,94,2054,2148,0.1623547,0.0710838,
2,95,2054,2149,0.1788093,0.0822066,
2,96,2054,2150,0.1967531,0.0950051,
2,0,2055,2055,0.0077996,0.0013241,
2,1,2055,2056,0.0005341,0.0000329,
2,2,2055,2057,0.0002805,0.0000190,
2,3,2055,2058,0.0001960,0.0000151,
2,4,2055,2059,0.0001520,0.0000121,
2,5,2055,2060,0.0001465,0.0000138,
2,6,2055,2061,0.0001399,0.0000148,
2,7,2055,2062,0.0001348,0.0000160,
2,8,2055,2063,0.0001336,0.0000180,
2,9,2055,2064,0.0001377,0.0000212,
2,10,2055,2065,0.0001465,0.0000259,
2,11,2055,2066,0.0001596,0.0000321,
2,12,2055,2067,0.0001783,0.0000404,
2,13,2055,2068,0.0002061,0.0000526,
2,14,2055,2069,0.0002415,0.0000682,
2,15,2055,2070,0.0002756,0.0000819,
2,16,2055,2071,0.0003003,0.0000881,
2,17,2055,2072,0.0003175,0.0000875,
2,18,2055,2073,0.0003342,0.0000863,
2,19,2055,2074,0.0003539,0.0000881,
2,20,2055,2075,0.0003732,0.0000906,
2,21,2055,2076,0.0003859,0.0000893,
2,22,2055,2077,0.0003897,0.0000832,
2,23,2055,2078,0.0003908,0.0000764,
2,24,2055,2079,0.0003983,0.0000737,
2,25,2055,2080,0.0004147,0.0000753,
2,26,2055,2081,0.0004348,0.0000783,
2,27,2055,2082,0.0004528,0.0000797,
2,28,2055,2083,0.0004684,0.0000814,
2,29,2055,2084,0.0004856,0.0000831,
2,30,2055,2085,0.0005091,0.0000859,
2,31,2055,2086,0.0005408,0.0000897,
2,32,2055,2087,0.0005796,0.0000941,
2,33,2055,2088,0.0006220,0.0000978,
2,34,2055,2089,0.0006665,0.0001008,
2,35,2055,2090,0.0007153,0.0001033,
2,36,2055,2091,0.0007710,0.0001089,
2,37,2055,2092,0.0008314,0.0001147,
2,38,2055,2093,0.0008908,0.0001222,
2,39,2055,2094,0.0009481,0.0001319,
2,40,2055,2095,0.0010090,0.0001434,
2,41,2055,2096,0.0010784,0.0001556,
2,42,2055,2097,0.0011559,0.0001685,
2,43,2055,2098,0.0012427,0.0001856,
2,44,2055,2099,0.0013435,0.0002112,
2,45,2055,2100,0.0014588,0.0002405,
2,46,2055,2101,0.0015840,0.0002718,
2,47,2055,2102,0.0017152,0.0002985,
2,48,2055,2103,0.0018531,0.0003237,
2,49,2055,2104,0.0020059,0.0003497,
2,50,2055,2105,0.0021845,0.0003740,
2,51,2055,2106,0.0023896,0.0003957,
2,52,2055,2107,0.0026115,0.0004164,
2,53,2055,2108,0.0028474,0.0004420,
2,54,2055,2109,0.0031082,0.0004819,
2,55,2055,2110,0.0034035,0.0005291,
2,56,2055,2111,0.0037277,0.0005771,
2,57,2055,2112,0.0040692,0.0006143,
2,58,2055,2113,0.0044295,0.0006474,
2,59,2055,2114,0.0048296,0.0006888,
2,60,2055,2115,0.0052973,0.0007478,
2,61,2055,2116,0.0058480,0.0008267,
2,62,2055,2117,0.0064757,0.0009250,
2,63,2055,2118,0.0071641,0.0010440,
2,64,2055,2119,0.0078986,0.0011726,
2,65,2055,2120,0.0086645,0.0012850,
2,66,2055,2121,0.0094558,0.0013794,
2,67,2055,2122,0.0103010,0.0014747,
2,68,2055,2123,0.0112531,0.0015946,
2,69,2055,2124,0.0123584,0.0017470,
2,70,2055,2125,0.0136702,0.0019475,
2,71,2055,2126,0.0152518,0.0022423,
2,72,2055,2127,0.0170987,0.0026431,
2,73,2055,2128,0.0190837,0.0030855,
2,74,2055,2129,0.0210750,0.0034986,
2,75,2055,2130,0.0231062,0.0038847,
2,76,2055,2131,0.0253497,0.0043427,
2,77,2055,2132,0.0279666,0.0049760,
2,78,2055,2133,0.0310443,0.0058482,
2,79,2055,2134,0.0345982,0.0069665,
2,80,2055,2135,0.0395295,0.0090923,
2,81,2055,2136,0.0438328,0.0105537,
2,82,2055,2137,0.0485928,0.0122448,
2,83,2055,2138,0.0538556,0.0142011,
2,84,2055,2139,0.0596709,0.0164390,
2,85,2055,2140,0.0660929,0.0190152,
2,86,2055,2141,0.0731799,0.0220154,
2,87,2055,2142,0.0809950,0.0255097,
2,88,2055,2143,0.0896059,0.0295520,
2,89,2055,2144,0.0990850,0.0341782,
2,90,2055,2145,0.1095094,0.0394904,
2,91,2055,2146,0.1209607,0.0456358,
2,92,2055,2147,0.1335249,0.0527760,
2,93,2055,2148,0.1472918,0.0610721,
2,94,2055,2149,0.1623547,0.0706609,
2,95,2055,2150,0.1788093,0.0817073,
2,0,2056,2056,0.0077996,0.0012654,
2,1,2056,2057,0.0005341,0.0000308,
2,2,2056,2058,0.0002805,0.0000179,
2,3,2056,2059,0.0001960,0.0000143,
2,4,2056,2060,0.0001520,0.0000115,
2,5,2056,2061,0.0001465,0.0000130,
2,6,2056,2062,0.0001399,0.0000141,
2,7,2056,2063,0.0001348,0.0000154,
2,8,2056,2064,0.0001336,0.0000174,
2,9,2056,2065,0.0001377,0.0000204,
2,10,2056,2066,0.0001465,0.0000250,
2,11,2056,2067,0.0001596,0.0000311,
2,12,2056,2068,0.0001783,0.0000394,
2,13,2056,2069,0.0002061,0.0000514,
2,14,2056,2070,0.0002415,0.0000666,
2,15,2056,2071,0.0002756,0.0000800,
2,16,2056,2072,0.0003003,0.0000863,
2,17,2056,2073,0.0003175,0.0000857,
2,18,2056,2074,0.0003342,0.0000845,
2,19,2056,2075,0.0003539,0.0000860,
2,20,2056,2076,0.0003732,0.0000884,
2,21,2056,2077,0.0003859,0.0000873,
2,22,2056,2078,0.0003897,0.0000814,
2,23,2056,2079,0.0003908,0.0000746,
2,24,2056,2080,0.0003983,0.0000718,
2,25,2056,2081,0.0004147,0.0000733,
2,26,2056,2082,0.0004348,0.0000764,
2,27,2056,2083,0.0004528,0.0000779,
2,28,2056,2084,0.0004684,0.0000795,
2,29,2056,2085,0.0004856,0.0000810,
2,30,2056,2086,0.0005091,0.0000837,
2,31,2056,2087,0.0005408,0.0000876,
2,32,2056,2088,0.0005796,0.0000919,
2,33,2056,2089,0.0006220,0.0000955,
2,34,2056,2090,0.0006665,0.0000982,
2,35,2056,2091,0.0007153,0.0001005,
2,36,2056,2092,0.0007710,0.0001062,
2,37,2056,2093,0.0008314,0.0001121,
2,38,2056,2094,0.0008908,0.0001193,
2,39,2056,2095,0.0009481,0.0001286,
2,40,2056,2096,0.0010090,0.0001398,
2,41,2056,2097,0.0010784,0.0001520,
2,42,2056,2098,0.0011559,0.0001649,
2,43,2056,2099,0.0012427,0.0001816,
2,44,2056,2100,0.0013435,0.0002065,
2,45,2056,2101,0.0014588,0.0002352,
2,46,2056,2102,0.0015840,0.0002664,
2,47,2056,2103,0.0017152,0.0002931,
2,48,2056,2104,0.0018531,0.0003178,
2,49,2056,2105,0.0020059,0.0003429,
2,50,2056,2106,0.0021845,0.0003665,
2,51,2056,2107,0.0023896,0.0003882,
2,52,2056,2108,0.0026115,0.0004090,
2,53,2056,2109,0.0028474,0.0004338,
2,54,2056,2110,0.0031082,0.0004723,
2,55,2056,2111,0.0034035,0.0005185,
2,56,2056,2112,0.0037277,0.0005662,
2,57,2056,2113,0.0040692,0.0006035,
2,58,2056,2114,0.0044295,0.0006357,
2,59,2056,2115,0.0048296,0.0006752,
2,60,2056,2116,0.0052973,0.0007328,
2,61,2056,2117,0.0058480,0.0008112,
2,62,2056,2118,0.0064757,0.0009091,
2,63,2056,2119,0.0071641,0.0010258,
2,64,2056,2120,0.0078986,0.0011508,
2,65,2056,2121,0.0086645,0.0012606,
2,66,2056,2122,0.0094558,0.0013548,
2,67,2056,2123,0.0103010,0.0014503,
2,68,2056,2124,0.0112531,0.0015675,
2,69,2056,2125,0.0123584,0.0017148,
2,70,2056,2126,0.0136702,0.0019113,
2,71,2056,2127,0.0152518,0.0022040,
2,72,2056,2128,0.0170987,0.0026028,
2,73,2056,2129,0.0190837,0.0030389,
2,74,2056,2130,0.0210750,0.0034424,
2,75,2056,2131,0.0231062,0.0038218,
2,76,2056,2132,0.0253497,0.0042777,
2,77,2056,2133,0.0279666,0.0049089,
2,78,2056,2134,0.0310443,0.0057705,
2,79,2056,2135,0.0345982,0.0068703,
2,80,2056,2136,0.0395295,0.0089753,
2,81,2056,2137,0.0438328,0.0104307,
2,82,2056,2138,0.0485928,0.0121175,
2,83,2056,2139,0.0538556,0.0140555,
2,84,2056,2140,0.0596709,0.0162626,
2,85,2056,2141,0.0660929,0.0188147,
2,86,2056,2142,0.0731799,0.0218061,
2,87,2056,2143,0.0809950,0.0252955,
2,88,2056,2144,0.0896059,0.0293102,
2,89,2056,2145,0.0990850,0.0338882,
2,90,2056,2146,0.1095094,0.0391637,
2,91,2056,2147,0.1209607,0.0452979,
2,92,2056,2148,0.1335249,0.0524321,
2,93,2056,2149,0.1472918,0.0606854,
2,94,2056,2150,0.1623547,0.0702022,
2,0,2057,2057,0.0077996,0.0012124,
2,1,2057,2058,0.0005341,0.0000290,
2,2,2057,2059,0.0002805,0.0000169,
2,3,2057,2060,0.0001960,0.0000134,
2,4,2057,2061,0.0001520,0.0000108,
2,5,2057,2062,0.0001465,0.0000124,
2,6,2057,2063,0.0001399,0.0000135,
2,7,2057,2064,0.0001348,0.0000148,
2,8,2057,2065,0.0001336,0.0000166,
2,9,2057,2066,0.0001377,0.0000197,
2,10,2057,2067,0.0001465,0.0000241,
2,11,2057,2068,0.0001596,0.0000302,
2,12,2057,2069,0.0001783,0.0000384,
2,13,2057,2070,0.0002061,0.0000501,
2,14,2057,2071,0.0002415,0.0000650,
2,15,2057,2072,0.0002756,0.0000783,
2,16,2057,2073,0.0003003,0.0000846,
2,17,2057,2074,0.0003175,0.0000840,
2,18,2057,2075,0.0003342,0.0000826,
2,19,2057,2076,0.0003539,0.0000840,
2,20,2057,2077,0.0003732,0.0000864,
2,21,2057,2078,0.0003859,0.0000854,
2,22,2057,2079,0.0003897,0.0000796,
2,23,2057,2080,0.0003908,0.0000727,
2,24,2057,2081,0.0003983,0.0000698,
2,25,2057,2082,0.0004147,0.0000715,
2,26,2057,2083,0.0004348,0.0000747,
2,27,2057,2084,0.0004528,0.0000760,
2,28,2057,2085,0.0004684,0.0000774,
2,29,2057,2086,0.0004856,0.0000789,
2,30,2057,2087,0.0005091,0.0000817,
2,31,2057,2088,0.0005408,0.0000856,
2,32,2057,2089,0.0005796,0.0000898,
2,33,2057,2090,0.0006220,0.0000931,
2,34,2057,2091,0.0006665,0.0000956,
2,35,2057,2092,0.0007153,0.0000981,
2,36,2057,2093,0.0007710,0.0001038,
2,37,2057,2094,0.0008314,0.0001095,
2,38,2057,2095,0.0008908,0.0001163,
2,39,2057,2096,0.0009481,0.0001253,
2,40,2057,2097,0.0010090,0.0001365,
2,41,2057,2098,0.0010784,0.0001487,
2,42,2057,2099,0.0011559,0.0001613,
2,43,2057,2100,0.0012427,0.0001774,
2,44,2057,2101,0.0013435,0.0002018,
2,45,2057,2102,0.0014588,0.0002304,
2,46,2057,2103,0.0015840,0.0002615,
2,47,2057,2104,0.0017152,0.0002877,
2,48,2057,2105,0.0018531,0.0003115,
2,49,2057,2106,0.0020059,0.0003360,
2,50,2057,2107,0.0021845,0.0003596,
2,51,2057,2108,0.0023896,0.0003814,
2,52,2057,2109,0.0026115,0.0004015,
2,53,2057,2110,0.0028474,0.0004251,
2,54,2057,2111,0.0031082,0.0004626,
2,55,2057,2112,0.0034035,0.0005086,
2,56,2057,2113,0.0037277,0.0005563,
2,57,2057,2114,0.0040692,0.0005926,
2,58,2057,2115,0.0044295,0.0006231,
2,59,2057,2116,0.0048296,0.0006615,
2,60,2057,2117,0.0052973,0.0007189,
2,61,2057,2118,0.0058480,0.0007970,
2,62,2057,2119,0.0064757,0.0008930,
2,63,2057,2120,0.0071641,0.0010063,
2,64,2057,2121,0.0078986,0.0011288,
2,65,2057,2122,0.0086645,0.0012381,
2,66,2057,2123,0.0094558,0.0013324,
2,67,2057,2124,0.0103010,0.0014256,
2,68,2057,2125,0.0112531,0.0015384,
2,69,2057,2126,0.0123584,0.0016825,
2,70,2057,2127,0.0136702,0.0018778,
2,71,2057,2128,0.0152518,0.0021692,
2,72,2057,2129,0.0170987,0.0025622,
2,73,2057,2130,0.0190837,0.0029890,
2,74,2057,2131,0.0210750,0.0033858,
2,75,2057,2132,0.0231062,0.0037635,
2,76,2057,2133,0.0253497,0.0042183,
2,77,2057,2134,0.0279666,0.0048409,
2,78,2057,2135,0.0310443,0.0056869,
2,79,2057,2136,0.0345982,0.0067732,
2,80,2057,2137,0.0395295,0.0088664,
2,81,2057,2138,0.0438328,0.0103179,
2,82,2057,2139,0.0485928,0.0119881,
2,83,2057,2140,0.0538556,0.0138985,
2,84,2057,2141,0.0596709,0.0160839,
2,85,2057,2142,0.0660929,0.0186278,
2,86,2057,2143,0.0731799,0.0216145,
2,87,2057,2144,0.0809950,0.0250786,
2,88,2057,2145,0.0896059,0.0290494,
2,89,2057,2146,0.0990850,0.0335937,
2,90,2057,2147,0.1095094,0.0388583,
2,91,2057,2148,0.1209607,0.0449860,
2,92,2057,2149,0.1335249,0.0520801,
2,93,2057,2150,0.1472918,0.0602662,
2,0,2058,2058,0.0077996,0.0011654,
2,1,2058,2059,0.0005341,0.0000272,
2,2,2058,2060,0.0002805,0.0000159,
2,3,2058,2061,0.0001960,0.0000126,
2,4,2058,2062,0.0001520,0.0000102,
2,5,2058,2063,0.0001465,0.0000118,
2,6,2058,2064,0.0001399,0.0000129,
2,7,2058,2065,0.0001348,0.0000141,
2,8,2058,2066,0.0001336,0.0000159,
2,9,2058,2067,0.0001377,0.0000189,
2,10,2058,2068,0.0001465,0.0000234,
2,11,2058,2069,0.0001596,0.0000294,
2,12,2058,2070,0.0001783,0.0000373,
2,13,2058,2071,0.0002061,0.0000488,
2,14,2058,2072,0.0002415,0.0000635,
2,15,2058,2073,0.0002756,0.0000768,
2,16,2058,2074,0.0003003,0.0000829,
2,17,2058,2075,0.0003175,0.0000821,
2,18,2058,2076,0.0003342,0.0000806,
2,19,2058,2077,0.0003539,0.0000821,
2,20,2058,2078,0.0003732,0.0000846,
2,21,2058,2079,0.0003859,0.0000836,
2,22,2058,2080,0.0003897,0.0000776,
2,23,2058,2081,0.0003908,0.0000708,
2,24,2058,2082,0.0003983,0.0000681,
2,25,2058,2083,0.0004147,0.0000698,
2,26,2058,2084,0.0004348,0.0000729,
2,27,2058,2085,0.0004528,0.0000741,
2,28,2058,2086,0.0004684,0.0000754,
2,29,2058,2087,0.0004856,0.0000770,
2,30,2058,2088,0.0005091,0.0000798,
2,31,2058,2089,0.0005408,0.0000836,
2,32,2058,2090,0.0005796,0.0000876,
2,33,2058,2091,0.0006220,0.0000907,
2,34,2058,2092,0.0006665,0.0000933,
2,35,2058,2093,0.0007153,0.0000958,
2,36,2058,2094,0.0007710,0.0001013,
2,37,2058,2095,0.0008314,0.0001066,
2,38,2058,2096,0.0008908,0.0001133,
2,39,2058,2097,0.0009481,0.0001223,
2,40,2058,2098,0.0010090,0.0001335,
2,41,2058,2099,0.0010784,0.0001455,
2,42,2058,2100,0.0011559,0.0001575,
2,43,2058,2101,0.0012427,0.0001732,
2,44,2058,2102,0.0013435,0.0001975,
2,45,2058,2103,0.0014588,0.0002260,
2,46,2058,2104,0.0015840,0.0002566,
2,47,2058,2105,0.0017152,0.0002820,
2,48,2058,2106,0.0018531,0.0003053,
2,49,2058,2107,0.0020059,0.0003297,
2,50,2058,2108,0.0021845,0.0003533,
2,51,2058,2109,0.0023896,0.0003744,
2,52,2058,2110,0.0026115,0.0003934,
2,53,2058,2111,0.0028474,0.0004163,
2,54,2058,2112,0.0031082,0.0004537,
2,55,2058,2113,0.0034035,0.0004996,
2,56,2058,2114,0.0037277,0.0005463,
2,57,2058,2115,0.0040692,0.0005811,
2,58,2058,2116,0.0044295,0.0006106,
2,59,2058,2117,0.0048296,0.0006489,
2,60,2058,2118,0.0052973,0.0007062,
2,61,2058,2119,0.0058480,0.0007827,
2,62,2058,2120,0.0064757,0.0008757,
2,63,2058,2121,0.0071641,0.0009867,
2,64,2058,2122,0.0078986,0.0011085,
2,65,2058,2123,0.0086645,0.0012176,
2,66,2058,2124,0.0094558,0.0013097,
2,67,2058,2125,0.0103010,0.0013991,
2,68,2058,2126,0.0112531,0.0015092,
2,69,2058,2127,0.0123584,0.0016527,
2,70,2058,2128,0.0136702,0.0018474,
2,71,2058,2129,0.0152518,0.0021342,
2,72,2058,2130,0.0170987,0.0025188,
2,73,2058,2131,0.0190837,0.0029388,
2,74,2058,2132,0.0210750,0.0033333,
2,75,2058,2133,0.0231062,0.0037102,
2,76,2058,2134,0.0253497,0.0041581,
2,77,2058,2135,0.0279666,0.0047679,
2,78,2058,2136,0.0310443,0.0056026,
2,79,2058,2137,0.0345982,0.0066830,
2,80,2058,2138,0.0395295,0.0087666,
2,81,2058,2139,0.0438328,0.0102032,
2,82,2058,2140,0.0485928,0.0118487,
2,83,2058,2141,0.0538556,0.0137395,
2,84,2058,2142,0.0596709,0.0159174,
2,85,2058,2143,0.0660929,0.0184568,
2,86,2058,2144,0.0731799,0.0214205,
2,87,2058,2145,0.0809950,0.0248449,
2,88,2058,2146,0.0896059,0.0287847,
2,89,2058,2147,0.0990850,0.0333185,
2,90,2058,2148,0.1095094,0.0385765,
2,91,2058,2149,0.1209607,0.0446670,
2,92,2058,2150,0.1335249,0.0516988,
2,0,2059,2059,0.0077996,0.0011191,
2,1,2059,2060,0.0005341,0.0000255,
2,2,2059,2061,0.0002805,0.0000149,
2,3,2059,2062,0.0001960,0.0000119,
2,4,2059,2063,0.0001520,0.0000097,
2,5,2059,2064,0.0001465,0.0000113,
2,6,2059,2065,0.0001399,0.0000123,
2,7,2059,2066,0.0001348,0.0000135,
2,8,2059,2067,0.0001336,0.0000153,
2,9,2059,2068,0.0001377,0.0000183,
2,10,2059,2069,0.0001465,0.0000227,
2,11,2059,2070,0.0001596,0.0000285,
2,12,2059,2071,0.0001783,0.0000362,
2,13,2059,2072,0.0002061,0.0000476,
2,14,2059,2073,0.0002415,0.0000622,
2,15,2059,2074,0.0002756,0.0000753,
2,16,2059,2075,0.0003003,0.0000811,
2,17,2059,2076,0.0003175,0.0000802,
2,18,2059,2077,0.0003342,0.0000788,
2,19,2059,2078,0.0003539,0.0000804,
2,20,2059,2079,0.0003732,0.0000828,
2,21,2059,2080,0.0003859,0.0000816,
2,22,2059,2081,0.0003897,0.0000756,
2,23,2059,2082,0.0003908,0.0000690,
2,24,2059,2083,0.0003983,0.0000665,
2,25,2059,2084,0.0004147,0.0000681,
2,26,2059,2085,0.0004348,0.0000710,
2,27,2059,2086,0.0004528,0.0000722,
2,28,2059,2087,0.0004684,0.0000736,
2,29,2059,2088,0.0004856,0.0000752,
2,30,2059,2089,0.0005091,0.0000780,
2,31,2059,2090,0.0005408,0.0000815,
2,32,2059,2091,0.0005796,0.0000853,
2,33,2059,2092,0.0006220,0.0000885,
2,34,2059,2093,0.0006665,0.0000912,
2,35,2059,2094,0.0007153,0.0000935,
2,36,2059,2095,0.0007710,0.0000987,
2,37,2059,2096,0.0008314,0.0001038,
2,38,2059,2097,0.0008908,0.0001105,
2,39,2059,2098,0.0009481,0.0001195,
2,40,2059,2099,0.0010090,0.0001305,
2,41,2059,2100,0.0010784,0.0001420,
2,42,2059,2101,0.0011559,0.0001537,
2,43,2059,2102,0.0012427,0.0001694,
2,44,2059,2103,0.0013435,0.0001936,
2,45,2059,2104,0.0014588,0.0002216,
2,46,2059,2105,0.0015840,0.0002514,
2,47,2059,2106,0.0017152,0.0002762,
2,48,2059,2107,0.0018531,0.0002994,
2,49,2059,2108,0.0020059,0.0003239,
2,50,2059,2109,0.0021845,0.0003469,
2,51,2059,2110,0.0023896,0.0003670,
2,52,2059,2111,0.0026115,0.0003853,
2,53,2059,2112,0.0028474,0.0004082,
2,54,2059,2113,0.0031082,0.0004456,
2,55,2059,2114,0.0034035,0.0004906,
2,56,2059,2115,0.0037277,0.0005357,
2,57,2059,2116,0.0040692,0.0005695,
2,58,2059,2117,0.0044295,0.0005990,
2,59,2059,2118,0.0048296,0.0006374,
2,60,2059,2119,0.0052973,0.0006933,
2,61,2059,2120,0.0058480,0.0007673,
2,62,2059,2121,0.0064757,0.0008583,
2,63,2059,2122,0.0071641,0.0009686,
2,64,2059,2123,0.0078986,0.0010899,
2,65,2059,2124,0.0086645,0.0011968,
2,66,2059,2125,0.0094558,0.0012853,
2,67,2059,2126,0.0103010,0.0013724,
2,68,2059,2127,0.0112531,0.0014822,
2,69,2059,2128,0.0123584,0.0016255,
2,70,2059,2129,0.0136702,0.0018168,
2,71,2059,2130,0.0152518,0.0020967,
2,72,2059,2131,0.0170987,0.0024750,
2,73,2059,2132,0.0190837,0.0028922,
2,74,2059,2133,0.0210750,0.0032854,
2,75,2059,2134,0.0231062,0.0036562,
2,76,2059,2135,0.0253497,0.0040935,
2,77,2059,2136,0.0279666,0.0046943,
2,78,2059,2137,0.0310443,0.0055243,
2,79,2059,2138,0.0345982,0.0066003,
2,80,2059,2139,0.0395295,0.0086653,
2,81,2059,2140,0.0438328,0.0100798,
2,82,2059,2141,0.0485928,0.0117076,
2,83,2059,2142,0.0538556,0.0135915,
2,84,2059,2143,0.0596709,0.0157650,
2,85,2059,2144,0.0660929,0.0182838,
2,86,2059,2145,0.0731799,0.0212115,
2,87,2059,2146,0.0809950,0.0246077,
2,88,2059,2147,0.0896059,0.0285375,
2,89,2059,2148,0.0990850,0.0330647,
2,90,2059,2149,0.1095094,0.0382884,
2,91,2059,2150,0.1209607,0.0443215,
2,0,2060,2060,0.0077996,0.0010708,
2,1,2060,2061,0.0005341,0.0000238,
2,2,2060,2062,0.0002805,0.0000140,
2,3,2060,2063,0.0001960,0.0000113,
2,4,2060,2064,0.0001520,0.0000092,
2,5,2060,2065,0.0001465,0.0000107,
2,6,2060,2066,0.0001399,0.0000117,
2,7,2060,2067,0.0001348,0.0000129,
2,8,2060,2068,0.0001336,0.0000147,
2,9,2060,2069,0.0001377,0.0000177,
2,10,2060,2070,0.0001465,0.0000219,
2,11,2060,2071,0.0001596,0.0000276,
2,12,2060,2072,0.0001783,0.0000352,
2,13,2060,2073,0.0002061,0.0000465,
2,14,2060,2074,0.0002415,0.0000609,
2,15,2060,2075,0.0002756,0.0000736,
2,16,2060,2076,0.0003003,0.0000793,
2,17,2060,2077,0.0003175,0.0000785,
2,18,2060,2078,0.0003342,0.0000772,
2,19,2060,2079,0.0003539,0.0000787,
2,20,2060,2080,0.0003732,0.0000809,
2,21,2060,2081,0.0003859,0.0000796,
2,22,2060,2082,0.0003897,0.0000739,
2,23,2060,2083,0.0003908,0.0000674,
2,24,2060,2084,0.0003983,0.0000649,
2,25,2060,2085,0.0004147,0.0000664,
2,26,2060,2086,0.0004348,0.0000692,
2,27,2060,2087,0.0004528,0.0000704,
2,28,2060,2088,0.0004684,0.0000719,
2,29,2060,2089,0.0004856,0.0000735,
2,30,2060,2090,0.0005091,0.0000760,
2,31,2060,2091,0.0005408,0.0000794,
2,32,2060,2092,0.0005796,0.0000833,
2,33,2060,2093,0.0006220,0.0000865,
2,34,2060,2094,0.0006665,0.0000890,
2,35,2060,2095,0.0007153,0.0000911,
2,36,2060,2096,0.0007710,0.0000961,
2,37,2060,2097,0.0008314,0.0001013,
2,38,2060,2098,0.0008908,0.0001079,
2,39,2060,2099,0.0009481,0.0001168,
2,40,2060,2100,0.0010090,0.0001273,
2,41,2060,2101,0.0010784,0.0001385,
2,42,2060,2102,0.0011559,0.0001502,
2,43,2060,2103,0.0012427,0.0001659,
2,44,2060,2104,0.0013435,0.0001897,
2,45,2060,2105,0.0014588,0.0002169,
2,46,2060,2106,0.0015840,0.0002462,
2,47,2060,2107,0.0017152,0.0002709,
2,48,2060,2108,0.0018531,0.0002941,
2,49,2060,2109,0.0020059,0.0003180,
2,50,2060,2110,0.0021845,0.0003401,
2,51,2060,2111,0.0023896,0.0003595,
2,52,2060,2112,0.0026115,0.0003779,
2,53,2060,2113,0.0028474,0.0004009,
2,54,2060,2114,0.0031082,0.0004375,
2,55,2060,2115,0.0034035,0.0004810,
2,56,2060,2116,0.0037277,0.0005250,
2,57,2060,2117,0.0040692,0.0005587,
2,58,2060,2118,0.0044295,0.0005884,
2,59,2060,2119,0.0048296,0.0006257,
2,60,2060,2120,0.0052973,0.0006796,
2,61,2060,2121,0.0058480,0.0007519,
2,62,2060,2122,0.0064757,0.0008423,
2,63,2060,2123,0.0071641,0.0009521,
2,64,2060,2124,0.0078986,0.0010711,
2,65,2060,2125,0.0086645,0.0011746,
2,66,2060,2126,0.0094558,0.0012609,
2,67,2060,2127,0.0103010,0.0013478,
2,68,2060,2128,0.0112531,0.0014577,
2,69,2060,2129,0.0123584,0.0015982,
2,70,2060,2130,0.0136702,0.0017841,
2,71,2060,2131,0.0152518,0.0020590,
2,72,2060,2132,0.0170987,0.0024345,
2,73,2060,2133,0.0190837,0.0028496,
2,74,2060,2134,0.0210750,0.0032368,
2,75,2060,2135,0.0231062,0.0035983,
2,76,2060,2136,0.0253497,0.0040284,
2,77,2060,2137,0.0279666,0.0046259,
2,78,2060,2138,0.0310443,0.0054526,
2,79,2060,2139,0.0345982,0.0065165,
2,80,2060,2140,0.0395295,0.0085562,
2,81,2060,2141,0.0438328,0.0099549,
2,82,2060,2142,0.0485928,0.0115763,
2,83,2060,2143,0.0538556,0.0134561,
2,84,2060,2144,0.0596709,0.0156110,
2,85,2060,2145,0.0660929,0.0180974,
2,86,2060,2146,0.0731799,0.0209996,
2,87,2060,2147,0.0809950,0.0243862,
2,88,2060,2148,0.0896059,0.0283096,
2,89,2060,2149,0.0990850,0.0328053,
2,90,2060,2150,0.1095094,0.0379764,
2,0,2061,2061,0.0077995,0.0010235,
2,1,2061,2062,0.0005341,0.0000223,
2,2,2061,2063,0.0002805,0.0000132,
2,3,2061,2064,0.0001960,0.0000107,
2,4,2061,2065,0.0001520,0.0000087,
2,5,2061,2066,0.0001465,0.0000101,
2,6,2061,2067,0.0001399,0.0000112,
2,7,2061,2068,0.0001348,0.0000124,
2,8,2061,2069,0.0001336,0.0000142,
2,9,2061,2070,0.0001377,0.0000170,
2,10,2061,2071,0.0001465,0.0000211,
2,11,2061,2072,0.0001596,0.0000267,
2,12,2061,2073,0.0001783,0.0000343,
2,13,2061,2074,0.0002061,0.0000454,
2,14,2061,2075,0.0002415,0.0000595,
2,15,2061,2076,0.0002756,0.0000720,
2,16,2061,2077,0.0003003,0.0000777,
2,17,2061,2078,0.0003175,0.0000769,
2,18,2061,2079,0.0003342,0.0000756,
2,19,2061,2080,0.0003539,0.0000768,
2,20,2061,2081,0.0003732,0.0000790,
2,21,2061,2082,0.0003859,0.0000778,
2,22,2061,2083,0.0003897,0.0000722,
2,23,2061,2084,0.0003908,0.0000658,
2,24,2061,2085,0.0003983,0.0000632,
2,25,2061,2086,0.0004147,0.0000646,
2,26,2061,2087,0.0004348,0.0000675,
2,27,2061,2088,0.0004528,0.0000688,
2,28,2061,2089,0.0004684,0.0000702,
2,29,2061,2090,0.0004856,0.0000716,
2,30,2061,2091,0.0005091,0.0000741,
2,31,2061,2092,0.0005408,0.0000775,
2,32,2061,2093,0.0005796,0.0000814,
2,33,2061,2094,0.0006220,0.0000845,
2,34,2061,2095,0.0006665,0.0000868,
2,35,2061,2096,0.0007153,0.0000887,
2,36,2061,2097,0.0007710,0.0000937,
2,37,2061,2098,0.0008314,0.0000989,
2,38,2061,2099,0.0008908,0.0001054,
2,39,2061,2100,0.0009481,0.0001138,
2,40,2061,2101,0.0010090,0.0001241,
2,41,2061,2102,0.0010784,0.0001353,
2,42,2061,2103,0.0011559,0.0001471,
2,43,2061,2104,0.0012427,0.0001624,
2,44,2061,2105,0.0013435,0.0001855,
2,45,2061,2106,0.0014588,0.0002123,
2,46,2061,2107,0.0015840,0.0002413,
2,47,2061,2108,0.0017152,0.0002661,
2,48,2061,2109,0.0018531,0.0002888,
2,49,2061,2110,0.0020059,0.0003118,
2,50,2061,2111,0.0021845,0.0003332,
2,51,2061,2112,0.0023896,0.0003526,
2,52,2061,2113,0.0026115,0.0003711,
2,53,2061,2114,0.0028474,0.0003935,
2,54,2061,2115,0.0031082,0.0004288,
2,55,2061,2116,0.0034035,0.0004713,
2,56,2061,2117,0.0037277,0.0005152,
2,57,2061,2118,0.0040692,0.0005489,
2,58,2061,2119,0.0044295,0.0005777,
2,59,2061,2120,0.0048296,0.0006132,
2,60,2061,2121,0.0052973,0.0006657,
2,61,2061,2122,0.0058480,0.0007376,
2,62,2061,2123,0.0064757,0.0008276,
2,63,2061,2124,0.0071641,0.0009354,
2,64,2061,2125,0.0078986,0.0010510,
2,65,2061,2126,0.0086645,0.0011522,
2,66,2061,2127,0.0094558,0.0012383,
2,67,2061,2128,0.0103010,0.0013255,
2,68,2061,2129,0.0112531,0.0014331,
2,69,2061,2130,0.0123584,0.0015691,
2,70,2061,2131,0.0136702,0.0017512,
2,71,2061,2132,0.0152518,0.0020241,
2,72,2061,2133,0.0170987,0.0023975,
2,73,2061,2134,0.0190837,0.0028066,
2,74,2061,2135,0.0210750,0.0031848,
2,75,2061,2136,0.0231062,0.0035400,
2,76,2061,2137,0.0253497,0.0039680,
2,77,2061,2138,0.0279666,0.0045634,
2,78,2061,2139,0.0310443,0.0053800,
2,79,2061,2140,0.0345982,0.0064264,
2,80,2061,2141,0.0395295,0.0084460,
2,81,2061,2142,0.0438328,0.0098387,
2,82,2061,2143,0.0485928,0.0114563,
2,83,2061,2144,0.0538556,0.0133192,
2,84,2061,2145,0.0596709,0.0154451,
2,85,2061,2146,0.0660929,0.0179085,
2,86,2061,2147,0.0731799,0.0208018,
2,87,2061,2148,0.0809950,0.0241822,
2,88,2061,2149,0.0896059,0.0280768,
2,89,2061,2150,0.0990850,0.0325246,
2,0,2062,2062,0.0077995,0.0009808,
2,1,2062,2063,0.0005341,0.0000210,
2,2,2062,2064,0.0002805,0.0000125,
2,3,2062,2065,0.0001960,0.0000101,
2,4,2062,2066,0.0001520,0.0000082,
2,5,2062,2067,0.0001465,0.0000096,
2,6,2062,2068,0.0001399,0.0000107,
2,7,2062,2069,0.0001348,0.0000119,
2,8,2062,2070,0.0001336,0.0000136,
2,9,2062,2071,0.0001377,0.0000164,
2,10,2062,2072,0.0001465,0.0000204,
2,11,2062,2073,0.0001596,0.0000260,
2,12,2062,2074,0.0001783,0.0000335,
2,13,2062,2075,0.0002061,0.0000442,
2,14,2062,2076,0.0002415,0.0000581,
2,15,2062,2077,0.0002756,0.0000705,
2,16,2062,2078,0.0003003,0.0000762,
2,17,2062,2079,0.0003175,0.0000754,
2,18,2062,2080,0.0003342,0.0000738,
2,19,2062,2081,0.0003539,0.0000750,
2,20,2062,2082,0.0003732,0.0000772,
2,21,2062,2083,0.0003859,0.0000761,
2,22,2062,2084,0.0003897,0.0000706,
2,23,2062,2085,0.0003908,0.0000642,
2,24,2062,2086,0.0003983,0.0000615,
2,25,2062,2087,0.0004147,0.0000630,
2,26,2062,2088,0.0004348,0.0000659,
2,27,2062,2089,0.0004528,0.0000671,
2,28,2062,2090,0.0004684,0.0000684,
2,29,2062,2091,0.0004856,0.0000698,
2,30,2062,2092,0.0005091,0.0000723,
2,31,2062,2093,0.0005408,0.0000758,
2,32,2062,2094,0.0005796,0.0000795,
2,33,2062,2095,0.0006220,0.0000824,
2,34,2062,2096,0.0006665,0.0000845,
2,35,2062,2097,0.0007153,0.0000865,
2,36,2062,2098,0.0007710,0.0000916,
2,37,2062,2099,0.0008314,0.0000966,
2,38,2062,2100,0.0008908,0.0001027,
2,39,2062,2101,0.0009481,0.0001109,
2,40,2062,2102,0.0010090,0.0001212,
2,41,2062,2103,0.0010784,0.0001324,
2,42,2062,2104,0.0011559,0.0001439,
2,43,2062,2105,0.0012427,0.0001588,
2,44,2062,2106,0.0013435,0.0001814,
2,45,2062,2107,0.0014588,0.0002079,
2,46,2062,2108,0.0015840,0.0002369,
2,47,2062,2109,0.0017152,0.0002611,
2,48,2062,2110,0.0018531,0.0002830,
2,49,2062,2111,0.0020059,0.0003055,
2,50,2062,2112,0.0021845,0.0003269,
2,51,2062,2113,0.0023896,0.0003464,
2,52,2062,2114,0.0026115,0.0003643,
2,53,2062,2115,0.0028474,0.0003856,
2,54,2062,2116,0.0031082,0.0004201,
2,55,2062,2117,0.0034035,0.0004624,
2,56,2062,2118,0.0037277,0.0005062,
2,57,2062,2119,0.0040692,0.0005390,
2,58,2062,2120,0.0044295,0.0005662,
2,59,2062,2121,0.0048296,0.0006007,
2,60,2062,2122,0.0052973,0.0006530,
2,61,2062,2123,0.0058480,0.0007246,
2,62,2062,2124,0.0064757,0.0008128,
2,63,2062,2125,0.0071641,0.0009175,
2,64,2062,2126,0.0078986,0.0010308,
2,65,2062,2127,0.0086645,0.0011315,
2,66,2062,2128,0.0094558,0.0012178,
2,67,2062,2129,0.0103010,0.0013030,
2,68,2062,2130,0.0112531,0.0014067,
2,69,2062,2131,0.0123584,0.0015398,
2,70,2062,2132,0.0136702,0.0017207,
2,71,2062,2133,0.0152518,0.0019922,
2,72,2062,2134,0.0170987,0.0023601,
2,73,2062,2135,0.0190837,0.0027604,
2,74,2062,2136,0.0210750,0.0031323,
2,75,2062,2137,0.0231062,0.0034859,
2,76,2062,2138,0.0253497,0.0039127,
2,77,2062,2139,0.0279666,0.0045001,
2,78,2062,2140,0.0310443,0.0053020,
2,79,2062,2141,0.0345982,0.0063354,
2,80,2062,2142,0.0395295,0.0083434,
2,81,2062,2143,0.0438328,0.0097326,
2,82,2062,2144,0.0485928,0.0113350,
2,83,2062,2145,0.0538556,0.0131719,
2,84,2062,2146,0.0596709,0.0152771,
2,85,2062,2147,0.0660929,0.0177323,
2,86,2062,2148,0.0731799,0.0206196,
2,87,2062,2149,0.0809950,0.0239738,
2,88,2062,2150,0.0896059,0.0278249,
2,0,2063,2063,0.0077995,0.0009428,
2,1,2063,2064,0.0005341,0.0000197,
2,2,2063,2065,0.0002805,0.0000117,
2,3,2063,2066,0.0001960,0.0000095,
2,4,2063,2067,0.0001520,0.0000078,
2,5,2063,2068,0.0001465,0.0000092,
2,6,2063,2069,0.0001399,0.0000102,
2,7,2063,2070,0.0001348,0.0000113,
2,8,2063,2071,0.0001336,0.0000130,
2,9,2063,2072,0.0001377,0.0000158,
2,10,2063,2073,0.0001465,0.0000198,
2,11,2063,2074,0.0001596,0.0000253,
2,12,2063,2075,0.0001783,0.0000325,
2,13,2063,2076,0.0002061,0.0000431,
2,14,2063,2077,0.0002415,0.0000568,
2,15,2063,2078,0.0002756,0.0000691,
2,16,2063,2079,0.0003003,0.0000747,
2,17,2063,2080,0.0003175,0.0000737,
2,18,2063,2081,0.0003342,0.0000721,
2,19,2063,2082,0.0003539,0.0000733,
2,20,2063,2083,0.0003732,0.0000756,
2,21,2063,2084,0.0003859,0.0000745,
2,22,2063,2085,0.0003897,0.0000689,
2,23,2063,2086,0.0003908,0.0000625,
2,24,2063,2087,0.0003983,0.0000600,
2,25,2063,2088,0.0004147,0.0000616,
2,26,2063,2089,0.0004348,0.0000644,
2,27,2063,2090,0.0004528,0.0000654,
2,28,2063,2091,0.0004684,0.0000666,
2,29,2063,2092,0.0004856,0.0000680,
2,30,2063,2093,0.0005091,0.0000706,
2,31,2063,2094,0.0005408,0.0000740,
2,32,2063,2095,0.0005796,0.0000775,
2,33,2063,2096,0.0006220,0.0000802,
2,34,2063,2097,0.0006665,0.0000824,
2,35,2063,2098,0.0007153,0.0000845,
2,36,2063,2099,0.0007710,0.0000894,
2,37,2063,2100,0.0008314,0.0000941,
2,38,2063,2101,0.0008908,0.0001000,
2,39,2063,2102,0.0009481,0.0001082,
2,40,2063,2103,0.0010090,0.0001185,
2,41,2063,2104,0.0010784,0.0001295,
2,42,2063,2105,0.0011559,0.0001406,
2,43,2063,2106,0.0012427,0.0001551,
2,44,2063,2107,0.0013435,0.0001776,
2,45,2063,2108,0.0014588,0.0002040,
2,46,2063,2109,0.0015840,0.0002325,
2,47,2063,2110,0.0017152,0.0002559,
2,48,2063,2111,0.0018531,0.0002772,
2,49,2063,2112,0.0020059,0.0002997,
2,50,2063,2113,0.0021845,0.0003211,
2,51,2063,2114,0.0023896,0.0003401,
2,52,2063,2115,0.0026115,0.0003570,
2,53,2063,2116,0.0028474,0.0003777,
2,54,2063,2117,0.0031082,0.0004120,
2,55,2063,2118,0.0034035,0.0004542,
2,56,2063,2119,0.0037277,0.0004970,
2,57,2063,2120,0.0040692,0.0005283,
2,58,2063,2121,0.0044295,0.0005546,
2,59,2063,2122,0.0048296,0.0005891,
2,60,2063,2123,0.0052973,0.0006413,
2,61,2063,2124,0.0058480,0.0007115,
2,62,2063,2125,0.0064757,0.0007970,
2,63,2063,2126,0.0071641,0.0008995,
2,64,2063,2127,0.0078986,0.0010122,
2,65,2063,2128,0.0086645,0.0011127,
2,66,2063,2129,0.0094558,0.0011971,
2,67,2063,2130,0.0103010,0.0012789,
2,68,2063,2131,0.0112531,0.0013803,
2,69,2063,2132,0.0123584,0.0015126,
2,70,2063,2133,0.0136702,0.0016930,
2,71,2063,2134,0.0152518,0.0019601,
2,72,2063,2135,0.0170987,0.0023200,
2,73,2063,2136,0.0190837,0.0027139,
2,74,2063,2137,0.0210750,0.0030837,
2,75,2063,2138,0.0231062,0.0034364,
2,76,2063,2139,0.0253497,0.0038568,
2,77,2063,2140,0.0279666,0.0044322,
2,78,2063,2141,0.0310443,0.0052232,
2,79,2063,2142,0.0345982,0.0062509,
2,80,2063,2143,0.0395295,0.0082498,
2,81,2063,2144,0.0438328,0.0096253,
2,82,2063,2145,0.0485928,0.0112045,
2,83,2063,2146,0.0538556,0.0130228,
2,84,2063,2147,0.0596709,0.0151204,
2,85,2063,2148,0.0660929,0.0175700,
2,86,2063,2149,0.0731799,0.0204337,
2,87,2063,2150,0.0809950,0.0237485,
2,0,2064,2064,0.0077995,0.0009051,
2,1,2064,2065,0.0005341,0.0000184,
2,2,2064,2066,0.0002805,0.0000109,
2,3,2064,2067,0.0001960,0.0000090,
2,4,2064,2068,0.0001520,0.0000074,
2,5,2064,2069,0.0001465,0.0000087,
2,6,2064,2070,0.0001399,0.0000097,
2,7,2064,2071,0.0001348,0.0000108,
2,8,2064,2072,0.0001336,0.0000125,
2,9,2064,2073,0.0001377,0.0000152,
2,10,2064,2074,0.0001465,0.0000192,
2,11,2064,2075,0.0001596,0.0000245,
2,12,2064,2076,0.0001783,0.0000316,
2,13,2064,2077,0.0002061,0.0000420,
2,14,2064,2078,0.0002415,0.0000556,
2,15,2064,2079,0.0002756,0.0000677,
2,16,2064,2080,0.0003003,0.0000730,
2,17,2064,2081,0.0003175,0.0000720,
2,18,2064,2082,0.0003342,0.0000705,
2,19,2064,2083,0.0003539,0.0000718,
2,20,2064,2084,0.0003732,0.0000740,
2,21,2064,2085,0.0003859,0.0000727,
2,22,2064,2086,0.0003897,0.0000672,
2,23,2064,2087,0.0003908,0.0000610,
2,24,2064,2088,0.0003983,0.0000586,
2,25,2064,2089,0.0004147,0.0000601,
2,26,2064,2090,0.0004348,0.0000627,
2,27,2064,2091,0.0004528,0.0000637,
2,28,2064,2092,0.0004684,0.0000650,
2,29,2064,2093,0.0004856,0.0000665,
2,30,2064,2094,0.0005091,0.0000690,
2,31,2064,2095,0.0005408,0.0000721,
2,32,2064,2096,0.0005796,0.0000755,
2,33,2064,2097,0.0006220,0.0000783,
2,34,2064,2098,0.0006665,0.0000805,
2,35,2064,2099,0.0007153,0.0000825,
2,36,2064,2100,0.0007710,0.0000871,
2,37,2064,2101,0.0008314,0.0000916,
2,38,2064,2102,0.0008908,0.0000976,
2,39,2064,2103,0.0009481,0.0001058,
2,40,2064,2104,0.0010090,0.0001159,
2,41,2064,2105,0.0010784,0.0001264,
2,42,2064,2106,0.0011559,0.0001372,
2,43,2064,2107,0.0012427,0.0001517,
2,44,2064,2108,0.0013435,0.0001741,
2,45,2064,2109,0.0014588,0.0002000,
2,46,2064,2110,0.0015840,0.0002277,
2,47,2064,2111,0.0017152,0.0002506,
2,48,2064,2112,0.0018531,0.0002719,
2,49,2064,2113,0.0020059,0.0002944,
2,50,2064,2114,0.0021845,0.0003153,
2,51,2064,2115,0.0023896,0.0003334,
2,52,2064,2116,0.0026115,0.0003497,
2,53,2064,2117,0.0028474,0.0003704,
2,54,2064,2118,0.0031082,0.0004046,
2,55,2064,2119,0.0034035,0.0004460,
2,56,2064,2120,0.0037277,0.0004872,
2,57,2064,2121,0.0040692,0.0005177,
2,58,2064,2122,0.0044295,0.0005440,
2,59,2064,2123,0.0048296,0.0005786,
2,60,2064,2124,0.0052973,0.0006296,
2,61,2064,2125,0.0058480,0.0006974,
2,62,2064,2126,0.0064757,0.0007811,
2,63,2064,2127,0.0071641,0.0008830,
2,64,2064,2128,0.0078986,0.0009952,
2,65,2064,2129,0.0086645,0.0010938,
2,66,2064,2130,0.0094558,0.0011750,
2,67,2064,2131,0.0103010,0.0012548,
2,68,2064,2132,0.0112531,0.0013558,
2,69,2064,2133,0.0123584,0.0014879,
2,70,2064,2134,0.0136702,0.0016649,
2,71,2064,2135,0.0152518,0.0019256,
2,72,2064,2136,0.0170987,0.0022797,
2,73,2064,2137,0.0190837,0.0026708,
2,74,2064,2138,0.0210750,0.0030393,
2,75,2064,2139,0.0231062,0.0033864,
2,76,2064,2140,0.0253497,0.0037968,
2,77,2064,2141,0.0279666,0.0043636,
2,78,2064,2142,0.0310443,0.0051501,
2,79,2064,2143,0.0345982,0.0061739,
2,80,2064,2144,0.0395295,0.0081552,
2,81,2064,2145,0.0438328,0.0095101,
2,82,2064,2146,0.0485928,0.0110725,
2,83,2064,2147,0.0538556,0.0128837,
2,84,2064,2148,0.0596709,0.0149762,
2,85,2064,2149,0.0660929,0.0174045,
2,86,2064,2150,0.0731799,0.0202327,
2,0,2065,2065,0.0077995,0.0008658,
2,1,2065,2066,0.0005341,0.0000172,
2,2,2065,2067,0.0002805,0.0000103,
2,3,2065,2068,0.0001960,0.0000085,
2,4,2065,2069,0.0001520,0.0000070,
2,5,2065,2070,0.0001465,0.0000083,
2,6,2065,2071,0.0001399,0.0000093,
2,7,2065,2072,0.0001348,0.0000104,
2,8,2065,2073,0.0001336,0.0000121,
2,9,2065,2074,0.0001377,0.0000147,
2,10,2065,2075,0.0001465,0.0000185,
2,11,2065,2076,0.0001596,0.0000237,
2,12,2065,2077,0.0001783,0.0000307,
2,13,2065,2078,0.0002061,0.0000411,
2,14,2065,2079,0.0002415,0.0000544,
2,15,2065,2080,0.0002756,0.0000662,
2,16,2065,2081,0.0003003,0.0000714,
2,17,2065,2082,0.0003175,0.0000705,
2,18,2065,2083,0.0003342,0.0000690,
2,19,2065,2084,0.0003539,0.0000703,
2,20,2065,2085,0.0003732,0.0000722,
2,21,2065,2086,0.0003859,0.0000710,
2,22,2065,2087,0.0003897,0.0000656,
2,23,2065,2088,0.0003908,0.0000596,
2,24,2065,2089,0.0003983,0.0000572,
2,25,2065,2090,0.0004147,0.0000585,
2,26,2065,2091,0.0004348,0.0000611,
2,27,2065,2092,0.0004528,0.0000621,
2,28,2065,2093,0.0004684,0.0000635,
2,29,2065,2094,0.0004856,0.0000649,
2,30,2065,2095,0.0005091,0.0000672,
2,31,2065,2096,0.0005408,0.0000703,
2,32,2065,2097,0.0005796,0.0000737,
2,33,2065,2098,0.0006220,0.0000765,
2,34,2065,2099,0.0006665,0.0000786,
2,35,2065,2100,0.0007153,0.0000803,
2,36,2065,2101,0.0007710,0.0000848,
2,37,2065,2102,0.0008314,0.0000893,
2,38,2065,2103,0.0008908,0.0000953,
2,39,2065,2104,0.0009481,0.0001034,
2,40,2065,2105,0.0010090,0.0001131,
2,41,2065,2106,0.0010784,0.0001234,
2,42,2065,2107,0.0011559,0.0001342,
2,43,2065,2108,0.0012427,0.0001486,
2,44,2065,2109,0.0013435,0.0001706,
2,45,2065,2110,0.0014588,0.0001958,
2,46,2065,2111,0.0015840,0.0002229,
2,47,2065,2112,0.0017152,0.0002457,
2,48,2065,2113,0.0018531,0.0002671,
2,49,2065,2114,0.0020059,0.0002891,
2,50,2065,2115,0.0021845,0.0003091,
2,51,2065,2116,0.0023896,0.0003266,
2,52,2065,2117,0.0026115,0.0003430,
2,53,2065,2118,0.0028474,0.0003637,
2,54,2065,2119,0.0031082,0.0003972,
2,55,2065,2120,0.0034035,0.0004371,
2,56,2065,2121,0.0037277,0.0004774,
2,57,2065,2122,0.0040692,0.0005078,
2,58,2065,2123,0.0044295,0.0005343,
2,59,2065,2124,0.0048296,0.0005679,
2,60,2065,2125,0.0052973,0.0006170,
2,61,2065,2126,0.0058480,0.0006833,
2,62,2065,2127,0.0064757,0.0007664,
2,63,2065,2128,0.0071641,0.0008679,
2,64,2065,2129,0.0078986,0.0009782,
2,65,2065,2130,0.0086645,0.0010737,
2,66,2065,2131,0.0094558,0.0011529,
2,67,2065,2132,0.0103010,0.0012325,
2,68,2065,2133,0.0112531,0.0013334,
2,69,2065,2134,0.0123584,0.0014629,
2,70,2065,2135,0.0136702,0.0016349,
2,71,2065,2136,0.0152518,0.0018909,
2,72,2065,2137,0.0170987,0.0022423,
2,73,2065,2138,0.0190837,0.0026315,
2,74,2065,2139,0.0210750,0.0029943,
2,75,2065,2140,0.0231062,0.0033327,
2,76,2065,2141,0.0253497,0.0037363,
2,77,2065,2142,0.0279666,0.0043000,
2,78,2065,2143,0.0310443,0.0050835,
2,79,2065,2144,0.0345982,0.0060961,
2,80,2065,2145,0.0395295,0.0080536,
2,81,2065,2146,0.0438328,0.0093934,
2,82,2065,2147,0.0485928,0.0109495,
2,83,2065,2148,0.0538556,0.0127559,
2,84,2065,2149,0.0596709,0.0148292,
2,85,2065,2150,0.0660929,0.0172256,
2,0,2066,2066,0.0077995,0.0008273,
2,1,2066,2067,0.0005341,0.0000161,
2,2,2066,2068,0.0002805,0.0000097,
2,3,2066,2069,0.0001960,0.0000080,
2,4,2066,2070,0.0001520,0.0000066,
2,5,2066,2071,0.0001465,0.0000079,
2,6,2066,2072,0.0001399,0.0000088,
2,7,2066,2073,0.0001348,0.0000100,
2,8,2066,2074,0.0001336,0.0000116,
2,9,2066,2075,0.0001377,0.0000142,
2,10,2066,2076,0.0001465,0.0000179,
2,11,2066,2077,0.0001596,0.0000230,
2,12,2066,2078,0.0001783,0.0000300,
2,13,2066,2079,0.0002061,0.0000401,
2,14,2066,2080,0.0002415,0.0000532,
2,15,2066,2081,0.0002756,0.0000648,
2,16,2066,2082,0.0003003,0.0000699,
2,17,2066,2083,0.0003175,0.0000691,
2,18,2066,2084,0.0003342,0.0000676,
2,19,2066,2085,0.0003539,0.0000686,
2,20,2066,2086,0.0003732,0.0000705,
2,21,2066,2087,0.0003859,0.0000694,
2,22,2066,2088,0.0003897,0.0000641,
2,23,2066,2089,0.0003908,0.0000582,
2,24,2066,2090,0.0003983,0.0000557,
2,25,2066,2091,0.0004147,0.0000570,
2,26,2066,2092,0.0004348,0.0000596,
2,27,2066,2093,0.0004528,0.0000607,
2,28,2066,2094,0.0004684,0.0000620,
2,29,2066,2095,0.0004856,0.0000633,
2,30,2066,2096,0.0005091,0.0000655,
2,31,2066,2097,0.0005408,0.0000686,
2,32,2066,2098,0.0005796,0.0000720,
2,33,2066,2099,0.0006220,0.0000747,
2,34,2066,2100,0.0006665,0.0000766,
2,35,2066,2101,0.0007153,0.0000782,
2,36,2066,2102,0.0007710,0.0000827,
2,37,2066,2103,0.0008314,0.0000873,
2,38,2066,2104,0.0008908,0.0000931,
2,39,2066,2105,0.0009481,0.0001009,
2,40,2066,2106,0.0010090,0.0001103,
2,41,2066,2107,0.0010784,0.0001206,
2,42,2066,2108,0.0011559,0.0001313,
2,43,2066,2109,0.0012427,0.0001454,
2,44,2066,2110,0.0013435,0.0001668,
2,45,2066,2111,0.0014588,0.0001915,
2,46,2066,2112,0.0015840,0.0002185,
2,47,2066,2113,0.0017152,0.0002413,
2,48,2066,2114,0.0018531,0.0002622,
2,49,2066,2115,0.0020059,0.0002834,
2,50,2066,2116,0.0021845,0.0003029,
2,51,2066,2117,0.0023896,0.0003204,
2,52,2066,2118,0.0026115,0.0003368,
2,53,2066,2119,0.0028474,0.0003569,
2,54,2066,2120,0.0031082,0.0003892,
2,55,2066,2121,0.0034035,0.0004282,
2,56,2066,2122,0.0037277,0.0004684,
2,57,2066,2123,0.0040692,0.0004988,
2,58,2066,2124,0.0044295,0.0005245,
2,59,2066,2125,0.0048296,0.0005565,
2,60,2066,2126,0.0052973,0.0006044,
2,61,2066,2127,0.0058480,0.0006702,
2,62,2066,2128,0.0064757,0.0007531,
2,63,2066,2129,0.0071641,0.0008527,
2,64,2066,2130,0.0078986,0.0009599,
2,65,2066,2131,0.0086645,0.0010534,
2,66,2066,2132,0.0094558,0.0011324,
2,67,2066,2133,0.0103010,0.0012121,
2,68,2066,2134,0.0112531,0.0013109,
2,69,2066,2135,0.0123584,0.0014362,
2,70,2066,2136,0.0136702,0.0016047,
2,71,2066,2137,0.0152518,0.0018588,
2,72,2066,2138,0.0170987,0.0022082,
2,73,2066,2139,0.0190837,0.0025917,
2,74,2066,2140,0.0210750,0.0029461,
2,75,2066,2141,0.0231062,0.0032785,
2,76,2066,2142,0.0253497,0.0036803,
2,77,2066,2143,0.0279666,0.0042421,
2,78,2066,2144,0.0310443,0.0050164,
2,79,2066,2145,0.0345982,0.0060127,
2,80,2066,2146,0.0395295,0.0079509,
2,81,2066,2147,0.0438328,0.0092848,
2,82,2066,2148,0.0485928,0.0108363,
2,83,2066,2149,0.0538556,0.0126255,
2,84,2066,2150,0.0596709,0.0146703,
2,0,2067,2067,0.0077995,0.0007926,
2,1,2067,2068,0.0005341,0.0000151,
2,2,2067,2069,0.0002805,0.0000092,
2,3,2067,2070,0.0001960,0.0000076,
2,4,2067,2071,0.0001520,0.0000062,
2,5,2067,2072,0.0001465,0.0000075,
2,6,2067,2073,0.0001399,0.0000085,
2,7,2067,2074,0.0001348,0.0000096,
2,8,2067,2075,0.0001336,0.0000111,
2,9,2067,2076,0.0001377,0.0000136,
2,10,2067,2077,0.0001465,0.0000173,
2,11,2067,2078,0.0001596,0.0000224,
2,12,2067,2079,0.0001783,0.0000292,
2,13,2067,2080,0.0002061,0.0000391,
2,14,2067,2081,0.0002415,0.0000519,
2,15,2067,2082,0.0002756,0.0000634,
2,16,2067,2083,0.0003003,0.0000686,
2,17,2067,2084,0.0003175,0.0000677,
2,18,2067,2085,0.0003342,0.0000660,
2,19,2067,2086,0.0003539,0.0000670,
2,20,2067,2087,0.0003732,0.0000689,
2,21,2067,2088,0.0003859,0.0000679,
2,22,2067,2089,0.0003897,0.0000627,
2,23,2067,2090,0.0003908,0.0000567,
2,24,2067,2091,0.0003983,0.0000542,
2,25,2067,2092,0.0004147,0.0000555,
2,26,2067,2093,0.0004348,0.0000582,
2,27,2067,2094,0.0004528,0.0000593,
2,28,2067,2095,0.0004684,0.0000604,
2,29,2067,2096,0.0004856,0.0000616,
2,30,2067,2097,0.0005091,0.0000639,
2,31,2067,2098,0.0005408,0.0000670,
2,32,2067,2099,0.0005796,0.0000703,
2,33,2067,2100,0.0006220,0.0000728,
2,34,2067,2101,0.0006665,0.0000746,
2,35,2067,2102,0.0007153,0.0000763,
2,36,2067,2103,0.0007710,0.0000808,
2,37,2067,2104,0.0008314,0.0000852,
2,38,2067,2105,0.0008908,0.0000908,
2,39,2067,2106,0.0009481,0.0000983,
2,40,2067,2107,0.0010090,0.0001078,
2,41,2067,2108,0.0010784,0.0001180,
2,42,2067,2109,0.0011559,0.0001285,
2,43,2067,2110,0.0012427,0.0001421,
2,44,2067,2111,0.0013435,0.0001630,
2,45,2067,2112,0.0014588,0.0001876,
2,46,2067,2113,0.0015840,0.0002145,
2,47,2067,2114,0.0017152,0.0002368,
2,48,2067,2115,0.0018531,0.0002570,
2,49,2067,2116,0.0020059,0.0002777,
2,50,2067,2117,0.0021845,0.0002972,
2,51,2067,2118,0.0023896,0.0003147,
2,52,2067,2119,0.0026115,0.0003306,
2,53,2067,2120,0.0028474,0.0003497,
2,54,2067,2121,0.0031082,0.0003812,
2,55,2067,2122,0.0034035,0.0004200,
2,56,2067,2123,0.0037277,0.0004601,
2,57,2067,2124,0.0040692,0.0004897,
2,58,2067,2125,0.0044295,0.0005140,
2,59,2067,2126,0.0048296,0.0005451,
2,60,2067,2127,0.0052973,0.0005927,
2,61,2067,2128,0.0058480,0.0006584,
2,62,2067,2129,0.0064757,0.0007397,
2,63,2067,2130,0.0071641,0.0008366,
2,64,2067,2131,0.0078986,0.0009416,
2,65,2067,2132,0.0086645,0.0010346,
2,66,2067,2133,0.0094558,0.0011137,
2,67,2067,2134,0.0103010,0.0011916,
2,68,2067,2135,0.0112531,0.0012868,
2,69,2067,2136,0.0123584,0.0014093,
2,70,2067,2137,0.0136702,0.0015767,
2,71,2067,2138,0.0152518,0.0018295,
2,72,2067,2139,0.0170987,0.0021737,
2,73,2067,2140,0.0190837,0.0025490,
2,74,2067,2141,0.0210750,0.0028975,
2,75,2067,2142,0.0231062,0.0032284,
2,76,2067,2143,0.0253497,0.0036292,
2,77,2067,2144,0.0279666,0.0041838,
2,78,2067,2145,0.0310443,0.0049444,
2,79,2067,2146,0.0345982,0.0059285,
2,80,2067,2147,0.0395295,0.0078553,
2,81,2067,2148,0.0438328,0.0091850,
2,82,2067,2149,0.0485928,0.0107210,
2,83,2067,2150,0.0538556,0.0124847,
2,0,2068,2068,0.0077995,0.0007618,
2,1,2068,2069,0.0005341,0.0000142,
2,2,2068,2070,0.0002805,0.0000086,
2,3,2068,2071,0.0001960,0.0000071,
2,4,2068,2072,0.0001520,0.0000059,
2,5,2068,2073,0.0001465,0.0000071,
2,6,2068,2074,0.0001399,0.0000081,
2,7,2068,2075,0.0001348,0.0000091,
2,8,2068,2076,0.0001336,0.0000107,
2,9,2068,2077,0.0001377,0.0000131,
2,10,2068,2078,0.0001465,0.0000168,
2,11,2068,2079,0.0001596,0.0000217,
2,12,2068,2080,0.0001783,0.0000284,
2,13,2068,2081,0.0002061,0.0000381,
2,14,2068,2082,0.0002415,0.0000508,
2,15,2068,2083,0.0002756,0.0000622,
2,16,2068,2084,0.0003003,0.0000672,
2,17,2068,2085,0.0003175,0.0000662,
2,18,2068,2086,0.0003342,0.0000645,
2,19,2068,2087,0.0003539,0.0000655,
2,20,2068,2088,0.0003732,0.0000675,
2,21,2068,2089,0.0003859,0.0000664,
2,22,2068,2090,0.0003897,0.0000611,
2,23,2068,2091,0.0003908,0.0000552,
2,24,2068,2092,0.0003983,0.0000529,
2,25,2068,2093,0.0004147,0.0000542,
2,26,2068,2094,0.0004348,0.0000568,
2,27,2068,2095,0.0004528,0.0000577,
2,28,2068,2096,0.0004684,0.0000588,
2,29,2068,2097,0.0004856,0.0000601,
2,30,2068,2098,0.0005091,0.0000624,
2,31,2068,2099,0.0005408,0.0000654,
2,32,2068,2100,0.0005796,0.0000686,
2,33,2068,2101,0.0006220,0.0000709,
2,34,2068,2102,0.0006665,0.0000728,
2,35,2068,2103,0.0007153,0.0000745,
2,36,2068,2104,0.0007710,0.0000789,
2,37,2068,2105,0.0008314,0.0000831,
2,38,2068,2106,0.0008908,0.0000884,
2,39,2068,2107,0.0009481,0.0000960,
2,40,2068,2108,0.0010090,0.0001054,
2,41,2068,2109,0.0010784,0.0001154,
2,42,2068,2110,0.0011559,0.0001255,
2,43,2068,2111,0.0012427,0.0001388,
2,44,2068,2112,0.0013435,0.0001595,
2,45,2068,2113,0.0014588,0.0001840,
2,46,2068,2114,0.0015840,0.0002104,
2,47,2068,2115,0.0017152,0.0002321,
2,48,2068,2116,0.0018531,0.0002518,
2,49,2068,2117,0.0020059,0.0002724,
2,50,2068,2118,0.0021845,0.0002919,
2,51,2068,2119,0.0023896,0.0003089,
2,52,2068,2120,0.0026115,0.0003239,
2,53,2068,2121,0.0028474,0.0003424,
2,54,2068,2122,0.0031082,0.0003738,
2,55,2068,2123,0.0034035,0.0004125,
2,56,2068,2124,0.0037277,0.0004517,
2,57,2068,2125,0.0040692,0.0004800,
2,58,2068,2126,0.0044295,0.0005034,
2,59,2068,2127,0.0048296,0.0005345,
2,60,2068,2128,0.0052973,0.0005821,
2,61,2068,2129,0.0058480,0.0006465,
2,62,2068,2130,0.0064757,0.0007254,
2,63,2068,2131,0.0071641,0.0008203,
2,64,2068,2132,0.0078986,0.0009247,
2,65,2068,2133,0.0086645,0.0010175,
2,66,2068,2134,0.0094558,0.0010948,
2,67,2068,2135,0.0103010,0.0011695,
2,68,2068,2136,0.0112531,0.0012625,
2,69,2068,2137,0.0123584,0.0013845,
2,70,2068,2138,0.0136702,0.0015513,
2,71,2068,2139,0.0152518,0.0018000,
2,72,2068,2140,0.0170987,0.0021367,
2,73,2068,2141,0.0190837,0.0025060,
2,74,2068,2142,0.0210750,0.0028524,
2,75,2068,2143,0.0231062,0.0031827,
2,76,2068,2144,0.0253497,0.0035778,
2,77,2068,2145,0.0279666,0.0041212,
2,78,2068,2146,0.0310443,0.0048717,
2,79,2068,2147,0.0345982,0.0058501,
2,80,2068,2148,0.0395295,0.0077674,
2,81,2068,2149,0.0438328,0.0090833,
2,82,2068,2150,0.0485928,0.0105967,
2,0,2069,2069,0.0077995,0.0007316,
2,1,2069,2070,0.0005341,0.0000133,
2,2,2069,2071,0.0002805,0.0000081,
2,3,2069,2072,0.0001960,0.0000067,
2,4,2069,2073,0.0001520,0.0000056,
2,5,2069,2074,0.0001465,0.0000068,
2,6,2069,2075,0.0001399,0.0000077,
2,7,2069,2076,0.0001348,0.0000087,
2,8,2069,2077,0.0001336,0.0000103,
2,9,2069,2078,0.0001377,0.0000127,
2,10,2069,2079,0.0001465,0.0000163,
2,11,2069,2080,0.0001596,0.0000211,
2,12,2069,2081,0.0001783,0.0000276,
2,13,2069,2082,0.0002061,0.0000372,
2,14,2069,2083,0.0002415,0.0000497,
2,15,2069,2084,0.0002756,0.0000609,
2,16,2069,2085,0.0003003,0.0000658,
2,17,2069,2086,0.0003175,0.0000646,
2,18,2069,2087,0.0003342,0.0000631,
2,19,2069,2088,0.0003539,0.0000641,
2,20,2069,2089,0.0003732,0.0000661,
2,21,2069,2090,0.0003859,0.0000649,
2,22,2069,2091,0.0003897,0.0000596,
2,23,2069,2092,0.0003908,0.0000538,
2,24,2069,2093,0.0003983,0.0000516,
2,25,2069,2094,0.0004147,0.0000529,
2,26,2069,2095,0.0004348,0.0000553,
2,27,2069,2096,0.0004528,0.0000562,
2,28,2069,2097,0.0004684,0.0000574,
2,29,2069,2098,0.0004856,0.0000587,
2,30,2069,2099,0.0005091,0.0000610,
2,31,2069,2100,0.0005408,0.0000638,
2,32,2069,2101,0.0005796,0.0000668,
2,33,2069,2102,0.0006220,0.0000692,
2,34,2069,2103,0.0006665,0.0000711,
2,35,2069,2104,0.0007153,0.0000728,
2,36,2069,2105,0.0007710,0.0000769,
2,37,2069,2106,0.0008314,0.0000809,
2,38,2069,2107,0.0008908,0.0000863,
2,39,2069,2108,0.0009481,0.0000938,
2,40,2069,2109,0.0010090,0.0001031,
2,41,2069,2110,0.0010784,0.0001127,
2,42,2069,2111,0.0011559,0.0001225,
2,43,2069,2112,0.0012427,0.0001357,
2,44,2069,2113,0.0013435,0.0001564,
2,45,2069,2114,0.0014588,0.0001804,
2,46,2069,2115,0.0015840,0.0002061,
2,47,2069,2116,0.0017152,0.0002273,
2,48,2069,2117,0.0018531,0.0002470,
2,49,2069,2118,0.0020059,0.0002676,
2,50,2069,2119,0.0021845,0.0002866,
2,51,2069,2120,0.0023896,0.0003028,
2,52,2069,2121,0.0026115,0.0003173,
2,53,2069,2122,0.0028474,0.0003357,
2,54,2069,2123,0.0031082,0.0003671,
2,55,2069,2124,0.0034035,0.0004050,
2,56,2069,2125,0.0037277,0.0004428,
2,57,2069,2126,0.0040692,0.0004702,
2,58,2069,2127,0.0044295,0.0004937,
2,59,2069,2128,0.0048296,0.0005249,
2,60,2069,2129,0.0052973,0.0005715,
2,61,2069,2130,0.0058480,0.0006338,
2,62,2069,2131,0.0064757,0.0007110,
2,63,2069,2132,0.0071641,0.0008053,
2,64,2069,2133,0.0078986,0.0009093,
2,65,2069,2134,0.0086645,0.0010002,
2,66,2069,2135,0.0094558,0.0010746,
2,67,2069,2136,0.0103010,0.0011474,
2,68,2069,2137,0.0112531,0.0012401,
2,69,2069,2138,0.0123584,0.0013618,
2,70,2069,2139,0.0136702,0.0015255,
2,71,2069,2140,0.0152518,0.0017682,
2,72,2069,2141,0.0170987,0.0020995,
2,73,2069,2142,0.0190837,0.0024661,
2,74,2069,2143,0.0210750,0.0028115,
2,75,2069,2144,0.0231062,0.0031367,
2,76,2069,2145,0.0253497,0.0035227,
2,77,2069,2146,0.0279666,0.0040581,
2,78,2069,2147,0.0310443,0.0048042,
2,79,2069,2148,0.0345982,0.0057783,
2,80,2069,2149,0.0395295,0.0076780,
2,81,2069,2150,0.0438328,0.0089737,
2,0,2070,2070,0.0077995,0.0007000,
2,1,2070,2071,0.0005341,0.0000124,
2,2,2070,2072,0.0002805,0.0000076,
2,3,2070,2073,0.0001960,0.0000064,
2,4,2070,2074,0.0001520,0.0000053,
2,5,2070,2075,0.0001465,0.0000065,
2,6,2070,2076,0.0001399,0.0000073,
2,7,2070,2077,0.0001348,0.0000084,
2,8,2070,2078,0.0001336,0.0000099,
2,9,2070,2079,0.0001377,0.0000123,
2,10,2070,2080,0.0001465,0.0000157,
2,11,2070,2081,0.0001596,0.0000204,
2,12,2070,2082,0.0001783,0.0000268,
2,13,2070,2083,0.0002061,0.0000363,
2,14,2070,2084,0.0002415,0.0000487,
2,15,2070,2085,0.0002756,0.0000596,
2,16,2070,2086,0.0003003,0.0000644,
2,17,2070,2087,0.0003175,0.0000633,
2,18,2070,2088,0.0003342,0.0000618,
2,19,2070,2089,0.0003539,0.0000628,
2,20,2070,2090,0.0003732,0.0000645,
2,21,2070,2091,0.0003859,0.0000633,
2,22,2070,2092,0.0003897,0.0000582,
2,23,2070,2093,0.0003908,0.0000526,
2,24,2070,2094,0.0003983,0.0000504,
2,25,2070,2095,0.0004147,0.0000516,
2,26,2070,2096,0.0004348,0.0000539,
2,27,2070,2097,0.0004528,0.0000548,
2,28,2070,2098,0.0004684,0.0000561,
2,29,2070,2099,0.0004856,0.0000574,
2,30,2070,2100,0.0005091,0.0000594,
2,31,2070,2101,0.0005408,0.0000621,
2,32,2070,2102,0.0005796,0.0000652,
2,33,2070,2103,0.0006220,0.0000676,
2,34,2070,2104,0.0006665,0.0000695,
2,35,2070,2105,0.0007153,0.0000709,
2,36,2070,2106,0.0007710,0.0000749,
2,37,2070,2107,0.0008314,0.0000789,
2,38,2070,2108,0.0008908,0.0000843,
2,39,2070,2109,0.0009481,0.0000917,
2,40,2070,2110,0.0010090,0.0001005,
2,41,2070,2111,0.0010784,0.0001099,
2,42,2070,2112,0.0011559,0.0001197,
2,43,2070,2113,0.0012427,0.0001329,
2,44,2070,2114,0.0013435,0.0001532,
2,45,2070,2115,0.0014588,0.0001766,
2,46,2070,2116,0.0015840,0.0002018,
2,47,2070,2117,0.0017152,0.0002229,
2,48,2070,2118,0.0018531,0.0002426,
2,49,2070,2119,0.0020059,0.0002628,
2,50,2070,2120,0.0021845,0.0002810,
2,51,2070,2121,0.0023896,0.0002966,
2,52,2070,2122,0.0026115,0.0003111,
2,53,2070,2123,0.0028474,0.0003296,
2,54,2070,2124,0.0031082,0.0003603,
2,55,2070,2125,0.0034035,0.0003969,
2,56,2070,2126,0.0037277,0.0004338,
2,57,2070,2127,0.0040692,0.0004612,
2,58,2070,2128,0.0044295,0.0004849,
2,59,2070,2129,0.0048296,0.0005153,
2,60,2070,2130,0.0052973,0.0005602,
2,61,2070,2131,0.0058480,0.0006211,
2,62,2070,2132,0.0064757,0.0006978,
2,63,2070,2133,0.0071641,0.0007916,
2,64,2070,2134,0.0078986,0.0008937,
2,65,2070,2135,0.0086645,0.0009818,
2,66,2070,2136,0.0094558,0.0010543,
2,67,2070,2137,0.0103010,0.0011270,
2,68,2070,2138,0.0112531,0.0012196,
2,69,2070,2139,0.0123584,0.0013389,
2,70,2070,2140,0.0136702,0.0014980,
2,71,2070,2141,0.0152518,0.0017364,
2,72,2070,2142,0.0170987,0.0020651,
2,73,2070,2143,0.0190837,0.0024299,
2,74,2070,2144,0.0210750,0.0027702,
2,75,2070,2145,0.0231062,0.0030875,
2,76,2070,2146,0.0253497,0.0034671,
2,77,2070,2147,0.0279666,0.0039995,
2,78,2070,2148,0.0310443,0.0047423,
2,79,2070,2149,0.0345982,0.0057052,
2,80,2070,2150,0.0395295,0.0075815,
2,0,2071,2071,0.0077995,0.0006692,
2,1,2071,2072,0.0005341,0.0000116,
2,2,2071,2073,0.0002805,0.0000072,
2,3,2071,2074,0.0001960,0.0000060,
2,4,2071,2075,0.0001520,0.0000050,
2,5,2071,2076,0.0001465,0.0000061,
2,6,2071,2077,0.0001399,0.0000070,
2,7,2071,2078,0.0001348,0.0000080,
2,8,2071,2079,0.0001336,0.0000095,
2,9,2071,2080,0.0001377,0.0000118,
2,10,2071,2081,0.0001465,0.0000152,
2,11,2071,2082,0.0001596,0.0000198,
2,12,2071,2083,0.0001783,0.0000262,
2,13,2071,2084,0.0002061,0.0000355,
2,14,2071,2085,0.0002415,0.0000476,
2,15,2071,2086,0.0002756,0.0000583,
2,16,2071,2087,0.0003003,0.0000630,
2,17,2071,2088,0.0003175,0.0000620,
2,18,2071,2089,0.0003342,0.0000605,
2,19,2071,2090,0.0003539,0.0000613,
2,20,2071,2091,0.0003732,0.0000630,
2,21,2071,2092,0.0003859,0.0000618,
2,22,2071,2093,0.0003897,0.0000569,
2,23,2071,2094,0.0003908,0.0000513,
2,24,2071,2095,0.0003983,0.0000491,
2,25,2071,2096,0.0004147,0.0000502,
2,26,2071,2097,0.0004348,0.0000525,
2,27,2071,2098,0.0004528,0.0000535,
2,28,2071,2099,0.0004684,0.0000547,
2,29,2071,2100,0.0004856,0.0000559,
2,30,2071,2101,0.0005091,0.0000579,
2,31,2071,2102,0.0005408,0.0000606,
2,32,2071,2103,0.0005796,0.0000637,
2,33,2071,2104,0.0006220,0.0000661,
2,34,2071,2105,0.0006665,0.0000677,
2,35,2071,2106,0.0007153,0.0000691,
2,36,2071,2107,0.0007710,0.0000731,
2,37,2071,2108,0.0008314,0.0000771,
2,38,2071,2109,0.0008908,0.0000824,
2,39,2071,2110,0.0009481,0.0000894,
2,40,2071,2111,0.0010090,0.0000980,
2,41,2071,2112,0.0010784,0.0001074,
2,42,2071,2113,0.0011559,0.0001172,
2,43,2071,2114,0.0012427,0.0001301,
2,44,2071,2115,0.0013435,0.0001499,
2,45,2071,2116,0.0014588,0.0001728,
2,46,2071,2117,0.0015840,0.0001978,
2,47,2071,2118,0.0017152,0.0002189,
2,48,2071,2119,0.0018531,0.0002381,
2,49,2071,2120,0.0020059,0.0002575,
2,50,2071,2121,0.0021845,0.0002753,
2,51,2071,2122,0.0023896,0.0002909,
2,52,2071,2123,0.0026115,0.0003054,
2,53,2071,2124,0.0028474,0.0003235,
2,54,2071,2125,0.0031082,0.0003530,
2,55,2071,2126,0.0034035,0.0003888,
2,56,2071,2127,0.0037277,0.0004255,
2,57,2071,2128,0.0040692,0.0004530,
2,58,2071,2129,0.0044295,0.0004760,
2,59,2071,2130,0.0048296,0.0005050,
2,60,2071,2131,0.0052973,0.0005488,
2,61,2071,2132,0.0058480,0.0006094,
2,62,2071,2133,0.0064757,0.0006857,
2,63,2071,2134,0.0071641,0.0007778,
2,64,2071,2135,0.0078986,0.0008771,
2,65,2071,2136,0.0086645,0.0009632,
2,66,2071,2137,0.0094558,0.0010355,
2,67,2071,2138,0.0103010,0.0011083,
2,68,2071,2139,0.0112531,0.0011990,
2,69,2071,2140,0.0123584,0.0013144,
2,70,2071,2141,0.0136702,0.0014703,
2,71,2071,2142,0.0152518,0.0017069,
2,72,2071,2143,0.0170987,0.0020338,
2,73,2071,2144,0.0190837,0.0023935,
2,74,2071,2145,0.0210750,0.0027260,
2,75,2071,2146,0.0231062,0.0030379,
2,76,2071,2147,0.0253497,0.0034156,
2,77,2071,2148,0.0279666,0.0039459,
2,78,2071,2149,0.0310443,0.0046794,
2,79,2071,2150,0.0345982,0.0056265,
2,0,2072,2072,0.0077995,0.0006413,
2,1,2072,2073,0.0005341,0.0000109,
2,2,2072,2074,0.0002805,0.0000068,
2,3,2072,2075,0.0001960,0.0000057,
2,4,2072,2076,0.0001520,0.0000047,
2,5,2072,2077,0.0001465,0.0000058,
2,6,2072,2078,0.0001399,0.0000067,
2,7,2072,2079,0.0001348,0.0000077,
2,8,2072,2080,0.0001336,0.0000091,
2,9,2072,2081,0.0001377,0.0000114,
2,10,2072,2082,0.0001465,0.0000147,
2,11,2072,2083,0.0001596,0.0000193,
2,12,2072,2084,0.0001783,0.0000255,
2,13,2072,2085,0.0002061,0.0000346,
2,14,2072,2086,0.0002415,0.0000464,
2,15,2072,2087,0.0002756,0.0000571,
2,16,2072,2088,0.0003003,0.0000618,
2,17,2072,2089,0.0003175,0.0000607,
2,18,2072,2090,0.0003342,0.0000591,
2,19,2072,2091,0.0003539,0.0000599,
2,20,2072,2092,0.0003732,0.0000616,
2,21,2072,2093,0.0003859,0.0000605,
2,22,2072,2094,0.0003897,0.0000556,
2,23,2072,2095,0.0003908,0.0000500,
2,24,2072,2096,0.0003983,0.0000477,
2,25,2072,2097,0.0004147,0.0000489,
2,26,2072,2098,0.0004348,0.0000513,
2,27,2072,2099,0.0004528,0.0000523,
2,28,2072,2100,0.0004684,0.0000533,
2,29,2072,2101,0.0004856,0.0000544,
2,30,2072,2102,0.0005091,0.0000564,
2,31,2072,2103,0.0005408,0.0000593,
2,32,2072,2104,0.0005796,0.0000622,
2,33,2072,2105,0.0006220,0.0000644,
2,34,2072,2106,0.0006665,0.0000660,
2,35,2072,2107,0.0007153,0.0000674,
2,36,2072,2108,0.0007710,0.0000714,
2,37,2072,2109,0.0008314,0.0000753,
2,38,2072,2110,0.0008908,0.0000803,
2,39,2072,2111,0.0009481,0.0000871,
2,40,2072,2112,0.0010090,0.0000957,
2,41,2072,2113,0.0010784,0.0001051,
2,42,2072,2114,0.0011559,0.0001147,
2,43,2072,2115,0.0012427,0.0001272,
2,44,2072,2116,0.0013435,0.0001465,
2,45,2072,2117,0.0014588,0.0001693,
2,46,2072,2118,0.0015840,0.0001942,
2,47,2072,2119,0.0017152,0.0002148,
2,48,2072,2120,0.0018531,0.0002334,
2,49,2072,2121,0.0020059,0.0002523,
2,50,2072,2122,0.0021845,0.0002700,
2,51,2072,2123,0.0023896,0.0002856,
2,52,2072,2124,0.0026115,0.0002998,
2,53,2072,2125,0.0028474,0.0003169,
2,54,2072,2126,0.0031082,0.0003457,
2,55,2072,2127,0.0034035,0.0003813,
2,56,2072,2128,0.0037277,0.0004180,
2,57,2072,2129,0.0040692,0.0004448,
2,58,2072,2130,0.0044295,0.0004666,
2,59,2072,2131,0.0048296,0.0004947,
2,60,2072,2132,0.0052973,0.0005383,
2,61,2072,2133,0.0058480,0.0005986,
2,62,2072,2134,0.0064757,0.0006735,
2,63,2072,2135,0.0071641,0.0007630,
2,64,2072,2136,0.0078986,0.0008603,
2,65,2072,2137,0.0086645,0.0009460,
2,66,2072,2138,0.0094558,0.0010184,
2,67,2072,2139,0.0103010,0.0010895,
2,68,2072,2140,0.0112531,0.0011769,
2,69,2072,2141,0.0123584,0.0012898,
2,70,2072,2142,0.0136702,0.0014446,
2,71,2072,2143,0.0152518,0.0016800,
2,72,2072,2144,0.0170987,0.0020023,
2,73,2072,2145,0.0190837,0.0023544,
2,74,2072,2146,0.0210750,0.0026815,
2,75,2072,2147,0.0231062,0.0029918,
2,76,2072,2148,0.0253497,0.0033684,
2,77,2072,2149,0.0279666,0.0038913,
2,78,2072,2150,0.0310443,0.0046117,
2,0,2073,2073,0.0077995,0.0006166,
2,1,2073,2074,0.0005341,0.0000103,
2,2,2073,2075,0.0002805,0.0000063,
2,3,2073,2076,0.0001960,0.0000054,
2,4,2073,2077,0.0001520,0.0000045,
2,5,2073,2078,0.0001465,0.0000056,
2,6,2073,2079,0.0001399,0.0000064,
2,7,2073,2080,0.0001348,0.0000074,
2,8,2073,2081,0.0001336,0.0000088,
2,9,2073,2082,0.0001377,0.0000110,
2,10,2073,2083,0.0001465,0.0000142,
2,11,2073,2084,0.0001596,0.0000187,
2,12,2073,2085,0.0001783,0.0000248,
2,13,2073,2086,0.0002061,0.0000337,
2,14,2073,2087,0.0002415,0.0000454,
2,15,2073,2088,0.0002756,0.0000560,
2,16,2073,2089,0.0003003,0.0000606,
2,17,2073,2090,0.0003175,0.0000594,
2,18,2073,2091,0.0003342,0.0000577,
2,19,2073,2092,0.0003539,0.0000585,
2,20,2073,2093,0.0003732,0.0000603,
2,21,2073,2094,0.0003859,0.0000592,
2,22,2073,2095,0.0003897,0.0000542,
2,23,2073,2096,0.0003908,0.0000487,
2,24,2073,2097,0.0003983,0.0000465,
2,25,2073,2098,0.0004147,0.0000478,
2,26,2073,2099,0.0004348,0.0000501,
2,27,2073,2100,0.0004528,0.0000509,
2,28,2073,2101,0.0004684,0.0000519,
2,29,2073,2102,0.0004856,0.0000531,
2,30,2073,2103,0.0005091,0.0000552,
2,31,2073,2104,0.0005408,0.0000579,
2,32,2073,2105,0.0005796,0.0000607,
2,33,2073,2106,0.0006220,0.0000628,
2,34,2073,2107,0.0006665,0.0000644,
2,35,2073,2108,0.0007153,0.0000658,
2,36,2073,2109,0.0007710,0.0000697,
2,37,2073,2110,0.0008314,0.0000734,
2,38,2073,2111,0.0008908,0.0000782,
2,39,2073,2112,0.0009481,0.0000850,
2,40,2073,2113,0.0010090,0.0000936,
2,41,2073,2114,0.0010784,0.0001028,
2,42,2073,2115,0.0011559,0.0001120,
2,43,2073,2116,0.0012427,0.0001242,
2,44,2073,2117,0.0013435,0.0001434,
2,45,2073,2118,0.0014588,0.0001661,
2,46,2073,2119,0.0015840,0.0001905,
2,47,2073,2120,0.0017152,0.0002105,
2,48,2073,2121,0.0018531,0.0002286,
2,49,2073,2122,0.0020059,0.0002475,
2,50,2073,2123,0.0021845,0.0002652,
2,51,2073,2124,0.0023896,0.0002804,
2,52,2073,2125,0.0026115,0.0002937,
2,53,2073,2126,0.0028474,0.0003102,
2,54,2073,2127,0.0031082,0.0003389,
2,55,2073,2128,0.0034035,0.0003745,
2,56,2073,2129,0.0037277,0.0004104,
2,57,2073,2130,0.0040692,0.0004360,
2,58,2073,2131,0.0044295,0.0004571,
2,59,2073,2132,0.0048296,0.0004852,
2,60,2073,2133,0.0052973,0.0005287,
2,61,2073,2134,0.0058480,0.0005878,
2,62,2073,2135,0.0064757,0.0006605,
2,63,2073,2136,0.0071641,0.0007482,
2,64,2073,2137,0.0078986,0.0008448,
2,65,2073,2138,0.0086645,0.0009303,
2,66,2073,2139,0.0094558,0.0010011,
2,67,2073,2140,0.0103010,0.0010694,
2,68,2073,2141,0.0112531,0.0011547,
2,69,2073,2142,0.0123584,0.0012670,
2,70,2073,2143,0.0136702,0.0014214,
2,71,2073,2144,0.0152518,0.0016531,
2,72,2073,2145,0.0170987,0.0019686,
2,73,2073,2146,0.0190837,0.0023151,
2,74,2073,2147,0.0210750,0.0026403,
2,75,2073,2148,0.0231062,0.0029497,
2,76,2073,2149,0.0253497,0.0033204,
2,77,2073,2150,0.0279666,0.0038327,
2,0,2074,2074,0.0077995,0.0005922,
2,1,2074,2075,0.0005341,0.0000096,
2,2,2074,2076,0.0002805,0.0000059,
2,3,2074,2077,0.0001960,0.0000051,
2,4,2074,2078,0.0001520,0.0000043,
2,5,2074,2079,0.0001465,0.0000053,
2,6,2074,2080,0.0001399,0.0000061,
2,7,2074,2081,0.0001348,0.0000070,
2,8,2074,2082,0.0001336,0.0000084,
2,9,2074,2083,0.0001377,0.0000106,
2,10,2074,2084,0.0001465,0.0000138,
2,11,2074,2085,0.0001596,0.0000181,
2,12,2074,2086,0.0001783,0.0000241,
2,13,2074,2087,0.0002061,0.0000329,
2,14,2074,2088,0.0002415,0.0000445,
2,15,2074,2089,0.0002756,0.0000549,
2,16,2074,2090,0.0003003,0.0000593,
2,17,2074,2091,0.0003175,0.0000580,
2,18,2074,2092,0.0003342,0.0000564,
2,19,2074,2093,0.0003539,0.0000573,
2,20,2074,2094,0.0003732,0.0000590,
2,21,2074,2095,0.0003859,0.0000578,
2,22,2074,2096,0.0003897,0.0000529,
2,23,2074,2097,0.0003908,0.0000475,
2,24,2074,2098,0.0003983,0.0000454,
2,25,2074,2099,0.0004147,0.0000466,
2,26,2074,2100,0.0004348,0.0000488,
2,27,2074,2101,0.0004528,0.0000496,
2,28,2074,2102,0.0004684,0.0000506,
2,29,2074,2103,0.0004856,0.0000519,
2,30,2074,2104,0.0005091,0.0000539,
2,31,2074,2105,0.0005408,0.0000565,
2,32,2074,2106,0.0005796,0.0000591,
2,33,2074,2107,0.0006220,0.0000612,
2,34,2074,2108,0.0006665,0.0000629,
2,35,2074,2109,0.0007153,0.0000643,
2,36,2074,2110,0.0007710,0.0000679,
2,37,2074,2111,0.0008314,0.0000715,
2,38,2074,2112,0.0008908,0.0000763,
2,39,2074,2113,0.0009481,0.0000831,
2,40,2074,2114,0.0010090,0.0000916,
2,41,2074,2115,0.0010784,0.0001003,
2,42,2074,2116,0.0011559,0.0001093,
2,43,2074,2117,0.0012427,0.0001215,
2,44,2074,2118,0.0013435,0.0001406,
2,45,2074,2119,0.0014588,0.0001628,
2,46,2074,2120,0.0015840,0.0001866,
2,47,2074,2121,0.0017152,0.0002061,
2,48,2074,2122,0.0018531,0.0002242,
2,49,2074,2123,0.0020059,0.0002431,
2,50,2074,2124,0.0021845,0.0002603,
2,51,2074,2125,0.0023896,0.0002747,
2,52,2074,2126,0.0026115,0.0002876,
2,53,2074,2127,0.0028474,0.0003041,
2,54,2074,2128,0.0031082,0.0003328,
2,55,2074,2129,0.0034035,0.0003677,
2,56,2074,2130,0.0037277,0.0004024,
2,57,2074,2131,0.0040692,0.0004272,
2,58,2074,2132,0.0044295,0.0004483,
2,59,2074,2133,0.0048296,0.0004766,
2,60,2074,2134,0.0052973,0.0005191,
2,61,2074,2135,0.0058480,0.0005763,
2,62,2074,2136,0.0064757,0.0006474,
2,63,2074,2137,0.0071641,0.0007345,
2,64,2074,2138,0.0078986,0.0008307,
2,65,2074,2139,0.0086645,0.0009145,
2,66,2074,2140,0.0094558,0.0009826,
2,67,2074,2141,0.0103010,0.0010491,
2,68,2074,2142,0.0112531,0.0011341,
2,69,2074,2143,0.0123584,0.0012463,
2,70,2074,2144,0.0136702,0.0013980,
2,71,2074,2145,0.0152518,0.0016243,
2,72,2074,2146,0.0170987,0.0019346,
2,73,2074,2147,0.0190837,0.0022787,
2,74,2074,2148,0.0210750,0.0026025,
2,75,2074,2149,0.0231062,0.0029069,
2,76,2074,2150,0.0253497,0.0032689,
2,0,2075,2075,0.0077995,0.0005668,
2,1,2075,2076,0.0005341,0.0000090,
2,2,2075,2077,0.0002805,0.0000056,
2,3,2075,2078,0.0001960,0.0000048,
2,4,2075,2079,0.0001520,0.0000040,
2,5,2075,2080,0.0001465,0.0000050,
2,6,2075,2081,0.0001399,0.0000058,
2,7,2075,2082,0.0001348,0.0000067,
2,8,2075,2083,0.0001336,0.0000081,
2,9,2075,2084,0.0001377,0.0000102,
2,10,2075,2085,0.0001465,0.0000133,
2,11,2075,2086,0.0001596,0.0000176,
2,12,2075,2087,0.0001783,0.0000234,
2,13,2075,2088,0.0002061,0.0000321,
2,14,2075,2089,0.0002415,0.0000435,
2,15,2075,2090,0.0002756,0.0000537,
2,16,2075,2091,0.0003003,0.0000580,
2,17,2075,2092,0.0003175,0.0000568,
2,18,2075,2093,0.0003342,0.0000552,
2,19,2075,2094,0.0003539,0.0000561,
2,20,2075,2095,0.0003732,0.0000576,
2,21,2075,2096,0.0003859,0.0000564,
2,22,2075,2097,0.0003897,0.0000516,
2,23,2075,2098,0.0003908,0.0000464,
2,24,2075,2099,0.0003983,0.0000443,
2,25,2075,2100,0.0004147,0.0000454,
2,26,2075,2101,0.0004348,0.0000475,
2,27,2075,2102,0.0004528,0.0000483,
2,28,2075,2103,0.0004684,0.0000495,
2,29,2075,2104,0.0004856,0.0000507,
2,30,2075,2105,0.0005091,0.0000525,
2,31,2075,2106,0.0005408,0.0000550,
2,32,2075,2107,0.0005796,0.0000577,
2,33,2075,2108,0.0006220,0.0000599,
2,34,2075,2109,0.0006665,0.0000614,
2,35,2075,2110,0.0007153,0.0000626,
2,36,2075,2111,0.0007710,0.0000661,
2,37,2075,2112,0.0008314,0.0000697,
2,38,2075,2113,0.0008908,0.0000745,
2,39,2075,2114,0.0009481,0.0000812,
2,40,2075,2115,0.0010090,0.0000893,
2,41,2075,2116,0.0010784,0.0000979,
2,42,2075,2117,0.0011559,0.0001069,
2,43,2075,2118,0.0012427,0.0001190,
2,44,2075,2119,0.0013435,0.0001377,
2,45,2075,2120,0.0014588,0.0001593,
2,46,2075,2121,0.0015840,0.0001826,
2,47,2075,2122,0.0017152,0.0002021,
2,48,2075,2123,0.0018531,0.0002201,
2,49,2075,2124,0.0020059,0.0002386,
2,50,2075,2125,0.0021845,0.0002551,
2,51,2075,2126,0.0023896,0.0002691,
2,52,2075,2127,0.0026115,0.0002819,
2,53,2075,2128,0.0028474,0.0002986,
2,54,2075,2129,0.0031082,0.0003267,
2,55,2075,2130,0.0034035,0.0003604,
2,56,2075,2131,0.0037277,0.0003943,
2,57,2075,2132,0.0040692,0.0004191,
2,58,2075,2133,0.0044295,0.0004403,
2,59,2075,2134,0.0048296,0.0004678,
2,60,2075,2135,0.0052973,0.0005088,
2,61,2075,2136,0.0058480,0.0005647,
2,62,2075,2137,0.0064757,0.0006353,
2,63,2075,2138,0.0071641,0.0007220,
2,64,2075,2139,0.0078986,0.0008165,
2,65,2075,2140,0.0086645,0.0008976,
2,66,2075,2141,0.0094558,0.0009640,
2,67,2075,2142,0.0103010,0.0010304,
2,68,2075,2143,0.0112531,0.0011155,
2,69,2075,2144,0.0123584,0.0012255,
2,70,2075,2145,0.0136702,0.0013730,
2,71,2075,2146,0.0152518,0.0015953,
2,72,2075,2147,0.0170987,0.0019032,
2,73,2075,2148,0.0190837,0.0022453,
2,74,2075,2149,0.0210750,0.0025641,
2,75,2075,2150,0.0231062,0.0028609,
2,0,2076,2076,0.0077995,0.0005419,
2,1,2076,2077,0.0005341,0.0000084,
2,2,2076,2078,0.0002805,0.0000053,
2,3,2076,2079,0.0001960,0.0000046,
2,4,2076,2080,0.0001520,0.0000038,
2,5,2076,2081,0.0001465,0.0000048,
2,6,2076,2082,0.0001399,0.0000056,
2,7,2076,2083,0.0001348,0.0000065,
2,8,2076,2084,0.0001336,0.0000078,
2,9,2076,2085,0.0001377,0.0000099,
2,10,2076,2086,0.0001465,0.0000129,
2,11,2076,2087,0.0001596,0.0000171,
2,12,2076,2088,0.0001783,0.0000228,
2,13,2076,2089,0.0002061,0.0000314,
2,14,2076,2090,0.0002415,0.0000425,
2,15,2076,2091,0.0002756,0.0000525,
2,16,2076,2092,0.0003003,0.0000568,
2,17,2076,2093,0.0003175,0.0000557,
2,18,2076,2094,0.0003342,0.0000541,
2,19,2076,2095,0.0003539,0.0000547,
2,20,2076,2096,0.0003732,0.0000562,
2,21,2076,2097,0.0003859,0.0000551,
2,22,2076,2098,0.0003897,0.0000505,
2,23,2076,2099,0.0003908,0.0000453,
2,24,2076,2100,0.0003983,0.0000432,
2,25,2076,2101,0.0004147,0.0000442,
2,26,2076,2102,0.0004348,0.0000463,
2,27,2076,2103,0.0004528,0.0000472,
2,28,2076,2104,0.0004684,0.0000483,
2,29,2076,2105,0.0004856,0.0000494,
2,30,2076,2106,0.0005091,0.0000512,
2,31,2076,2107,0.0005408,0.0000537,
2,32,2076,2108,0.0005796,0.0000564,
2,33,2076,2109,0.0006220,0.0000585,
2,34,2076,2110,0.0006665,0.0000599,
2,35,2076,2111,0.0007153,0.0000610,
2,36,2076,2112,0.0007710,0.0000645,
2,37,2076,2113,0.0008314,0.0000681,
2,38,2076,2114,0.0008908,0.0000728,
2,39,2076,2115,0.0009481,0.0000792,
2,40,2076,2116,0.0010090,0.0000871,
2,41,2076,2117,0.0010784,0.0000956,
2,42,2076,2118,0.0011559,0.0001046,
2,43,2076,2119,0.0012427,0.0001164,
2,44,2076,2120,0.0013435,0.0001346,
2,45,2076,2121,0.0014588,0.0001558,
2,46,2076,2122,0.0015840,0.0001790,
2,47,2076,2123,0.0017152,0.0001984,
2,48,2076,2124,0.0018531,0.0002161,
2,49,2076,2125,0.0020059,0.0002338,
2,50,2076,2126,0.0021845,0.0002499,
2,51,2076,2127,0.0023896,0.0002639,
2,52,2076,2128,0.0026115,0.0002768,
2,53,2076,2129,0.0028474,0.0002930,
2,54,2076,2130,0.0031082,0.0003201,
2,55,2076,2131,0.0034035,0.0003531,
2,56,2076,2132,0.0037277,0.0003868,
2,57,2076,2133,0.0040692,0.0004117,
2,58,2076,2134,0.0044295,0.0004323,
2,59,2076,2135,0.0048296,0.0004585,
2,60,2076,2136,0.0052973,0.0004984,
2,61,2076,2137,0.0058480,0.0005540,
2,62,2076,2138,0.0064757,0.0006243,
2,63,2076,2139,0.0071641,0.0007094,
2,64,2076,2140,0.0078986,0.0008012,
2,65,2076,2141,0.0086645,0.0008806,
2,66,2076,2142,0.0094558,0.0009468,
2,67,2076,2143,0.0103010,0.0010134,
2,68,2076,2144,0.0112531,0.0010968,
2,69,2076,2145,0.0123584,0.0012033,
2,70,2076,2146,0.0136702,0.0013479,
2,71,2076,2147,0.0152518,0.0015685,
2,72,2076,2148,0.0170987,0.0018744,
2,73,2076,2149,0.0190837,0.0022115,
2,74,2076,2150,0.0210750,0.0025229,
2,0,2077,2077,0.0077995,0.0005194,
2,1,2077,2078,0.0005341,0.0000079,
2,2,2077,2079,0.0002805,0.0000050,
2,3,2077,2080,0.0001960,0.0000043,
2,4,2077,2081,0.0001520,0.0000036,
2,5,2077,2082,0.0001465,0.0000045,
2,6,2077,2083,0.0001399,0.0000053,
2,7,2077,2084,0.0001348,0.0000062,
2,8,2077,2085,0.0001336,0.0000075,
2,9,2077,2086,0.0001377,0.0000095,
2,10,2077,2087,0.0001465,0.0000124,
2,11,2077,2088,0.0001596,0.0000166,
2,12,2077,2089,0.0001783,0.0000223,
2,13,2077,2090,0.0002061,0.0000306,
2,14,2077,2091,0.0002415,0.0000415,
2,15,2077,2092,0.0002756,0.0000514,
2,16,2077,2093,0.0003003,0.0000557,
2,17,2077,2094,0.0003175,0.0000545,
2,18,2077,2095,0.0003342,0.0000528,
2,19,2077,2096,0.0003539,0.0000534,
2,20,2077,2097,0.0003732,0.0000550,
2,21,2077,2098,0.0003859,0.0000539,
2,22,2077,2099,0.0003897,0.0000493,
2,23,2077,2100,0.0003908,0.0000441,
2,24,2077,2101,0.0003983,0.0000420,
2,25,2077,2102,0.0004147,0.0000431,
2,26,2077,2103,0.0004348,0.0000453,
2,27,2077,2104,0.0004528,0.0000461,
2,28,2077,2105,0.0004684,0.0000471,
2,29,2077,2106,0.0004856,0.0000481,
2,30,2077,2107,0.0005091,0.0000500,
2,31,2077,2108,0.0005408,0.0000525,
2,32,2077,2109,0.0005796,0.0000551,
2,33,2077,2110,0.0006220,0.0000570,
2,34,2077,2111,0.0006665,0.0000583,
2,35,2077,2112,0.0007153,0.0000595,
2,36,2077,2113,0.0007710,0.0000630,
2,37,2077,2114,0.0008314,0.0000665,
2,38,2077,2115,0.0008908,0.0000710,
2,39,2077,2116,0.0009481,0.0000772,
2,40,2077,2117,0.0010090,0.0000851,
2,41,2077,2118,0.0010784,0.0000936,
2,42,2077,2119,0.0011559,0.0001023,
2,43,2077,2120,0.0012427,0.0001138,
2,44,2077,2121,0.0013435,0.0001316,
2,45,2077,2122,0.0014588,0.0001526,
2,46,2077,2123,0.0015840,0.0001757,
2,47,2077,2124,0.0017152,0.0001947,
2,48,2077,2125,0.0018531,0.0002117,
2,49,2077,2126,0.0020059,0.0002291,
2,50,2077,2127,0.0021845,0.0002451,
2,51,2077,2128,0.0023896,0.0002591,
2,52,2077,2129,0.0026115,0.0002717,
2,53,2077,2130,0.0028474,0.0002871,
2,54,2077,2131,0.0031082,0.0003136,
2,55,2077,2132,0.0034035,0.0003463,
2,56,2077,2133,0.0037277,0.0003800,
2,57,2077,2134,0.0040692,0.0004042,
2,58,2077,2135,0.0044295,0.0004237,
2,59,2077,2136,0.0048296,0.0004491,
2,60,2077,2137,0.0052973,0.0004889,
2,61,2077,2138,0.0058480,0.0005443,
2,62,2077,2139,0.0064757,0.0006132,
2,63,2077,2140,0.0071641,0.0006959,
2,64,2077,2141,0.0078986,0.0007859,
2,65,2077,2142,0.0086645,0.0008649,
2,66,2077,2143,0.0094558,0.0009312,
2,67,2077,2144,0.0103010,0.0009963,
2,68,2077,2145,0.0112531,0.0010767,
2,69,2077,2146,0.0123584,0.0011810,
2,70,2077,2147,0.0136702,0.0013246,
2,71,2077,2148,0.0152518,0.0015439,
2,72,2077,2149,0.0170987,0.0018453,
2,73,2077,2150,0.0190837,0.0021752,
2,0,2078,2078,0.0077995,0.0004994,
2,1,2078,2079,0.0005341,0.0000075,
2,2,2078,2080,0.0002805,0.0000047,
2,3,2078,2081,0.0001960,0.0000040,
2,4,2078,2082,0.0001520,0.0000034,
2,5,2078,2083,0.0001465,0.0000043,
2,6,2078,2084,0.0001399,0.0000051,
2,7,2078,2085,0.0001348,0.0000059,
2,8,2078,2086,0.0001336,0.0000072,
2,9,2078,2087,0.0001377,0.0000091,
2,10,2078,2088,0.0001465,0.0000121,
2,11,2078,2089,0.0001596,0.0000161,
2,12,2078,2090,0.0001783,0.0000216,
2,13,2078,2091,0.0002061,0.0000298,
2,14,2078,2092,0.0002415,0.0000406,
2,15,2078,2093,0.0002756,0.0000504,
2,16,2078,2094,0.0003003,0.0000546,
2,17,2078,2095,0.0003175,0.0000533,
2,18,2078,2096,0.0003342,0.0000515,
2,19,2078,2097,0.0003539,0.0000522,
2,20,2078,2098,0.0003732,0.0000538,
2,21,2078,2099,0.0003859,0.0000527,
2,22,2078,2100,0.0003897,0.0000481,
2,23,2078,2101,0.0003908,0.0000430,
2,24,2078,2102,0.0003983,0.0000409,
2,25,2078,2103,0.0004147,0.0000421,
2,26,2078,2104,0.0004348,0.0000442,
2,27,2078,2105,0.0004528,0.0000449,
2,28,2078,2106,0.0004684,0.0000459,
2,29,2078,2107,0.0004856,0.0000469,
2,30,2078,2108,0.0005091,0.0000488,
2,31,2078,2109,0.0005408,0.0000513,
2,32,2078,2110,0.0005796,0.0000537,
2,33,2078,2111,0.0006220,0.0000555,
2,34,2078,2112,0.0006665,0.0000569,
2,35,2078,2113,0.0007153,0.0000581,
2,36,2078,2114,0.0007710,0.0000615,
2,37,2078,2115,0.0008314,0.0000648,
2,38,2078,2116,0.0008908,0.0000691,
2,39,2078,2117,0.0009481,0.0000753,
2,40,2078,2118,0.0010090,0.0000832,
2,41,2078,2119,0.0010784,0.0000915,
2,42,2078,2120,0.0011559,0.0000999,
2,43,2078,2121,0.0012427,0.0001111,
2,44,2078,2122,0.0013435,0.0001288,
2,45,2078,2123,0.0014588,0.0001497,
2,46,2078,2124,0.0015840,0.0001723,
2,47,2078,2125,0.0017152,0.0001907,
2,48,2078,2126,0.0018531,0.0002073,
2,49,2078,2127,0.0020059,0.0002247,
2,50,2078,2128,0.0021845,0.0002407,
2,51,2078,2129,0.0023896,0.0002544,
2,52,2078,2130,0.0026115,0.0002662,
2,53,2078,2131,0.0028474,0.0002812,
2,54,2078,2132,0.0031082,0.0003075,
2,55,2078,2133,0.0034035,0.0003402,
2,56,2078,2134,0.0037277,0.0003731,
2,57,2078,2135,0.0040692,0.0003963,
2,58,2078,2136,0.0044295,0.0004151,
2,59,2078,2137,0.0048296,0.0004405,
2,60,2078,2138,0.0052973,0.0004802,
2,61,2078,2139,0.0058480,0.0005344,
2,62,2078,2140,0.0064757,0.0006013,
2,63,2078,2141,0.0071641,0.0006823,
2,64,2078,2142,0.0078986,0.0007717,
2,65,2078,2143,0.0086645,0.0008506,
2,66,2078,2144,0.0094558,0.0009155,
2,67,2078,2145,0.0103010,0.0009781,
2,68,2078,2146,0.0112531,0.0010566,
2,69,2078,2147,0.0123584,0.0011604,
2,70,2078,2148,0.0136702,0.0013033,
2,71,2078,2149,0.0152518,0.0015190,
2,72,2078,2150,0.0170987,0.0018140,
2,0,2079,2079,0.0077995,0.0004798,
2,1,2079,2080,0.0005341,0.0000070,
2,2,2079,2081,0.0002805,0.0000044,
2,3,2079,2082,0.0001960,0.0000038,
2,4,2079,2083,0.0001520,0.0000032,
2,5,2079,2084,0.0001465,0.0000041,
2,6,2079,2085,0.0001399,0.0000049,
2,7,2079,2086,0.0001348,0.0000057,
2,8,2079,2087,0.0001336,0.0000069,
2,9,2079,2088,0.0001377,0.0000088,
2,10,2079,2089,0.0001465,0.0000117,
2,11,2079,2090,0.0001596,0.0000156,
2,12,2079,2091,0.0001783,0.0000210,
2,13,2079,2092,0.0002061,0.0000291,
2,14,2079,2093,0.0002415,0.0000398,
2,15,2079,2094,0.0002756,0.0000494,
2,16,2079,2095,0.0003003,0.0000534,
2,17,2079,2096,0.0003175,0.0000521,
2,18,2079,2097,0.0003342,0.0000504,
2,19,2079,2098,0.0003539,0.0000511,
2,20,2079,2099,0.0003732,0.0000526,
2,21,2079,2100,0.0003859,0.0000515,
2,22,2079,2101,0.0003897,0.0000469,
2,23,2079,2102,0.0003908,0.0000419,
2,24,2079,2103,0.0003983,0.0000400,
2,25,2079,2104,0.0004147,0.0000411,
2,26,2079,2105,0.0004348,0.0000431,
2,27,2079,2106,0.0004528,0.0000438,
2,28,2079,2107,0.0004684,0.0000448,
2,29,2079,2108,0.0004856,0.0000459,
2,30,2079,2109,0.0005091,0.0000477,
2,31,2079,2110,0.0005408,0.0000500,
2,32,2079,2111,0.0005796,0.0000524,
2,33,2079,2112,0.0006220,0.0000542,
2,34,2079,2113,0.0006665,0.0000556,
2,35,2079,2114,0.0007153,0.0000567,
2,36,2079,2115,0.0007710,0.0000600,
2,37,2079,2116,0.0008314,0.0000631,
2,38,2079,2117,0.0008908,0.0000674,
2,39,2079,2118,0.0009481,0.0000737,
2,40,2079,2119,0.0010090,0.0000813,
2,41,2079,2120,0.0010784,0.0000893,
2,42,2079,2121,0.0011559,0.0000975,
2,43,2079,2122,0.0012427,0.0001086,
2,44,2079,2123,0.0013435,0.0001262,
2,45,2079,2124,0.0014588,0.0001467,
2,46,2079,2125,0.0015840,0.0001687,
2,47,2079,2126,0.0017152,0.0001867,
2,48,2079,2127,0.0018531,0.0002033,
2,49,2079,2128,0.0020059,0.0002206,
2,50,2079,2129,0.0021845,0.0002364,
2,51,2079,2130,0.0023896,0.0002493,
2,52,2079,2131,0.0026115,0.0002607,
2,53,2079,2132,0.0028474,0.0002757,
2,54,2079,2133,0.0031082,0.0003020,
2,55,2079,2134,0.0034035,0.0003340,
2,56,2079,2135,0.0037277,0.0003658,
2,57,2079,2136,0.0040692,0.0003883,
2,58,2079,2137,0.0044295,0.0004071,
2,59,2079,2138,0.0048296,0.0004326,
2,60,2079,2139,0.0052973,0.0004714,
2,61,2079,2140,0.0058480,0.0005239,
2,62,2079,2141,0.0064757,0.0005893,
2,63,2079,2142,0.0071641,0.0006698,
2,64,2079,2143,0.0078986,0.0007589,
2,65,2079,2144,0.0086645,0.0008363,
2,66,2079,2145,0.0094558,0.0008988,
2,67,2079,2146,0.0103010,0.0009598,
2,68,2079,2147,0.0112531,0.0010380,
2,69,2079,2148,0.0123584,0.0011415,
2,70,2079,2149,0.0136702,0.0012818,
2,71,2079,2150,0.0152518,0.0014924,
2,0,2080,2080,0.0077995,0.0004593,
2,1,2080,2081,0.0005341,0.0000065,
2,2,2080,2082,0.0002805,0.0000041,
2,3,2080,2083,0.0001960,0.0000036,
2,4,2080,2084,0.0001520,0.0000031,
2,5,2080,2085,0.0001465,0.0000039,
2,6,2080,2086,0.0001399,0.0000046,
2,7,2080,2087,0.0001348,0.0000054,
2,8,2080,2088,0.0001336,0.0000067,
2,9,2080,2089,0.0001377,0.0000085,
2,10,2080,2090,0.0001465,0.0000113,
2,11,2080,2091,0.0001596,0.0000151,
2,12,2080,2092,0.0001783,0.0000204,
2,13,2080,2093,0.0002061,0.0000284,
2,14,2080,2094,0.0002415,0.0000389,
2,15,2080,2095,0.0002756,0.0000483,
2,16,2080,2096,0.0003003,0.0000522,
2,17,2080,2097,0.0003175,0.0000509,
2,18,2080,2098,0.0003342,0.0000494,
2,19,2080,2099,0.0003539,0.0000500,
2,20,2080,2100,0.0003732,0.0000514,
2,21,2080,2101,0.0003859,0.0000502,
2,22,2080,2102,0.0003897,0.0000458,
2,23,2080,2103,0.0003908,0.0000409,
2,24,2080,2104,0.0003983,0.0000390,
2,25,2080,2105,0.0004147,0.0000400,
2,26,2080,2106,0.0004348,0.0000419,
2,27,2080,2107,0.0004528,0.0000427,
2,28,2080,2108,0.0004684,0.0000437,
2,29,2080,2109,0.0004856,0.0000448,
2,30,2080,2110,0.0005091,0.0000465,
2,31,2080,2111,0.0005408,0.0000487,
2,32,2080,2112,0.0005796,0.0000511,
2,33,2080,2113,0.0006220,0.0000530,
2,34,2080,2114,0.0006665,0.0000543,
2,35,2080,2115,0.0007153,0.0000553,
2,36,2080,2116,0.0007710,0.0000584,
2,37,2080,2117,0.0008314,0.0000616,
2,38,2080,2118,0.0008908,0.0000659,
2,39,2080,2119,0.0009481,0.0000720,
2,40,2080,2120,0.0010090,0.0000794,
2,41,2080,2121,0.0010784,0.0000871,
2,42,2080,2122,0.0011559,0.0000953,
2,43,2080,2123,0.0012427,0.0001063,
2,44,2080,2124,0.0013435,0.0001236,
2,45,2080,2125,0.0014588,0.0001436,
2,46,2080,2126,0.0015840,0.0001651,
2,47,2080,2127,0.0017152,0.0001831,
2,48,2080,2128,0.0018531,0.0001997,
2,49,2080,2129,0.0020059,0.0002166,
2,50,2080,2130,0.0021845,0.0002317,
2,51,2080,2131,0.0023896,0.0002442,
2,52,2080,2132,0.0026115,0.0002557,
2,53,2080,2133,0.0028474,0.0002707,
2,54,2080,2134,0.0031082,0.0002964,
2,55,2080,2135,0.0034035,0.0003273,
2,56,2080,2136,0.0037277,0.0003584,
2,57,2080,2137,0.0040692,0.0003809,
2,58,2080,2138,0.0044295,0.0003998,
2,59,2080,2139,0.0048296,0.0004247,
2,60,2080,2140,0.0052973,0.0004620,
2,61,2080,2141,0.0058480,0.0005134,
2,62,2080,2142,0.0064757,0.0005783,
2,63,2080,2143,0.0071641,0.0006584,
2,64,2080,2144,0.0078986,0.0007460,
2,65,2080,2145,0.0086645,0.0008210,
2,66,2080,2146,0.0094558,0.0008819,
2,67,2080,2147,0.0103010,0.0009428,
2,68,2080,2148,0.0112531,0.0010210,
2,69,2080,2149,0.0123584,0.0011224,
2,70,2080,2150,0.0136702,0.0012587,
2,0,2081,2081,0.0077995,0.0004392,
2,1,2081,2082,0.0005341,0.0000061,
2,2,2081,2083,0.0002805,0.0000039,
2,3,2081,2084,0.0001960,0.0000034,
2,4,2081,2085,0.0001520,0.0000029,
2,5,2081,2086,0.0001465,0.0000037,
2,6,2081,2087,0.0001399,0.0000044,
2,7,2081,2088,0.0001348,0.0000052,
2,8,2081,2089,0.0001336,0.0000064,
2,9,2081,2090,0.0001377,0.0000082,
2,10,2081,2091,0.0001465,0.0000109,
2,11,2081,2092,0.0001596,0.0000147,
2,12,2081,2093,0.0001783,0.0000199,
2,13,2081,2094,0.0002061,0.0000278,
2,14,2081,2095,0.0002415,0.0000380,
2,15,2081,2096,0.0002756,0.0000472,
2,16,2081,2097,0.0003003,0.0000511,
2,17,2081,2098,0.0003175,0.0000499,
2,18,2081,2099,0.0003342,0.0000483,
2,19,2081,2100,0.0003539,0.0000489,
2,20,2081,2101,0.0003732,0.0000502,
2,21,2081,2102,0.0003859,0.0000491,
2,22,2081,2103,0.0003897,0.0000447,
2,23,2081,2104,0.0003908,0.0000400,
2,24,2081,2105,0.0003983,0.0000380,
2,25,2081,2106,0.0004147,0.0000390,
2,26,2081,2107,0.0004348,0.0000409,
2,27,2081,2108,0.0004528,0.0000417,
2,28,2081,2109,0.0004684,0.0000427,
2,29,2081,2110,0.0004856,0.0000437,
2,30,2081,2111,0.0005091,0.0000453,
2,31,2081,2112,0.0005408,0.0000475,
2,32,2081,2113,0.0005796,0.0000499,
2,33,2081,2114,0.0006220,0.0000517,
2,34,2081,2115,0.0006665,0.0000529,
2,35,2081,2116,0.0007153,0.0000538,
2,36,2081,2117,0.0007710,0.0000570,
2,37,2081,2118,0.0008314,0.0000601,
2,38,2081,2119,0.0008908,0.0000644,
2,39,2081,2120,0.0009481,0.0000702,
2,40,2081,2121,0.0010090,0.0000774,
2,41,2081,2122,0.0010784,0.0000851,
2,42,2081,2123,0.0011559,0.0000933,
2,43,2081,2124,0.0012427,0.0001041,
2,44,2081,2125,0.0013435,0.0001208,
2,45,2081,2126,0.0014588,0.0001404,
2,46,2081,2127,0.0015840,0.0001618,
2,47,2081,2128,0.0017152,0.0001797,
2,48,2081,2129,0.0018531,0.0001960,
2,49,2081,2130,0.0020059,0.0002123,
2,50,2081,2131,0.0021845,0.0002270,
2,51,2081,2132,0.0023896,0.0002395,
2,52,2081,2133,0.0026115,0.0002510,
2,53,2081,2134,0.0028474,0.0002656,
2,54,2081,2135,0.0031082,0.0002904,
2,55,2081,2136,0.0034035,0.0003207,
2,56,2081,2137,0.0037277,0.0003516,
2,57,2081,2138,0.0040692,0.0003741,
2,58,2081,2139,0.0044295,0.0003925,
2,59,2081,2140,0.0048296,0.0004162,
2,60,2081,2141,0.0052973,0.0004526,
2,61,2081,2142,0.0058480,0.0005036,
2,62,2081,2143,0.0064757,0.0005683,
2,63,2081,2144,0.0071641,0.0006470,
2,64,2081,2145,0.0078986,0.0007322,
2,65,2081,2146,0.0086645,0.0008056,
2,66,2081,2147,0.0094558,0.0008664,
2,67,2081,2148,0.0103010,0.0009273,
2,68,2081,2149,0.0112531,0.0010038,
2,69,2081,2150,0.0123584,0.0011019,
2,0,2082,2082,0.0077995,0.0004211,
2,1,2082,2083,0.0005341,0.0000058,
2,2,2082,2084,0.0002805,0.0000037,
2,3,2082,2085,0.0001960,0.0000032,
2,4,2082,2086,0.0001520,0.0000027,
2,5,2082,2087,0.0001465,0.0000035,
2,6,2082,2088,0.0001399,0.0000042,
2,7,2082,2089,0.0001348,0.0000050,
2,8,2082,2090,0.0001336,0.0000061,
2,9,2082,2091,0.0001377,0.0000079,
2,10,2082,2092,0.0001465,0.0000105,
2,11,2082,2093,0.0001596,0.0000143,
2,12,2082,2094,0.0001783,0.0000194,
2,13,2082,2095,0.0002061,0.0000270,
2,14,2082,2096,0.0002415,0.0000371,
2,15,2082,2097,0.0002756,0.0000462,
2,16,2082,2098,0.0003003,0.0000501,
2,17,2082,2099,0.0003175,0.0000489,
2,18,2082,2100,0.0003342,0.0000472,
2,19,2082,2101,0.0003539,0.0000477,
2,20,2082,2102,0.0003732,0.0000490,
2,21,2082,2103,0.0003859,0.0000480,
2,22,2082,2104,0.0003897,0.0000437,
2,23,2082,2105,0.0003908,0.0000390,
2,24,2082,2106,0.0003983,0.0000370,
2,25,2082,2107,0.0004147,0.0000380,
2,26,2082,2108,0.0004348,0.0000400,
2,27,2082,2109,0.0004528,0.0000407,
2,28,2082,2110,0.0004684,0.0000416,
2,29,2082,2111,0.0004856,0.0000425,
2,30,2082,2112,0.0005091,0.0000442,
2,31,2082,2113,0.0005408,0.0000464,
2,32,2082,2114,0.0005796,0.0000488,
2,33,2082,2115,0.0006220,0.0000504,
2,34,2082,2116,0.0006665,0.0000515,
2,35,2082,2117,0.0007153,0.0000525,
2,36,2082,2118,0.0007710,0.0000557,
2,37,2082,2119,0.0008314,0.0000587,
2,38,2082,2120,0.0008908,0.0000627,
2,39,2082,2121,0.0009481,0.0000684,
2,40,2082,2122,0.0010090,0.0000755,
2,41,2082,2123,0.0010784,0.0000833,
2,42,2082,2124,0.0011559,0.0000912,
2,43,2082,2125,0.0012427,0.0001017,
2,44,2082,2126,0.0013435,0.0001181,
2,45,2082,2127,0.0014588,0.0001375,
2,46,2082,2128,0.0015840,0.0001588,
2,47,2082,2129,0.0017152,0.0001764,
2,48,2082,2130,0.0018531,0.0001921,
2,49,2082,2131,0.0020059,0.0002080,
2,50,2082,2132,0.0021845,0.0002226,
2,51,2082,2133,0.0023896,0.0002352,
2,52,2082,2134,0.0026115,0.0002464,
2,53,2082,2135,0.0028474,0.0002602,
2,54,2082,2136,0.0031082,0.0002845,
2,55,2082,2137,0.0034035,0.0003146,
2,56,2082,2138,0.0037277,0.0003454,
2,57,2082,2139,0.0040692,0.0003673,
2,58,2082,2140,0.0044295,0.0003847,
2,59,2082,2141,0.0048296,0.0004077,
2,60,2082,2142,0.0052973,0.0004439,
2,61,2082,2143,0.0058480,0.0004948,
2,62,2082,2144,0.0064757,0.0005583,
2,63,2082,2145,0.0071641,0.0006348,
2,64,2082,2146,0.0078986,0.0007183,
2,65,2082,2147,0.0086645,0.0007913,
2,66,2082,2148,0.0094558,0.0008521,
2,67,2082,2149,0.0103010,0.0009116,
2,68,2082,2150,0.0112531,0.0009853,
2,0,2083,2083,0.0077995,0.0004049,
2,1,2083,2084,0.0005341,0.0000054,
2,2,2083,2085,0.0002805,0.0000035,
2,3,2083,2086,0.0001960,0.0000031,
2,4,2083,2087,0.0001520,0.0000026,
2,5,2083,2088,0.0001465,0.0000034,
2,6,2083,2089,0.0001399,0.0000040,
2,7,2083,2090,0.0001348,0.0000048,
2,8,2083,2091,0.0001336,0.0000059,
2,9,2083,2092,0.0001377,0.0000076,
2,10,2083,2093,0.0001465,0.0000102,
2,11,2083,2094,0.0001596,0.0000139,
2,12,2083,2095,0.0001783,0.0000189,
2,13,2083,2096,0.0002061,0.0000263,
2,14,2083,2097,0.0002415,0.0000363,
2,15,2083,2098,0.0002756,0.0000453,
2,16,2083,2099,0.0003003,0.0000491,
2,17,2083,2100,0.0003175,0.0000478,
2,18,2083,2101,0.0003342,0.0000461,
2,19,2083,2102,0.0003539,0.0000466,
2,20,2083,2103,0.0003732,0.0000480,
2,21,2083,2104,0.0003859,0.0000470,
2,22,2083,2105,0.0003897,0.0000427,
2,23,2083,2106,0.0003908,0.0000379,
2,24,2083,2107,0.0003983,0.0000361,
2,25,2083,2108,0.0004147,0.0000371,
2,26,2083,2109,0.0004348,0.0000390,
2,27,2083,2110,0.0004528,0.0000397,
2,28,2083,2111,0.0004684,0.0000405,
2,29,2083,2112,0.0004856,0.0000415,
2,30,2083,2113,0.0005091,0.0000432,
2,31,2083,2114,0.0005408,0.0000454,
2,32,2083,2115,0.0005796,0.0000476,
2,33,2083,2116,0.0006220,0.0000491,
2,34,2083,2117,0.0006665,0.0000503,
2,35,2083,2118,0.0007153,0.0000513,
2,36,2083,2119,0.0007710,0.0000543,
2,37,2083,2120,0.0008314,0.0000572,
2,38,2083,2121,0.0008908,0.0000611,
2,39,2083,2122,0.0009481,0.0000667,
2,40,2083,2123,0.0010090,0.0000739,
2,41,2083,2124,0.0010784,0.0000814,
2,42,2083,2125,0.0011559,0.0000891,
2,43,2083,2126,0.0012427,0.0000992,
2,44,2083,2127,0.0013435,0.0001155,
2,45,2083,2128,0.0014588,0.0001348,
2,46,2083,2129,0.0015840,0.0001558,
2,47,2083,2130,0.0017152,0.0001728,
2,48,2083,2131,0.0018531,0.0001881,
2,49,2083,2132,0.0020059,0.0002040,
2,50,2083,2133,0.0021845,0.0002187,
2,51,2083,2134,0.0023896,0.0002309,
2,52,2083,2135,0.0026115,0.0002414,
2,53,2083,2136,0.0028474,0.0002548,
2,54,2083,2137,0.0031082,0.0002790,
2,55,2083,2138,0.0034035,0.0003090,
2,56,2083,2139,0.0037277,0.0003392,
2,57,2083,2140,0.0040692,0.0003601,
2,58,2083,2141,0.0044295,0.0003769,
2,59,2083,2142,0.0048296,0.0003998,
2,60,2083,2143,0.0052973,0.0004361,
2,61,2083,2144,0.0058480,0.0004859,
2,62,2083,2145,0.0064757,0.0005476,
2,63,2083,2146,0.0071641,0.0006226,
2,64,2083,2147,0.0078986,0.0007055,
2,65,2083,2148,0.0086645,0.0007783,
2,66,2083,2149,0.0094558,0.0008377,
2,67,2083,2150,0.0103010,0.0008948,
2,0,2084,2084,0.0077995,0.0003891,
2,1,2084,2085,0.0005341,0.0000051,
2,2,2084,2086,0.0002805,0.0000032,
2,3,2084,2087,0.0001960,0.0000029,
2,4,2084,2088,0.0001520,0.0000025,
2,5,2084,2089,0.0001465,0.0000032,
2,6,2084,2090,0.0001399,0.0000039,
2,7,2084,2091,0.0001348,0.0000046,
2,8,2084,2092,0.0001336,0.0000057,
2,9,2084,2093,0.0001377,0.0000074,
2,10,2084,2094,0.0001465,0.0000099,
2,11,2084,2095,0.0001596,0.0000134,
2,12,2084,2096,0.0001783,0.0000183,
2,13,2084,2097,0.0002061,0.0000257,
2,14,2084,2098,0.0002415,0.0000355,
2,15,2084,2099,0.0002756,0.0000444,
2,16,2084,2100,0.0003003,0.0000480,
2,17,2084,2101,0.0003175,0.0000467,
2,18,2084,2102,0.0003342,0.0000450,
2,19,2084,2103,0.0003539,0.0000456,
2,20,2084,2104,0.0003732,0.0000470,
2,21,2084,2105,0.0003859,0.0000459,
2,22,2084,2106,0.0003897,0.0000416,
2,23,2084,2107,0.0003908,0.0000370,
2,24,2084,2108,0.0003983,0.0000353,
2,25,2084,2109,0.0004147,0.0000362,
2,26,2084,2110,0.0004348,0.0000380,
2,27,2084,2111,0.0004528,0.0000386,
2,28,2084,2112,0.0004684,0.0000395,
2,29,2084,2113,0.0004856,0.0000405,
2,30,2084,2114,0.0005091,0.0000422,
2,31,2084,2115,0.0005408,0.0000442,
2,32,2084,2116,0.0005796,0.0000464,
2,33,2084,2117,0.0006220,0.0000479,
2,34,2084,2118,0.0006665,0.0000491,
2,35,2084,2119,0.0007153,0.0000501,
2,36,2084,2120,0.0007710,0.0000529,
2,37,2084,2121,0.0008314,0.0000557,
2,38,2084,2122,0.0008908,0.0000596,
2,39,2084,2123,0.0009481,0.0000652,
2,40,2084,2124,0.0010090,0.0000722,
2,41,2084,2125,0.0010784,0.0000795,
2,42,2084,2126,0.0011559,0.0000869,
2,43,2084,2127,0.0012427,0.0000970,
2,44,2084,2128,0.0013435,0.0001132,
2,45,2084,2129,0.0014588,0.0001322,
2,46,2084,2130,0.0015840,0.0001526,
2,47,2084,2131,0.0017152,0.0001692,
2,48,2084,2132,0.0018531,0.0001845,
2,49,2084,2133,0.0020059,0.0002004,
2,50,2084,2134,0.0021845,0.0002147,
2,51,2084,2135,0.0023896,0.0002263,
2,52,2084,2136,0.0026115,0.0002364,
2,53,2084,2137,0.0028474,0.0002499,
2,54,2084,2138,0.0031082,0.0002739,
2,55,2084,2139,0.0034035,0.0003033,
2,56,2084,2140,0.0037277,0.0003325,
2,57,2084,2141,0.0040692,0.0003528,
2,58,2084,2142,0.0044295,0.0003696,
2,59,2084,2143,0.0048296,0.0003927,
2,60,2084,2144,0.0052973,0.0004282,
2,61,2084,2145,0.0058480,0.0004765,
2,62,2084,2146,0.0064757,0.0005368,
2,63,2084,2147,0.0071641,0.0006113,
2,64,2084,2148,0.0078986,0.0006938,
2,65,2084,2149,0.0086645,0.0007651,
2,66,2084,2150,0.0094558,0.0008223,
2,0,2085,2085,0.0077995,0.0003725,
2,1,2085,2086,0.0005341,0.0000047,
2,2,2085,2087,0.0002805,0.0000031,
2,3,2085,2088,0.0001960,0.0000027,
2,4,2085,2089,0.0001520,0.0000023,
2,5,2085,2090,0.0001465,0.0000031,
2,6,2085,2091,0.0001399,0.0000037,
2,7,2085,2092,0.0001348,0.0000044,
2,8,2085,2093,0.0001336,0.0000055,
2,9,2085,2094,0.0001377,0.0000071,
2,10,2085,2095,0.0001465,0.0000096,
2,11,2085,2096,0.0001596,0.0000130,
2,12,2085,2097,0.0001783,0.0000178,
2,13,2085,2098,0.0002061,0.0000251,
2,14,2085,2099,0.0002415,0.0000348,
2,15,2085,2100,0.0002756,0.0000434,
2,16,2085,2101,0.0003003,0.0000470,
2,17,2085,2102,0.0003175,0.0000457,
2,18,2085,2103,0.0003342,0.0000441,
2,19,2085,2104,0.0003539,0.0000447,
2,20,2085,2105,0.0003732,0.0000459,
2,21,2085,2106,0.0003859,0.0000448,
2,22,2085,2107,0.0003897,0.0000406,
2,23,2085,2108,0.0003908,0.0000362,
2,24,2085,2109,0.0003983,0.0000344,
2,25,2085,2110,0.0004147,0.0000353,
2,26,2085,2111,0.0004348,0.0000370,
2,27,2085,2112,0.0004528,0.0000377,
2,28,2085,2113,0.0004684,0.0000386,
2,29,2085,2114,0.0004856,0.0000396,
2,30,2085,2115,0.0005091,0.0000411,
2,31,2085,2116,0.0005408,0.0000431,
2,32,2085,2117,0.0005796,0.0000452,
2,33,2085,2118,0.0006220,0.0000469,
2,34,2085,2119,0.0006665,0.0000480,
2,35,2085,2120,0.0007153,0.0000488,
2,36,2085,2121,0.0007710,0.0000515,
2,37,2085,2122,0.0008314,0.0000543,
2,38,2085,2123,0.0008908,0.0000582,
2,39,2085,2124,0.0009481,0.0000637,
2,40,2085,2125,0.0010090,0.0000704,
2,41,2085,2126,0.0010784,0.0000775,
2,42,2085,2127,0.0011559,0.0000849,
2,43,2085,2128,0.0012427,0.0000950,
2,44,2085,2129,0.0013435,0.0001109,
2,45,2085,2130,0.0014588,0.0001294,
2,46,2085,2131,0.0015840,0.0001494,
2,47,2085,2132,0.0017152,0.0001659,
2,48,2085,2133,0.0018531,0.0001812,
2,49,2085,2134,0.0020059,0.0001968,
2,50,2085,2135,0.0021845,0.0002105,
2,51,2085,2136,0.0023896,0.0002217,
2,52,2085,2137,0.0026115,0.0002318,
2,53,2085,2138,0.0028474,0.0002453,
2,54,2085,2139,0.0031082,0.0002689,
2,55,2085,2140,0.0034035,0.0002973,
2,56,2085,2141,0.0037277,0.0003258,
2,57,2085,2142,0.0040692,0.0003461,
2,58,2085,2143,0.0044295,0.0003631,
2,59,2085,2144,0.0048296,0.0003855,
2,60,2085,2145,0.0052973,0.0004197,
2,61,2085,2146,0.0058480,0.0004670,
2,62,2085,2147,0.0064757,0.0005269,
2,63,2085,2148,0.0071641,0.0006010,
2,64,2085,2149,0.0078986,0.0006820,
2,65,2085,2150,0.0086645,0.0007510,
2,0,2086,2086,0.0077995,0.0003562,
2,1,2086,2087,0.0005341,0.0000044,
2,2,2086,2088,0.0002805,0.0000029,
2,3,2086,2089,0.0001960,0.0000026,
2,4,2086,2090,0.0001520,0.0000022,
2,5,2086,2091,0.0001465,0.0000029,
2,6,2086,2092,0.0001399,0.0000035,
2,7,2086,2093,0.0001348,0.0000042,
2,8,2086,2094,0.0001336,0.0000053,
2,9,2086,2095,0.0001377,0.0000068,
2,10,2086,2096,0.0001465,0.0000092,
2,11,2086,2097,0.0001596,0.0000126,
2,12,2086,2098,0.0001783,0.0000174,
2,13,2086,2099,0.0002061,0.0000245,
2,14,2086,2100,0.0002415,0.0000340,
2,15,2086,2101,0.0002756,0.0000424,
2,16,2086,2102,0.0003003,0.0000460,
2,17,2086,2103,0.0003175,0.0000448,
2,18,2086,2104,0.0003342,0.0000432,
2,19,2086,2105,0.0003539,0.0000436,
2,20,2086,2106,0.0003732,0.0000448,
2,21,2086,2107,0.0003859,0.0000438,
2,22,2086,2108,0.0003897,0.0000397,
2,23,2086,2109,0.0003908,0.0000353,
2,24,2086,2110,0.0003983,0.0000335,
2,25,2086,2111,0.0004147,0.0000343,
2,26,2086,2112,0.0004348,0.0000361,
2,27,2086,2113,0.0004528,0.0000368,
2,28,2086,2114,0.0004684,0.0000377,
2,29,2086,2115,0.0004856,0.0000386,
2,30,2086,2116,0.0005091,0.0000401,
2,31,2086,2117,0.0005408,0.0000421,
2,32,2086,2118,0.0005796,0.0000442,
2,33,2086,2119,0.0006220,0.0000458,
2,34,2086,2120,0.0006665,0.0000467,
2,35,2086,2121,0.0007153,0.0000475,
2,36,2086,2122,0.0007710,0.0000503,
2,37,2086,2123,0.0008314,0.0000530,
2,38,2086,2124,0.0008908,0.0000568,
2,39,2086,2125,0.0009481,0.0000621,
2,40,2086,2126,0.0010090,0.0000686,
2,41,2086,2127,0.0010784,0.0000757,
2,42,2086,2128,0.0011559,0.0000831,
2,43,2086,2129,0.0012427,0.0000930,
2,44,2086,2130,0.0013435,0.0001085,
2,45,2086,2131,0.0014588,0.0001265,
2,46,2086,2132,0.0015840,0.0001464,
2,47,2086,2133,0.0017152,0.0001629,
2,48,2086,2134,0.0018531,0.0001779,
2,49,2086,2135,0.0020059,0.0001929,
2,50,2086,2136,0.0021845,0.0002062,
2,51,2086,2137,0.0023896,0.0002174,
2,52,2086,2138,0.0026115,0.0002276,
2,53,2086,2139,0.0028474,0.0002407,
2,54,2086,2140,0.0031082,0.0002635,
2,55,2086,2141,0.0034035,0.0002912,
2,56,2086,2142,0.0037277,0.0003196,
2,57,2086,2143,0.0040692,0.0003400,
2,58,2086,2144,0.0044295,0.0003565,
2,59,2086,2145,0.0048296,0.0003779,
2,60,2086,2146,0.0052973,0.0004113,
2,61,2086,2147,0.0058480,0.0004582,
2,62,2086,2148,0.0064757,0.0005178,
2,63,2086,2149,0.0071641,0.0005905,
2,64,2086,2150,0.0078986,0.0006693,
2,0,2087,2087,0.0077995,0.0003415,
2,1,2087,2088,0.0005341,0.0000042,
2,2,2087,2089,0.0002805,0.0000027,
2,3,2087,2090,0.0001960,0.0000024,
2,4,2087,2091,0.0001520,0.0000021,
2,5,2087,2092,0.0001465,0.0000028,
2,6,2087,2093,0.0001399,0.0000034,
2,7,2087,2094,0.0001348,0.0000040,
2,8,2087,2095,0.0001336,0.0000050,
2,9,2087,2096,0.0001377,0.0000066,
2,10,2087,2097,0.0001465,0.0000089,
2,11,2087,2098,0.0001596,0.0000123,
2,12,2087,2099,0.0001783,0.0000169,
2,13,2087,2100,0.0002061,0.0000239,
2,14,2087,2101,0.0002415,0.0000331,
2,15,2087,2102,0.0002756,0.0000415,
2,16,2087,2103,0.0003003,0.0000451,
2,17,2087,2104,0.0003175,0.0000439,
2,18,2087,2105,0.0003342,0.0000422,
2,19,2087,2106,0.0003539,0.0000426,
2,20,2087,2107,0.0003732,0.0000438,
2,21,2087,2108,0.0003859,0.0000428,
2,22,2087,2109,0.0003897,0.0000388,
2,23,2087,2110,0.0003908,0.0000344,
2,24,2087,2111,0.0003983,0.0000326,
2,25,2087,2112,0.0004147,0.0000335,
2,26,2087,2113,0.0004348,0.0000353,
2,27,2087,2114,0.0004528,0.0000359,
2,28,2087,2115,0.0004684,0.0000368,
2,29,2087,2116,0.0004856,0.0000376,
2,30,2087,2117,0.0005091,0.0000391,
2,31,2087,2118,0.0005408,0.0000411,
2,32,2087,2119,0.0005796,0.0000432,
2,33,2087,2120,0.0006220,0.0000446,
2,34,2087,2121,0.0006665,0.0000455,
2,35,2087,2122,0.0007153,0.0000463,
2,36,2087,2123,0.0007710,0.0000491,
2,37,2087,2124,0.0008314,0.0000518,
2,38,2087,2125,0.0008908,0.0000554,
2,39,2087,2126,0.0009481,0.0000605,
2,40,2087,2127,0.0010090,0.0000670,
2,41,2087,2128,0.0010784,0.0000741,
2,42,2087,2129,0.0011559,0.0000813,
2,43,2087,2130,0.0012427,0.0000909,
2,44,2087,2131,0.0013435,0.0001060,
2,45,2087,2132,0.0014588,0.0001239,
2,46,2087,2133,0.0015840,0.0001437,
2,47,2087,2134,0.0017152,0.0001599,
2,48,2087,2135,0.0018531,0.0001743,
2,49,2087,2136,0.0020059,0.0001890,
2,50,2087,2137,0.0021845,0.0002022,
2,51,2087,2138,0.0023896,0.0002135,
2,52,2087,2139,0.0026115,0.0002234,
2,53,2087,2140,0.0028474,0.0002359,
2,54,2087,2141,0.0031082,0.0002580,
2,55,2087,2142,0.0034035,0.0002857,
2,56,2087,2143,0.0037277,0.0003140,
2,57,2087,2144,0.0040692,0.0003338,
2,58,2087,2145,0.0044295,0.0003494,
2,59,2087,2146,0.0048296,0.0003702,
2,60,2087,2147,0.0052973,0.0004035,
2,61,2087,2148,0.0058480,0.0004502,
2,62,2087,2149,0.0064757,0.0005086,
2,63,2087,2150,0.0071641,0.0005793,
2,0,2088,2088,0.0077995,0.0003285,
2,1,2088,2089,0.0005341,0.0000039,
2,2,2088,2090,0.0002805,0.0000026,
2,3,2088,2091,0.0001960,0.0000023,
2,4,2088,2092,0.0001520,0.0000020,
2,5,2088,2093,0.0001465,0.0000026,
2,6,2088,2094,0.0001399,0.0000032,
2,7,2088,2095,0.0001348,0.0000039,
2,8,2088,2096,0.0001336,0.0000048,
2,9,2088,2097,0.0001377,0.0000063,
2,10,2088,2098,0.0001465,0.0000087,
2,11,2088,2099,0.0001596,0.0000119,
2,12,2088,2100,0.0001783,0.0000165,
2,13,2088,2101,0.0002061,0.0000233,
2,14,2088,2102,0.0002415,0.0000324,
2,15,2088,2103,0.0002756,0.0000407,
2,16,2088,2104,0.0003003,0.0000442,
2,17,2088,2105,0.0003175,0.0000429,
2,18,2088,2106,0.0003342,0.0000412,
2,19,2088,2107,0.0003539,0.0000416,
2,20,2088,2108,0.0003732,0.0000429,
2,21,2088,2109,0.0003859,0.0000419,
2,22,2088,2110,0.0003897,0.0000379,
2,23,2088,2111,0.0003908,0.0000335,
2,24,2088,2112,0.0003983,0.0000318,
2,25,2088,2113,0.0004147,0.0000327,
2,26,2088,2114,0.0004348,0.0000344,
2,27,2088,2115,0.0004528,0.0000350,
2,28,2088,2116,0.0004684,0.0000358,
2,29,2088,2117,0.0004856,0.0000367,
2,30,2088,2118,0.0005091,0.0000382,
2,31,2088,2119,0.0005408,0.0000402,
2,32,2088,2120,0.0005796,0.0000421,
2,33,2088,2121,0.0006220,0.0000434,
2,34,2088,2122,0.0006665,0.0000444,
2,35,2088,2123,0.0007153,0.0000452,
2,36,2088,2124,0.0007710,0.0000479,
2,37,2088,2125,0.0008314,0.0000504,
2,38,2088,2126,0.0008908,0.0000539,
2,39,2088,2127,0.0009481,0.0000590,
2,40,2088,2128,0.0010090,0.0000655,
2,41,2088,2129,0.0010784,0.0000724,
2,42,2088,2130,0.0011559,0.0000794,
2,43,2088,2131,0.0012427,0.0000887,
2,44,2088,2132,0.0013435,0.0001037,
2,45,2088,2133,0.0014588,0.0001216,
2,46,2088,2134,0.0015840,0.0001410,
2,47,2088,2135,0.0017152,0.0001566,
2,48,2088,2136,0.0018531,0.0001707,
2,49,2088,2137,0.0020059,0.0001853,
2,50,2088,2138,0.0021845,0.0001986,
2,51,2088,2139,0.0023896,0.0002096,
2,52,2088,2140,0.0026115,0.0002189,
2,53,2088,2141,0.0028474,0.0002310,
2,54,2088,2142,0.0031082,0.0002530,
2,55,2088,2143,0.0034035,0.0002806,
2,56,2088,2144,0.0037277,0.0003083,
2,57,2088,2145,0.0040692,0.0003273,
2,58,2088,2146,0.0044295,0.0003424,
2,59,2088,2147,0.0048296,0.0003632,
2,60,2088,2148,0.0052973,0.0003963,
2,61,2088,2149,0.0058480,0.0004421,
2,62,2088,2150,0.0064757,0.0004988,
2,0,2089,2089,0.0077995,0.0003156,
2,1,2089,2090,0.0005341,0.0000037,
2,2,2089,2091,0.0002805,0.0000024,
2,3,2089,2092,0.0001960,0.0000022,
2,4,2089,2093,0.0001520,0.0000019,
2,5,2089,2094,0.0001465,0.0000025,
2,6,2089,2095,0.0001399,0.0000031,
2,7,2089,2096,0.0001348,0.0000037,
2,8,2089,2097,0.0001336,0.0000046,
2,9,2089,2098,0.0001377,0.0000061,
2,10,2089,2099,0.0001465,0.0000084,
2,11,2089,2100,0.0001596,0.0000116,
2,12,2089,2101,0.0001783,0.0000160,
2,13,2089,2102,0.0002061,0.0000227,
2,14,2089,2103,0.0002415,0.0000317,
2,15,2089,2104,0.0002756,0.0000399,
2,16,2089,2105,0.0003003,0.0000433,
2,17,2089,2106,0.0003175,0.0000419,
2,18,2089,2107,0.0003342,0.0000403,
2,19,2089,2108,0.0003539,0.0000408,
2,20,2089,2109,0.0003732,0.0000420,
2,21,2089,2110,0.0003859,0.0000409,
2,22,2089,2111,0.0003897,0.0000369,
2,23,2089,2112,0.0003908,0.0000327,
2,24,2089,2113,0.0003983,0.0000310,
2,25,2089,2114,0.0004147,0.0000319,
2,26,2089,2115,0.0004348,0.0000336,
2,27,2089,2116,0.0004528,0.0000341,
2,28,2089,2117,0.0004684,0.0000349,
2,29,2089,2118,0.0004856,0.0000358,
2,30,2089,2119,0.0005091,0.0000373,
2,31,2089,2120,0.0005408,0.0000392,
2,32,2089,2121,0.0005796,0.0000410,
2,33,2089,2122,0.0006220,0.0000424,
2,34,2089,2123,0.0006665,0.0000434,
2,35,2089,2124,0.0007153,0.0000441,
2,36,2089,2125,0.0007710,0.0000467,
2,37,2089,2126,0.0008314,0.0000491,
2,38,2089,2127,0.0008908,0.0000526,
2,39,2089,2128,0.0009481,0.0000577,
2,40,2089,2129,0.0010090,0.0000640,
2,41,2089,2130,0.0010784,0.0000707,
2,42,2089,2131,0.0011559,0.0000775,
2,43,2089,2132,0.0012427,0.0000867,
2,44,2089,2133,0.0013435,0.0001017,
2,45,2089,2134,0.0014588,0.0001192,
2,46,2089,2135,0.0015840,0.0001380,
2,47,2089,2136,0.0017152,0.0001534,
2,48,2089,2137,0.0018531,0.0001674,
2,49,2089,2138,0.0020059,0.0001820,
2,50,2089,2139,0.0021845,0.0001950,
2,51,2089,2140,0.0023896,0.0002054,
2,52,2089,2141,0.0026115,0.0002144,
2,53,2089,2142,0.0028474,0.0002264,
2,54,2089,2143,0.0031082,0.0002485,
2,55,2089,2144,0.0034035,0.0002755,
2,56,2089,2145,0.0037277,0.0003023,
2,57,2089,2146,0.0040692,0.0003208,
2,58,2089,2147,0.0044295,0.0003359,
2,59,2089,2148,0.0048296,0.0003567,
2,60,2089,2149,0.0052973,0.0003891,
2,61,2089,2150,0.0058480,0.0004334,
2,0,2090,2090,0.0077995,0.0003021,
2,1,2090,2091,0.0005341,0.0000034,
2,2,2090,2092,0.0002805,0.0000023,
2,3,2090,2093,0.0001960,0.0000021,
2,4,2090,2094,0.0001520,0.0000018,
2,5,2090,2095,0.0001465,0.0000024,
2,6,2090,2096,0.0001399,0.0000029,
2,7,2090,2097,0.0001348,0.0000035,
2,8,2090,2098,0.0001336,0.0000045,
2,9,2090,2099,0.0001377,0.0000059,
2,10,2090,2100,0.0001465,0.0000081,
2,11,2090,2101,0.0001596,0.0000112,
2,12,2090,2102,0.0001783,0.0000156,
2,13,2090,2103,0.0002061,0.0000222,
2,14,2090,2104,0.0002415,0.0000311,
2,15,2090,2105,0.0002756,0.0000391,
2,16,2090,2106,0.0003003,0.0000423,
2,17,2090,2107,0.0003175,0.0000410,
2,18,2090,2108,0.0003342,0.0000395,
2,19,2090,2109,0.0003539,0.0000399,
2,20,2090,2110,0.0003732,0.0000410,
2,21,2090,2111,0.0003859,0.0000399,
2,22,2090,2112,0.0003897,0.0000361,
2,23,2090,2113,0.0003908,0.0000319,
2,24,2090,2114,0.0003983,0.0000303,
2,25,2090,2115,0.0004147,0.0000311,
2,26,2090,2116,0.0004348,0.0000327,
2,27,2090,2117,0.0004528,0.0000333,
2,28,2090,2118,0.0004684,0.0000341,
2,29,2090,2119,0.0004856,0.0000350,
2,30,2090,2120,0.0005091,0.0000364,
2,31,2090,2121,0.0005408,0.0000381,
2,32,2090,2122,0.0005796,0.0000400,
2,33,2090,2123,0.0006220,0.0000414,
2,34,2090,2124,0.0006665,0.0000423,
2,35,2090,2125,0.0007153,0.0000430,
2,36,2090,2126,0.0007710,0.0000454,
2,37,2090,2127,0.0008314,0.0000479,
2,38,2090,2128,0.0008908,0.0000514,
2,39,2090,2129,0.0009481,0.0000563,
2,40,2090,2130,0.0010090,0.0000625,
2,41,2090,2131,0.0010784,0.0000690,
2,42,2090,2132,0.0011559,0.0000757,
2,43,2090,2133,0.0012427,0.0000849,
2,44,2090,2134,0.0013435,0.0000996,
2,45,2090,2135,0.0014588,0.0001166,
2,46,2090,2136,0.0015840,0.0001351,
2,47,2090,2137,0.0017152,0.0001504,
2,48,2090,2138,0.0018531,0.0001644,
2,49,2090,2139,0.0020059,0.0001787,
2,50,2090,2140,0.0021845,0.0001912,
2,51,2090,2141,0.0023896,0.0002012,
2,52,2090,2142,0.0026115,0.0002102,
2,53,2090,2143,0.0028474,0.0002223,
2,54,2090,2144,0.0031082,0.0002440,
2,55,2090,2145,0.0034035,0.0002701,
2,56,2090,2146,0.0037277,0.0002963,
2,57,2090,2147,0.0040692,0.0003147,
2,58,2090,2148,0.0044295,0.0003299,
2,59,2090,2149,0.0048296,0.0003502,
2,60,2090,2150,0.0052973,0.0003814,
2,0,2091,2091,0.0077995,0.0002888,
2,1,2091,2092,0.0005341,0.0000032,
2,2,2091,2093,0.0002805,0.0000021,
2,3,2091,2094,0.0001960,0.0000020,
2,4,2091,2095,0.0001520,0.0000017,
2,5,2091,2096,0.0001465,0.0000023,
2,6,2091,2097,0.0001399,0.0000028,
2,7,2091,2098,0.0001348,0.0000034,
2,8,2091,2099,0.0001336,0.0000043,
2,9,2091,2100,0.0001377,0.0000057,
2,10,2091,2101,0.0001465,0.0000078,
2,11,2091,2102,0.0001596,0.0000109,
2,12,2091,2103,0.0001783,0.0000152,
2,13,2091,2104,0.0002061,0.0000217,
2,14,2091,2105,0.0002415,0.0000304,
2,15,2091,2106,0.0002756,0.0000382,
2,16,2091,2107,0.0003003,0.0000414,
2,17,2091,2108,0.0003175,0.0000402,
2,18,2091,2109,0.0003342,0.0000386,
2,19,2091,2110,0.0003539,0.0000390,
2,20,2091,2111,0.0003732,0.0000400,
2,21,2091,2112,0.0003859,0.0000390,
2,22,2091,2113,0.0003897,0.0000353,
2,23,2091,2114,0.0003908,0.0000312,
2,24,2091,2115,0.0003983,0.0000295,
2,25,2091,2116,0.0004147,0.0000303,
2,26,2091,2117,0.0004348,0.0000319,
2,27,2091,2118,0.0004528,0.0000325,
2,28,2091,2119,0.0004684,0.0000333,
2,29,2091,2120,0.0004856,0.0000341,
2,30,2091,2121,0.0005091,0.0000354,
2,31,2091,2122,0.0005408,0.0000372,
2,32,2091,2123,0.0005796,0.0000391,
2,33,2091,2124,0.0006220,0.0000404,
2,34,2091,2125,0.0006665,0.0000413,
2,35,2091,2126,0.0007153,0.0000418,
2,36,2091,2127,0.0007710,0.0000443,
2,37,2091,2128,0.0008314,0.0000468,
2,38,2091,2129,0.0008908,0.0000501,
2,39,2091,2130,0.0009481,0.0000549,
2,40,2091,2131,0.0010090,0.0000609,
2,41,2091,2132,0.0010784,0.0000674,
2,42,2091,2133,0.0011559,0.0000741,
2,43,2091,2134,0.0012427,0.0000831,
2,44,2091,2135,0.0013435,0.0000974,
2,45,2091,2136,0.0014588,0.0001141,
2,46,2091,2137,0.0015840,0.0001324,
2,47,2091,2138,0.0017152,0.0001476,
2,48,2091,2139,0.0018531,0.0001614,
2,49,2091,2140,0.0020059,0.0001752,
2,50,2091,2141,0.0021845,0.0001873,
2,51,2091,2142,0.0023896,0.0001973,
2,52,2091,2143,0.0026115,0.0002064,
2,53,2091,2144,0.0028474,0.0002182,
2,54,2091,2145,0.0031082,0.0002391,
2,55,2091,2146,0.0034035,0.0002647,
2,56,2091,2147,0.0037277,0.0002907,
2,57,2091,2148,0.0040692,0.0003092,
2,58,2091,2149,0.0044295,0.0003239,
2,59,2091,2150,0.0048296,0.0003432,
2,0,2092,2092,0.0077995,0.0002769,
2,1,2092,2093,0.0005341,0.0000030,
2,2,2092,2094,0.0002805,0.0000020,
2,3,2092,2095,0.0001960,0.0000018,
2,4,2092,2096,0.0001520,0.0000016,
2,5,2092,2097,0.0001465,0.0000021,
2,6,2092,2098,0.0001399,0.0000027,
2,7,2092,2099,0.0001348,0.0000033,
2,8,2092,2100,0.0001336,0.0000041,
2,9,2092,2101,0.0001377,0.0000055,
2,10,2092,2102,0.0001465,0.0000076,
2,11,2092,2103,0.0001596,0.0000106,
2,12,2092,2104,0.0001783,0.0000148,
2,13,2092,2105,0.0002061,0.0000211,
2,14,2092,2106,0.0002415,0.0000296,
2,15,2092,2107,0.0002756,0.0000374,
2,16,2092,2108,0.0003003,0.0000406,
2,17,2092,2109,0.0003175,0.0000394,
2,18,2092,2110,0.0003342,0.0000377,
2,19,2092,2111,0.0003539,0.0000380,
2,20,2092,2112,0.0003732,0.0000391,
2,21,2092,2113,0.0003859,0.0000382,
2,22,2092,2114,0.0003897,0.0000345,
2,23,2092,2115,0.0003908,0.0000304,
2,24,2092,2116,0.0003983,0.0000287,
2,25,2092,2117,0.0004147,0.0000295,
2,26,2092,2118,0.0004348,0.0000311,
2,27,2092,2119,0.0004528,0.0000317,
2,28,2092,2120,0.0004684,0.0000325,
2,29,2092,2121,0.0004856,0.0000332,
2,30,2092,2122,0.0005091,0.0000346,
2,31,2092,2123,0.0005408,0.0000364,
2,32,2092,2124,0.0005796,0.0000382,
2,33,2092,2125,0.0006220,0.0000394,
2,34,2092,2126,0.0006665,0.0000402,
2,35,2092,2127,0.0007153,0.0000408,
2,36,2092,2128,0.0007710,0.0000433,
2,37,2092,2129,0.0008314,0.0000457,
2,38,2092,2130,0.0008908,0.0000489,
2,39,2092,2131,0.0009481,0.0000535,
2,40,2092,2132,0.0010090,0.0000595,
2,41,2092,2133,0.0010784,0.0000659,
2,42,2092,2134,0.0011559,0.0000725,
2,43,2092,2135,0.0012427,0.0000812,
2,44,2092,2136,0.0013435,0.0000952,
2,45,2092,2137,0.0014588,0.0001117,
2,46,2092,2138,0.0015840,0.0001300,
2,47,2092,2139,0.0017152,0.0001449,
2,48,2092,2140,0.0018531,0.0001582,
2,49,2092,2141,0.0020059,0.0001716,
2,50,2092,2142,0.0021845,0.0001837,
2,51,2092,2143,0.0023896,0.0001938,
2,52,2092,2144,0.0026115,0.0002026,
2,53,2092,2145,0.0028474,0.0002138,
2,54,2092,2146,0.0031082,0.0002342,
2,55,2092,2147,0.0034035,0.0002596,
2,56,2092,2148,0.0037277,0.0002856,
2,57,2092,2149,0.0040692,0.0003036,
2,58,2092,2150,0.0044295,0.0003175,
2,0,2093,2093,0.0077995,0.0002663,
2,1,2093,2094,0.0005341,0.0000028,
2,2,2093,2095,0.0002805,0.0000019,
2,3,2093,2096,0.0001960,0.0000017,
2,4,2093,2097,0.0001520,0.0000015,
2,5,2093,2098,0.0001465,0.0000020,
2,6,2093,2099,0.0001399,0.0000025,
2,7,2093,2100,0.0001348,0.0000031,
2,8,2093,2101,0.0001336,0.0000040,
2,9,2093,2102,0.0001377,0.0000053,
2,10,2093,2103,0.0001465,0.0000073,
2,11,2093,2104,0.0001596,0.0000103,
2,12,2093,2105,0.0001783,0.0000144,
2,13,2093,2106,0.0002061,0.0000206,
2,14,2093,2107,0.0002415,0.0000290,
2,15,2093,2108,0.0002756,0.0000367,
2,16,2093,2109,0.0003003,0.0000398,
2,17,2093,2110,0.0003175,0.0000385,
2,18,2093,2111,0.0003342,0.0000368,
2,19,2093,2112,0.0003539,0.0000372,
2,20,2093,2113,0.0003732,0.0000383,
2,21,2093,2114,0.0003859,0.0000373,
2,22,2093,2115,0.0003897,0.0000336,
2,23,2093,2116,0.0003908,0.0000296,
2,24,2093,2117,0.0003983,0.0000280,
2,25,2093,2118,0.0004147,0.0000288,
2,26,2093,2119,0.0004348,0.0000304,
2,27,2093,2120,0.0004528,0.0000309,
2,28,2093,2121,0.0004684,0.0000316,
2,29,2093,2122,0.0004856,0.0000324,
2,30,2093,2123,0.0005091,0.0000338,
2,31,2093,2124,0.0005408,0.0000355,
2,32,2093,2125,0.0005796,0.0000372,
2,33,2093,2126,0.0006220,0.0000384,
2,34,2093,2127,0.0006665,0.0000392,
2,35,2093,2128,0.0007153,0.0000398,
2,36,2093,2129,0.0007710,0.0000422,
2,37,2093,2130,0.0008314,0.0000445,
2,38,2093,2131,0.0008908,0.0000476,
2,39,2093,2132,0.0009481,0.0000522,
2,40,2093,2133,0.0010090,0.0000582,
2,41,2093,2134,0.0010784,0.0000645,
2,42,2093,2135,0.0011559,0.0000708,
2,43,2093,2136,0.0012427,0.0000793,
2,44,2093,2137,0.0013435,0.0000931,
2,45,2093,2138,0.0014588,0.0001096,
2,46,2093,2139,0.0015840,0.0001275,
2,47,2093,2140,0.0017152,0.0001420,
2,48,2093,2141,0.0018531,0.0001549,
2,49,2093,2142,0.0020059,0.0001683,
2,50,2093,2143,0.0021845,0.0001804,
2,51,2093,2144,0.0023896,0.0001903,
2,52,2093,2145,0.0026115,0.0001986,
2,53,2093,2146,0.0028474,0.0002094,
2,54,2093,2147,0.0031082,0.0002297,
2,55,2093,2148,0.0034035,0.0002551,
2,56,2093,2149,0.0037277,0.0002805,
2,57,2093,2150,0.0040692,0.0002976,
2,0,2094,2094,0.0077995,0.0002557,
2,1,2094,2095,0.0005341,0.0000027,
2,2,2094,2096,0.0002805,0.0000018,
2,3,2094,2097,0.0001960,0.0000016,
2,4,2094,2098,0.0001520,0.0000014,
2,5,2094,2099,0.0001465,0.0000019,
2,6,2094,2100,0.0001399,0.0000024,
2,7,2094,2101,0.0001348,0.0000030,
2,8,2094,2102,0.0001336,0.0000038,
2,9,2094,2103,0.0001377,0.0000051,
2,10,2094,2104,0.0001465,0.0000071,
2,11,2094,2105,0.0001596,0.0000099,
2,12,2094,2106,0.0001783,0.0000140,
2,13,2094,2107,0.0002061,0.0000201,
2,14,2094,2108,0.0002415,0.0000284,
2,15,2094,2109,0.0002756,0.0000359,
2,16,2094,2110,0.0003003,0.0000390,
2,17,2094,2111,0.0003175,0.0000376,
2,18,2094,2112,0.0003342,0.0000360,
2,19,2094,2113,0.0003539,0.0000364,
2,20,2094,2114,0.0003732,0.0000375,
2,21,2094,2115,0.0003859,0.0000365,
2,22,2094,2116,0.0003897,0.0000328,
2,23,2094,2117,0.0003908,0.0000289,
2,24,2094,2118,0.0003983,0.0000274,
2,25,2094,2119,0.0004147,0.0000281,
2,26,2094,2120,0.0004348,0.0000296,
2,27,2094,2121,0.0004528,0.0000301,
2,28,2094,2122,0.0004684,0.0000308,
2,29,2094,2123,0.0004856,0.0000316,
2,30,2094,2124,0.0005091,0.0000330,
2,31,2094,2125,0.0005408,0.0000346,
2,32,2094,2126,0.0005796,0.0000363,
2,33,2094,2127,0.0006220,0.0000374,
2,34,2094,2128,0.0006665,0.0000383,
2,35,2094,2129,0.0007153,0.0000389,
2,36,2094,2130,0.0007710,0.0000411,
2,37,2094,2131,0.0008314,0.0000433,
2,38,2094,2132,0.0008908,0.0000464,
2,39,2094,2133,0.0009481,0.0000510,
2,40,2094,2134,0.0010090,0.0000569,
2,41,2094,2135,0.0010784,0.0000629,
2,42,2094,2136,0.0011559,0.0000691,
2,43,2094,2137,0.0012427,0.0000775,
2,44,2094,2138,0.0013435,0.0000913,
2,45,2094,2139,0.0014588,0.0001074,
2,46,2094,2140,0.0015840,0.0001249,
2,47,2094,2141,0.0017152,0.0001390,
2,48,2094,2142,0.0018531,0.0001519,
2,49,2094,2143,0.0020059,0.0001653,
2,50,2094,2144,0.0021845,0.0001772,
2,51,2094,2145,0.0023896,0.0001865,
2,52,2094,2146,0.0026115,0.0001945,
2,53,2094,2147,0.0028474,0.0002054,
2,54,2094,2148,0.0031082,0.0002256,
2,55,2094,2149,0.0034035,0.0002504,
2,56,2094,2150,0.0037277,0.0002750,
2,0,2095,2095,0.0077995,0.0002447,
2,1,2095,2096,0.0005341,0.0000025,
2,2,2095,2097,0.0002805,0.0000017,
2,3,2095,2098,0.0001960,0.0000016,
2,4,2095,2099,0.0001520,0.0000014,
2,5,2095,2100,0.0001465,0.0000019,
2,6,2095,2101,0.0001399,0.0000023,
2,7,2095,2102,0.0001348,0.0000028,
2,8,2095,2103,0.0001336,0.0000037,
2,9,2095,2104,0.0001377,0.0000049,
2,10,2095,2105,0.0001465,0.0000069,
2,11,2095,2106,0.0001596,0.0000096,
2,12,2095,2107,0.0001783,0.0000136,
2,13,2095,2108,0.0002061,0.0000196,
2,14,2095,2109,0.0002415,0.0000278,
2,15,2095,2110,0.0002756,0.0000352,
2,16,2095,2111,0.0003003,0.0000381,
2,17,2095,2112,0.0003175,0.0000368,
2,18,2095,2113,0.0003342,0.0000353,
2,19,2095,2114,0.0003539,0.0000356,
2,20,2095,2115,0.0003732,0.0000366,
2,21,2095,2116,0.0003859,0.0000356,
2,22,2095,2117,0.0003897,0.0000320,
2,23,2095,2118,0.0003908,0.0000282,
2,24,2095,2119,0.0003983,0.0000267,
2,25,2095,2120,0.0004147,0.0000274,
2,26,2095,2121,0.0004348,0.0000288,
2,27,2095,2122,0.0004528,0.0000293,
2,28,2095,2123,0.0004684,0.0000301,
2,29,2095,2124,0.0004856,0.0000309,
2,30,2095,2125,0.0005091,0.0000321,
2,31,2095,2126,0.0005408,0.0000337,
2,32,2095,2127,0.0005796,0.0000354,
2,33,2095,2128,0.0006220,0.0000366,
2,34,2095,2129,0.0006665,0.0000374,
2,35,2095,2130,0.0007153,0.0000379,
2,36,2095,2131,0.0007710,0.0000401,
2,37,2095,2132,0.0008314,0.0000422,
2,38,2095,2133,0.0008908,0.0000454,
2,39,2095,2134,0.0009481,0.0000499,
2,40,2095,2135,0.0010090,0.0000555,
2,41,2095,2136,0.0010784,0.0000614,
2,42,2095,2137,0.0011559,0.0000675,
2,43,2095,2138,0.0012427,0.0000759,
2,44,2095,2139,0.0013435,0.0000894,
2,45,2095,2140,0.0014588,0.0001051,
2,46,2095,2141,0.0015840,0.0001222,
2,47,2095,2142,0.0017152,0.0001363,
2,48,2095,2143,0.0018531,0.0001492,
2,49,2095,2144,0.0020059,0.0001623,
2,50,2095,2145,0.0021845,0.0001737,
2,51,2095,2146,0.0023896,0.0001827,
2,52,2095,2147,0.0026115,0.0001908,
2,53,2095,2148,0.0028474,0.0002017,
2,54,2095,2149,0.0031082,0.0002215,
2,55,2095,2150,0.0034035,0.0002455,
2,0,2096,2096,0.0077995,0.0002339,
2,1,2096,2097,0.0005341,0.0000023,
2,2,2096,2098,0.0002805,0.0000016,
2,3,2096,2099,0.0001960,0.0000015,
2,4,2096,2100,0.0001520,0.0000013,
2,5,2096,2101,0.0001465,0.0000018,
2,6,2096,2102,0.0001399,0.0000022,
2,7,2096,2103,0.0001348,0.0000027,
2,8,2096,2104,0.0001336,0.0000035,
2,9,2096,2105,0.0001377,0.0000048,
2,10,2096,2106,0.0001465,0.0000066,
2,11,2096,2107,0.0001596,0.0000094,
2,12,2096,2108,0.0001783,0.0000132,
2,13,2096,2109,0.0002061,0.0000192,
2,14,2096,2110,0.0002415,0.0000271,
2,15,2096,2111,0.0002756,0.0000344,
2,16,2096,2112,0.0003003,0.0000373,
2,17,2096,2113,0.0003175,0.0000361,
2,18,2096,2114,0.0003342,0.0000345,
2,19,2096,2115,0.0003539,0.0000348,
2,20,2096,2116,0.0003732,0.0000357,
2,21,2096,2117,0.0003859,0.0000348,
2,22,2096,2118,0.0003897,0.0000313,
2,23,2096,2119,0.0003908,0.0000275,
2,24,2096,2120,0.0003983,0.0000260,
2,25,2096,2121,0.0004147,0.0000267,
2,26,2096,2122,0.0004348,0.0000281,
2,27,2096,2123,0.0004528,0.0000287,
2,28,2096,2124,0.0004684,0.0000294,
2,29,2096,2125,0.0004856,0.0000301,
2,30,2096,2126,0.0005091,0.0000313,
2,31,2096,2127,0.0005408,0.0000329,
2,32,2096,2128,0.0005796,0.0000346,
2,33,2096,2129,0.0006220,0.0000357,
2,34,2096,2130,0.0006665,0.0000364,
2,35,2096,2131,0.0007153,0.0000369,
2,36,2096,2132,0.0007710,0.0000391,
2,37,2096,2133,0.0008314,0.0000413,
2,38,2096,2134,0.0008908,0.0000443,
2,39,2096,2135,0.0009481,0.0000486,
2,40,2096,2136,0.0010090,0.0000541,
2,41,2096,2137,0.0010784,0.0000599,
2,42,2096,2138,0.0011559,0.0000661,
2,43,2096,2139,0.0012427,0.0000743,
2,44,2096,2140,0.0013435,0.0000874,
2,45,2096,2141,0.0014588,0.0001028,
2,46,2096,2142,0.0015840,0.0001198,
2,47,2096,2143,0.0017152,0.0001338,
2,48,2096,2144,0.0018531,0.0001465,
2,49,2096,2145,0.0020059,0.0001592,
2,50,2096,2146,0.0021845,0.0001702,
2,51,2096,2147,0.0023896,0.0001792,
2,52,2096,2148,0.0026115,0.0001873,
2,53,2096,2149,0.0028474,0.0001979,
2,54,2096,2150,0.0031082,0.0002170,
2,0,2097,2097,0.0077995,0.0002242,
2,1,2097,2098,0.0005341,0.0000022,
2,2,2097,2099,0.0002805,0.0000015,
2,3,2097,2100,0.0001960,0.0000014,
2,4,2097,2101,0.0001520,0.0000012,
2,5,2097,2102,0.0001465,0.0000017,
2,6,2097,2103,0.0001399,0.0000021,
2,7,2097,2104,0.0001348,0.0000026,
2,8,2097,2105,0.0001336,0.0000034,
2,9,2097,2106,0.0001377,0.0000046,
2,10,2097,2107,0.0001465,0.0000064,
2,11,2097,2108,0.0001596,0.0000091,
2,12,2097,2109,0.0001783,0.0000129,
2,13,2097,2110,0.0002061,0.0000187,
2,14,2097,2111,0.0002415,0.0000265,
2,15,2097,2112,0.0002756,0.0000336,
2,16,2097,2113,0.0003003,0.0000366,
2,17,2097,2114,0.0003175,0.0000353,
2,18,2097,2115,0.0003342,0.0000337,
2,19,2097,2116,0.0003539,0.0000340,
2,20,2097,2117,0.0003732,0.0000349,
2,21,2097,2118,0.0003859,0.0000340,
2,22,2097,2119,0.0003897,0.0000306,
2,23,2097,2120,0.0003908,0.0000268,
2,24,2097,2121,0.0003983,0.0000253,
2,25,2097,2122,0.0004147,0.0000260,
2,26,2097,2123,0.0004348,0.0000275,
2,27,2097,2124,0.0004528,0.0000280,
2,28,2097,2125,0.0004684,0.0000286,
2,29,2097,2126,0.0004856,0.0000293,
2,30,2097,2127,0.0005091,0.0000305,
2,31,2097,2128,0.0005408,0.0000321,
2,32,2097,2129,0.0005796,0.0000338,
2,33,2097,2130,0.0006220,0.0000348,
2,34,2097,2131,0.0006665,0.0000355,
2,35,2097,2132,0.0007153,0.0000360,
2,36,2097,2133,0.0007710,0.0000382,
2,37,2097,2134,0.0008314,0.0000403,
2,38,2097,2135,0.0008908,0.0000432,
2,39,2097,2136,0.0009481,0.0000474,
2,40,2097,2137,0.0010090,0.0000528,
2,41,2097,2138,0.0010784,0.0000586,
2,42,2097,2139,0.0011559,0.0000646,
2,43,2097,2140,0.0012427,0.0000726,
2,44,2097,2141,0.0013435,0.0000854,
2,45,2097,2142,0.0014588,0.0001007,
2,46,2097,2143,0.0015840,0.0001176,
2,47,2097,2144,0.0017152,0.0001313,
2,48,2097,2145,0.0018531,0.0001436,
2,49,2097,2146,0.0020059,0.0001559,
2,50,2097,2147,0.0021845,0.0001670,
2,51,2097,2148,0.0023896,0.0001761,
2,52,2097,2149,0.0026115,0.0001839,
2,53,2097,2150,0.0028474,0.0001939,
2,0,2098,2098,0.0077995,0.0002155,
2,1,2098,2099,0.0005341,0.0000021,
2,2,2098,2100,0.0002805,0.0000014,
2,3,2098,2101,0.0001960,0.0000013,
2,4,2098,2102,0.0001520,0.0000011,
2,5,2098,2103,0.0001465,0.0000016,
2,6,2098,2104,0.0001399,0.0000020,
2,7,2098,2105,0.0001348,0.0000025,
2,8,2098,2106,0.0001336,0.0000032,
2,9,2098,2107,0.0001377,0.0000044,
2,10,2098,2108,0.0001465,0.0000062,
2,11,2098,2109,0.0001596,0.0000088,
2,12,2098,2110,0.0001783,0.0000125,
2,13,2098,2111,0.0002061,0.0000182,
2,14,2098,2112,0.0002415,0.0000259,
2,15,2098,2113,0.0002756,0.0000330,
2,16,2098,2114,0.0003003,0.0000359,
2,17,2098,2115,0.0003175,0.0000346,
2,18,2098,2116,0.0003342,0.0000330,
2,19,2098,2117,0.0003539,0.0000332,
2,20,2098,2118,0.0003732,0.0000342,
2,21,2098,2119,0.0003859,0.0000333,
2,22,2098,2120,0.0003897,0.0000298,
2,23,2098,2121,0.0003908,0.0000261,
2,24,2098,2122,0.0003983,0.0000246,
2,25,2098,2123,0.0004147,0.0000254,
2,26,2098,2124,0.0004348,0.0000268,
2,27,2098,2125,0.0004528,0.0000272,
2,28,2098,2126,0.0004684,0.0000279,
2,29,2098,2127,0.0004856,0.0000286,
2,30,2098,2128,0.0005091,0.0000298,
2,31,2098,2129,0.0005408,0.0000314,
2,32,2098,2130,0.0005796,0.0000329,
2,33,2098,2131,0.0006220,0.0000339,
2,34,2098,2132,0.0006665,0.0000346,
2,35,2098,2133,0.0007153,0.0000351,
2,36,2098,2134,0.0007710,0.0000373,
2,37,2098,2135,0.0008314,0.0000392,
2,38,2098,2136,0.0008908,0.0000420,
2,39,2098,2137,0.0009481,0.0000462,
2,40,2098,2138,0.0010090,0.0000516,
2,41,2098,2139,0.0010784,0.0000574,
2,42,2098,2140,0.0011559,0.0000631,
2,43,2098,2141,0.0012427,0.0000709,
2,44,2098,2142,0.0013435,0.0000836,
2,45,2098,2143,0.0014588,0.0000988,
2,46,2098,2144,0.0015840,0.0001154,
2,47,2098,2145,0.0017152,0.0001287,
2,48,2098,2146,0.0018531,0.0001407,
2,49,2098,2147,0.0020059,0.0001530,
2,50,2098,2148,0.0021845,0.0001640,
2,51,2098,2149,0.0023896,0.0001728,
2,52,2098,2150,0.0026115,0.0001802,
2,0,2099,2099,0.0077995,0.0002070,
2,1,2099,2100,0.0005341,0.0000019,
2,2,2099,2101,0.0002805,0.0000013,
2,3,2099,2102,0.0001960,0.0000012,
2,4,2099,2103,0.0001520,0.0000011,
2,5,2099,2104,0.0001465,0.0000015,
2,6,2099,2105,0.0001399,0.0000019,
2,7,2099,2106,0.0001348,0.0000024,
2,8,2099,2107,0.0001336,0.0000031,
2,9,2099,2108,0.0001377,0.0000043,
2,10,2099,2109,0.0001465,0.0000060,
2,11,2099,2110,0.0001596,0.0000086,
2,12,2099,2111,0.0001783,0.0000122,
2,13,2099,2112,0.0002061,0.0000178,
2,14,2099,2113,0.0002415,0.0000254,
2,15,2099,2114,0.0002756,0.0000323,
2,16,2099,2115,0.0003003,0.0000351,
2,17,2099,2116,0.0003175,0.0000338,
2,18,2099,2117,0.0003342,0.0000322,
2,19,2099,2118,0.0003539,0.0000325,
2,20,2099,2119,0.0003732,0.0000335,
2,21,2099,2120,0.0003859,0.0000325,
2,22,2099,2121,0.0003897,0.0000291,
2,23,2099,2122,0.0003908,0.0000255,
2,24,2099,2123,0.0003983,0.0000241,
2,25,2099,2124,0.0004147,0.0000248,
2,26,2099,2125,0.0004348,0.0000261,
2,27,2099,2126,0.0004528,0.0000265,
2,28,2099,2127,0.0004684,0.0000272,
2,29,2099,2128,0.0004856,0.0000279,
2,30,2099,2129,0.0005091,0.0000291,
2,31,2099,2130,0.0005408,0.0000306,
2,32,2099,2131,0.0005796,0.0000321,
2,33,2099,2132,0.0006220,0.0000331,
2,34,2099,2133,0.0006665,0.0000338,
2,35,2099,2134,0.0007153,0.0000343,
2,36,2099,2135,0.0007710,0.0000363,
2,37,2099,2136,0.0008314,0.0000382,
2,38,2099,2137,0.0008908,0.0000410,
2,39,2099,2138,0.0009481,0.0000452,
2,40,2099,2139,0.0010090,0.0000505,
2,41,2099,2140,0.0010784,0.0000560,
2,42,2099,2141,0.0011559,0.0000616,
2,43,2099,2142,0.0012427,0.0000693,
2,44,2099,2143,0.0013435,0.0000819,
2,45,2099,2144,0.0014588,0.0000968,
2,46,2099,2145,0.0015840,0.0001130,
2,47,2099,2146,0.0017152,0.0001261,
2,48,2099,2147,0.0018531,0.0001380,
2,49,2099,2148,0.0020059,0.0001503,
2,50,2099,2149,0.0021845,0.0001610,
2,51,2099,2150,0.0023896,0.0001694,
2,0,2100,2100,0.0077995,0.0001981,
2,1,2100,2101,0.0005341,0.0000018,
2,2,2100,2102,0.0002805,0.0000012,
2,3,2100,2103,0.0001960,0.0000012,
2,4,2100,2104,0.0001520,0.0000010,
2,5,2100,2105,0.0001465,0.0000014,
2,6,2100,2106,0.0001399,0.0000018,
2,7,2100,2107,0.0001348,0.0000023,
2,8,2100,2108,0.0001336,0.0000030,
2,9,2100,2109,0.0001377,0.0000041,
2,10,2100,2110,0.0001465,0.0000058,
2,11,2100,2111,0.0001596,0.0000083,
2,12,2100,2112,0.0001783,0.0000119,
2,13,2100,2113,0.0002061,0.0000174,
2,14,2100,2114,0.0002415,0.0000248,
2,15,2100,2115,0.0002756,0.0000316,
2,16,2100,2116,0.0003003,0.0000343,
2,17,2100,2117,0.0003175,0.0000331,
2,18,2100,2118,0.0003342,0.0000316,
2,19,2100,2119,0.0003539,0.0000318,
2,20,2100,2120,0.0003732,0.0000327,
2,21,2100,2121,0.0003859,0.0000317,
2,22,2100,2122,0.0003897,0.0000284,
2,23,2100,2123,0.0003908,0.0000249,
2,24,2100,2124,0.0003983,0.0000235,
2,25,2100,2125,0.0004147,0.0000241,
2,26,2100,2126,0.0004348,0.0000254,
2,27,2100,2127,0.0004528,0.0000258,
2,28,2100,2128,0.0004684,0.0000266,
2,29,2100,2129,0.0004856,0.0000273,
2,30,2100,2130,0.0005091,0.0000284,
2,31,2100,2131,0.0005408,0.0000298,
2,32,2100,2132,0.0005796,0.0000313,
2,33,2100,2133,0.0006220,0.0000323,
2,34,2100,2134,0.0006665,0.0000330,
2,35,2100,2135,0.0007153,0.0000334,
2,36,2100,2136,0.0007710,0.0000353,
2,37,2100,2137,0.0008314,0.0000373,
2,38,2100,2138,0.0008908,0.0000400,
2,39,2100,2139,0.0009481,0.0000441,
2,40,2100,2140,0.0010090,0.0000492,
2,41,2100,2141,0.0010784,0.0000546,
2,42,2100,2142,0.0011559,0.0000602,
2,43,2100,2143,0.0012427,0.0000679,
2,44,2100,2144,0.0013435,0.0000803,
2,45,2100,2145,0.0014588,0.0000948,
2,46,2100,2146,0.0015840,0.0001106,
2,47,2100,2147,0.0017152,0.0001236,
2,48,2100,2148,0.0018531,0.0001355,
2,49,2100,2149,0.0020059,0.0001476,
2,50,2100,2150,0.0021845,0.0001579,
2,0,2101,2101,0.0077995,0.0001893,
2,1,2101,2102,0.0005341,0.0000017,
2,2,2101,2103,0.0002805,0.0000012,
2,3,2101,2104,0.0001960,0.0000011,
2,4,2101,2105,0.0001520,0.0000010,
2,5,2101,2106,0.0001465,0.0000014,
2,6,2101,2107,0.0001399,0.0000017,
2,7,2101,2108,0.0001348,0.0000022,
2,8,2101,2109,0.0001336,0.0000029,
2,9,2101,2110,0.0001377,0.0000040,
2,10,2101,2111,0.0001465,0.0000056,
2,11,2101,2112,0.0001596,0.0000081,
2,12,2101,2113,0.0001783,0.0000116,
2,13,2101,2114,0.0002061,0.0000170,
2,14,2101,2115,0.0002415,0.0000243,
2,15,2101,2116,0.0002756,0.0000309,
2,16,2101,2117,0.0003003,0.0000336,
2,17,2101,2118,0.0003175,0.0000324,
2,18,2101,2119,0.0003342,0.0000309,
2,19,2101,2120,0.0003539,0.0000311,
2,20,2101,2121,0.0003732,0.0000319,
2,21,2101,2122,0.0003859,0.0000310,
2,22,2101,2123,0.0003897,0.0000277,
2,23,2101,2124,0.0003908,0.0000243,
2,24,2101,2125,0.0003983,0.0000229,
2,25,2101,2126,0.0004147,0.0000235,
2,26,2101,2127,0.0004348,0.0000248,
2,27,2101,2128,0.0004528,0.0000252,
2,28,2101,2129,0.0004684,0.0000259,
2,29,2101,2130,0.0004856,0.0000266,
2,30,2101,2131,0.0005091,0.0000276,
2,31,2101,2132,0.0005408,0.0000291,
2,32,2101,2133,0.0005796,0.0000306,
2,33,2101,2134,0.0006220,0.0000316,
2,34,2101,2135,0.0006665,0.0000322,
2,35,2101,2136,0.0007153,0.0000325,
2,36,2101,2137,0.0007710,0.0000345,
2,37,2101,2138,0.0008314,0.0000364,
2,38,2101,2139,0.0008908,0.0000391,
2,39,2101,2140,0.0009481,0.0000430,
2,40,2101,2141,0.0010090,0.0000480,
2,41,2101,2142,0.0010784,0.0000533,
2,42,2101,2143,0.0011559,0.0000589,
2,43,2101,2144,0.0012427,0.0000665,
2,44,2101,2145,0.0013435,0.0000785,
2,45,2101,2146,0.0014588,0.0000927,
2,46,2101,2147,0.0015840,0.0001084,
2,47,2101,2148,0.0017152,0.0001214,
2,48,2101,2149,0.0018531,0.0001330,
2,49,2101,2150,0.0020059,0.0001446,
2,0,2102,2102,0.0077995,0.0001814,
2,1,2102,2103,0.0005341,0.0000016,
2,2,2102,2104,0.0002805,0.0000011,
2,3,2102,2105,0.0001960,0.0000010,
2,4,2102,2106,0.0001520,0.0000009,
2,5,2102,2107,0.0001465,0.0000013,
2,6,2102,2108,0.0001399,0.0000017,
2,7,2102,2109,0.0001348,0.0000021,
2,8,2102,2110,0.0001336,0.0000028,
2,9,2102,2111,0.0001377,0.0000038,
2,10,2102,2112,0.0001465,0.0000054,
2,11,2102,2113,0.0001596,0.0000078,
2,12,2102,2114,0.0001783,0.0000113,
2,13,2102,2115,0.0002061,0.0000165,
2,14,2102,2116,0.0002415,0.0000237,
2,15,2102,2117,0.0002756,0.0000303,
2,16,2102,2118,0.0003003,0.0000330,
2,17,2102,2119,0.0003175,0.0000317,
2,18,2102,2120,0.0003342,0.0000302,
2,19,2102,2121,0.0003539,0.0000303,
2,20,2102,2122,0.0003732,0.0000312,
2,21,2102,2123,0.0003859,0.0000303,
2,22,2102,2124,0.0003897,0.0000271,
2,23,2102,2125,0.0003908,0.0000236,
2,24,2102,2126,0.0003983,0.0000222,
2,25,2102,2127,0.0004147,0.0000229,
2,26,2102,2128,0.0004348,0.0000242,
2,27,2102,2129,0.0004528,0.0000246,
2,28,2102,2130,0.0004684,0.0000253,
2,29,2102,2131,0.0004856,0.0000259,
2,30,2102,2132,0.0005091,0.0000270,
2,31,2102,2133,0.0005408,0.0000284,
2,32,2102,2134,0.0005796,0.0000299,
2,33,2102,2135,0.0006220,0.0000308,
2,34,2102,2136,0.0006665,0.0000313,
2,35,2102,2137,0.0007153,0.0000317,
2,36,2102,2138,0.0007710,0.0000337,
2,37,2102,2139,0.0008314,0.0000355,
2,38,2102,2140,0.0008908,0.0000381,
2,39,2102,2141,0.0009481,0.0000419,
2,40,2102,2142,0.0010090,0.0000469,
2,41,2102,2143,0.0010784,0.0000522,
2,42,2102,2144,0.0011559,0.0000576,
2,43,2102,2145,0.0012427,0.0000649,
2,44,2102,2146,0.0013435,0.0000767,
2,45,2102,2147,0.0014588,0.0000908,
2,46,2102,2148,0.0015840,0.0001064,
2,47,2102,2149,0.0017152,0.0001191,
2,48,2102,2150,0.0018531,0.0001304,
2,0,2103,2103,0.0077995,0.0001744,
2,1,2103,2104,0.0005341,0.0000015,
2,2,2103,2105,0.0002805,0.0000010,
2,3,2103,2106,0.0001960,0.0000010,
2,4,2103,2107,0.0001520,0.0000009,
2,5,2103,2108,0.0001465,0.0000012,
2,6,2103,2109,0.0001399,0.0000016,
2,7,2103,2110,0.0001348,0.0000020,
2,8,2103,2111,0.0001336,0.0000027,
2,9,2103,2112,0.0001377,0.0000037,
2,10,2103,2113,0.0001465,0.0000053,
2,11,2103,2114,0.0001596,0.0000076,
2,12,2103,2115,0.0001783,0.0000109,
2,13,2103,2116,0.0002061,0.0000161,
2,14,2103,2117,0.0002415,0.0000232,
2,15,2103,2118,0.0002756,0.0000297,
2,16,2103,2119,0.0003003,0.0000323,
2,17,2103,2120,0.0003175,0.0000310,
2,18,2103,2121,0.0003342,0.0000295,
2,19,2103,2122,0.0003539,0.0000296,
2,20,2103,2123,0.0003732,0.0000305,
2,21,2103,2124,0.0003859,0.0000296,
2,22,2103,2125,0.0003897,0.0000264,
2,23,2103,2126,0.0003908,0.0000230,
2,24,2103,2127,0.0003983,0.0000217,
2,25,2103,2128,0.0004147,0.0000223,
2,26,2103,2129,0.0004348,0.0000236,
2,27,2103,2130,0.0004528,0.0000240,
2,28,2103,2131,0.0004684,0.0000246,
2,29,2103,2132,0.0004856,0.0000252,
2,30,2103,2133,0.0005091,0.0000264,
2,31,2103,2134,0.0005408,0.0000278,
2,32,2103,2135,0.0005796,0.0000291,
2,33,2103,2136,0.0006220,0.0000300,
2,34,2103,2137,0.0006665,0.0000305,
2,35,2103,2138,0.0007153,0.0000310,
2,36,2103,2139,0.0007710,0.0000329,
2,37,2103,2140,0.0008314,0.0000346,
2,38,2103,2141,0.0008908,0.0000371,
2,39,2103,2142,0.0009481,0.0000409,
2,40,2103,2143,0.0010090,0.0000458,
2,41,2103,2144,0.0010784,0.0000510,
2,42,2103,2145,0.0011559,0.0000563,
2,43,2103,2146,0.0012427,0.0000634,
2,44,2103,2147,0.0013435,0.0000751,
2,45,2103,2148,0.0014588,0.0000891,
2,46,2103,2149,0.0015840,0.0001044,
2,47,2103,2150,0.0017152,0.0001167,
2,0,2104,2104,0.0077995,0.0001676,
2,1,2104,2105,0.0005341,0.0000014,
2,2,2104,2106,0.0002805,0.0000010,
2,3,2104,2107,0.0001960,0.0000009,
2,4,2104,2108,0.0001520,0.0000008,
2,5,2104,2109,0.0001465,0.0000012,
2,6,2104,2110,0.0001399,0.0000015,
2,7,2104,2111,0.0001348,0.0000019,
2,8,2104,2112,0.0001336,0.0000026,
2,9,2104,2113,0.0001377,0.0000036,
2,10,2104,2114,0.0001465,0.0000051,
2,11,2104,2115,0.0001596,0.0000074,
2,12,2104,2116,0.0001783,0.0000106,
2,13,2104,2117,0.0002061,0.0000157,
2,14,2104,2118,0.0002415,0.0000227,
2,15,2104,2119,0.0002756,0.0000291,
2,16,2104,2120,0.0003003,0.0000316,
2,17,2104,2121,0.0003175,0.0000303,
2,18,2104,2122,0.0003342,0.0000288,
2,19,2104,2123,0.0003539,0.0000290,
2,20,2104,2124,0.0003732,0.0000299,
2,21,2104,2125,0.0003859,0.0000289,
2,22,2104,2126,0.0003897,0.0000258,
2,23,2104,2127,0.0003908,0.0000224,
2,24,2104,2128,0.0003983,0.0000212,
2,25,2104,2129,0.0004147,0.0000218,
2,26,2104,2130,0.0004348,0.0000230,
2,27,2104,2131,0.0004528,0.0000234,
2,28,2104,2132,0.0004684,0.0000240,
2,29,2104,2133,0.0004856,0.0000247,
2,30,2104,2134,0.0005091,0.0000257,
2,31,2104,2135,0.0005408,0.0000270,
2,32,2104,2136,0.0005796,0.0000283,
2,33,2104,2137,0.0006220,0.0000292,
2,34,2104,2138,0.0006665,0.0000298,
2,35,2104,2139,0.0007153,0.0000302,
2,36,2104,2140,0.0007710,0.0000320,
2,37,2104,2141,0.0008314,0.0000337,
2,38,2104,2142,0.0008908,0.0000362,
2,39,2104,2143,0.0009481,0.0000400,
2,40,2104,2144,0.0010090,0.0000448,
2,41,2104,2145,0.0010784,0.0000498,
2,42,2104,2146,0.0011559,0.0000549,
2,43,2104,2147,0.0012427,0.0000620,
2,44,2104,2148,0.0013435,0.0000736,
2,45,2104,2149,0.0014588,0.0000874,
2,46,2104,2150,0.0015840,0.0001023,
2,0,2105,2105,0.0077995,0.0001605,
2,1,2105,2106,0.0005341,0.0000013,
2,2,2105,2107,0.0002805,0.0000009,
2,3,2105,2108,0.0001960,0.0000009,
2,4,2105,2109,0.0001520,0.0000008,
2,5,2105,2110,0.0001465,0.0000011,
2,6,2105,2111,0.0001399,0.0000015,
2,7,2105,2112,0.0001348,0.0000019,
2,8,2105,2113,0.0001336,0.0000025,
2,9,2105,2114,0.0001377,0.0000034,
2,10,2105,2115,0.0001465,0.0000049,
2,11,2105,2116,0.0001596,0.0000071,
2,12,2105,2117,0.0001783,0.0000103,
2,13,2105,2118,0.0002061,0.0000154,
2,14,2105,2119,0.0002415,0.0000222,
2,15,2105,2120,0.0002756,0.0000285,
2,16,2105,2121,0.0003003,0.0000309,
2,17,2105,2122,0.0003175,0.0000296,
2,18,2105,2123,0.0003342,0.0000282,
2,19,2105,2124,0.0003539,0.0000284,
2,20,2105,2125,0.0003732,0.0000292,
2,21,2105,2126,0.0003859,0.0000282,
2,22,2105,2127,0.0003897,0.0000251,
2,23,2105,2128,0.0003908,0.0000219,
2,24,2105,2129,0.0003983,0.0000206,
2,25,2105,2130,0.0004147,0.0000212,
2,26,2105,2131,0.0004348,0.0000224,
2,27,2105,2132,0.0004528,0.0000228,
2,28,2105,2133,0.0004684,0.0000234,
2,29,2105,2134,0.0004856,0.0000241,
2,30,2105,2135,0.0005091,0.0000251,
2,31,2105,2136,0.0005408,0.0000263,
2,32,2105,2137,0.0005796,0.0000277,
2,33,2105,2138,0.0006220,0.0000286,
2,34,2105,2139,0.0006665,0.0000291,
2,35,2105,2140,0.0007153,0.0000295,
2,36,2105,2141,0.0007710,0.0000312,
2,37,2105,2142,0.0008314,0.0000329,
2,38,2105,2143,0.0008908,0.0000354,
2,39,2105,2144,0.0009481,0.0000391,
2,40,2105,2145,0.0010090,0.0000437,
2,41,2105,2146,0.0010784,0.0000486,
2,42,2105,2147,0.0011559,0.0000537,
2,43,2105,2148,0.0012427,0.0000607,
2,44,2105,2149,0.0013435,0.0000721,
2,45,2105,2150,0.0014588,0.0000855,
2,0,2106,2106,0.0077994,0.0001535,
2,1,2106,2107,0.0005341,0.0000012,
2,2,2106,2108,0.0002805,0.0000009,
2,3,2106,2109,0.0001960,0.0000008,
2,4,2106,2110,0.0001520,0.0000007,
2,5,2106,2111,0.0001465,0.0000011,
2,6,2106,2112,0.0001399,0.0000014,
2,7,2106,2113,0.0001348,0.0000018,
2,8,2106,2114,0.0001336,0.0000024,
2,9,2106,2115,0.0001377,0.0000033,
2,10,2106,2116,0.0001465,0.0000048,
2,11,2106,2117,0.0001596,0.0000069,
2,12,2106,2118,0.0001783,0.0000101,
2,13,2106,2119,0.0002061,0.0000150,
2,14,2106,2120,0.0002415,0.0000217,
2,15,2106,2121,0.0002756,0.0000278,
2,16,2106,2122,0.0003003,0.0000303,
2,17,2106,2123,0.0003175,0.0000290,
2,18,2106,2124,0.0003342,0.0000276,
2,19,2106,2125,0.0003539,0.0000277,
2,20,2106,2126,0.0003732,0.0000284,
2,21,2106,2127,0.0003859,0.0000276,
2,22,2106,2128,0.0003897,0.0000246,
2,23,2106,2129,0.0003908,0.0000214,
2,24,2106,2130,0.0003983,0.0000201,
2,25,2106,2131,0.0004147,0.0000207,
2,26,2106,2132,0.0004348,0.0000218,
2,27,2106,2133,0.0004528,0.0000223,
2,28,2106,2134,0.0004684,0.0000229,
2,29,2106,2135,0.0004856,0.0000235,
2,30,2106,2136,0.0005091,0.0000244,
2,31,2106,2137,0.0005408,0.0000257,
2,32,2106,2138,0.0005796,0.0000270,
2,33,2106,2139,0.0006220,0.0000279,
2,34,2106,2140,0.0006665,0.0000284,
2,35,2106,2141,0.0007153,0.0000287,
2,36,2106,2142,0.0007710,0.0000304,
2,37,2106,2143,0.0008314,0.0000321,
2,38,2106,2144,0.0008908,0.0000345,
2,39,2106,2145,0.0009481,0.0000381,
2,40,2106,2146,0.0010090,0.0000426,
2,41,2106,2147,0.0010784,0.0000475,
2,42,2106,2148,0.0011559,0.0000526,
2,43,2106,2149,0.0012427,0.0000595,
2,44,2106,2150,0.0013435,0.0000705,
2,0,2107,2107,0.0077994,0.0001472,
2,1,2107,2108,0.0005341,0.0000012,
2,2,2107,2109,0.0002805,0.0000008,
2,3,2107,2110,0.0001960,0.0000008,
2,4,2107,2111,0.0001520,0.0000007,
2,5,2107,2112,0.0001465,0.0000010,
2,6,2107,2113,0.0001399,0.0000013,
2,7,2107,2114,0.0001348,0.0000017,
2,8,2107,2115,0.0001336,0.0000023,
2,9,2107,2116,0.0001377,0.0000032,
2,10,2107,2117,0.0001465,0.0000046,
2,11,2107,2118,0.0001596,0.0000067,
2,12,2107,2119,0.0001783,0.0000098,
2,13,2107,2120,0.0002061,0.0000146,
2,14,2107,2121,0.0002415,0.0000212,
2,15,2107,2122,0.0002756,0.0000272,
2,16,2107,2123,0.0003003,0.0000297,
2,17,2107,2124,0.0003175,0.0000284,
2,18,2107,2125,0.0003342,0.0000269,
2,19,2107,2126,0.0003539,0.0000271,
2,20,2107,2127,0.0003732,0.0000278,
2,21,2107,2128,0.0003859,0.0000270,
2,22,2107,2129,0.0003897,0.0000240,
2,23,2107,2130,0.0003908,0.0000208,
2,24,2107,2131,0.0003983,0.0000196,
2,25,2107,2132,0.0004147,0.0000201,
2,26,2107,2133,0.0004348,0.0000213,
2,27,2107,2134,0.0004528,0.0000217,
2,28,2107,2135,0.0004684,0.0000223,
2,29,2107,2136,0.0004856,0.0000228,
2,30,2107,2137,0.0005091,0.0000238,
2,31,2107,2138,0.0005408,0.0000251,
2,32,2107,2139,0.0005796,0.0000264,
2,33,2107,2140,0.0006220,0.0000272,
2,34,2107,2141,0.0006665,0.0000276,
2,35,2107,2142,0.0007153,0.0000280,
2,36,2107,2143,0.0007710,0.0000297,
2,37,2107,2144,0.0008314,0.0000313,
2,38,2107,2145,0.0008908,0.0000337,
2,39,2107,2146,0.0009481,0.0000371,
2,40,2107,2147,0.0010090,0.0000416,
2,41,2107,2148,0.0010784,0.0000465,
2,42,2107,2149,0.0011559,0.0000514,
2,43,2107,2150,0.0012427,0.0000581,
2,0,2108,2108,0.0077994,0.0001416,
2,1,2108,2109,0.0005341,0.0000011,
2,2,2108,2110,0.0002805,0.0000008,
2,3,2108,2111,0.0001960,0.0000007,
2,4,2108,2112,0.0001520,0.0000007,
2,5,2108,2113,0.0001465,0.0000010,
2,6,2108,2114,0.0001399,0.0000013,
2,7,2108,2115,0.0001348,0.0000016,
2,8,2108,2116,0.0001336,0.0000022,
2,9,2108,2117,0.0001377,0.0000031,
2,10,2108,2118,0.0001465,0.0000045,
2,11,2108,2119,0.0001596,0.0000066,
2,12,2108,2120,0.0001783,0.0000096,
2,13,2108,2121,0.0002061,0.0000142,
2,14,2108,2122,0.0002415,0.0000207,
2,15,2108,2123,0.0002756,0.0000267,
2,16,2108,2124,0.0003003,0.0000291,
2,17,2108,2125,0.0003175,0.0000278,
2,18,2108,2126,0.0003342,0.0000263,
2,19,2108,2127,0.0003539,0.0000264,
2,20,2108,2128,0.0003732,0.0000272,
2,21,2108,2129,0.0003859,0.0000264,
2,22,2108,2130,0.0003897,0.0000234,
2,23,2108,2131,0.0003908,0.0000203,
2,24,2108,2132,0.0003983,0.0000191,
2,25,2108,2133,0.0004147,0.0000197,
2,26,2108,2134,0.0004348,0.0000208,
2,27,2108,2135,0.0004528,0.0000212,
2,28,2108,2136,0.0004684,0.0000217,
2,29,2108,2137,0.0004856,0.0000223,
2,30,2108,2138,0.0005091,0.0000233,
2,31,2108,2139,0.0005408,0.0000245,
2,32,2108,2140,0.0005796,0.0000257,
2,33,2108,2141,0.0006220,0.0000265,
2,34,2108,2142,0.0006665,0.0000270,
2,35,2108,2143,0.0007153,0.0000273,
2,36,2108,2144,0.0007710,0.0000290,
2,37,2108,2145,0.0008314,0.0000305,
2,38,2108,2146,0.0008908,0.0000328,
2,39,2108,2147,0.0009481,0.0000362,
2,40,2108,2148,0.0010090,0.0000407,
2,41,2108,2149,0.0010784,0.0000455,
2,42,2108,2150,0.0011559,0.0000502,
2,0,2109,2109,0.0077994,0.0001360,
2,1,2109,2110,0.0005341,0.0000010,
2,2,2109,2111,0.0002805,0.0000007,
2,3,2109,2112,0.0001960,0.0000007,
2,4,2109,2113,0.0001520,0.0000006,
2,5,2109,2114,0.0001465,0.0000009,
2,6,2109,2115,0.0001399,0.0000012,
2,7,2109,2116,0.0001348,0.0000016,
2,8,2109,2117,0.0001336,0.0000021,
2,9,2109,2118,0.0001377,0.0000030,
2,10,2109,2119,0.0001465,0.0000043,
2,11,2109,2120,0.0001596,0.0000063,
2,12,2109,2121,0.0001783,0.0000093,
2,13,2109,2122,0.0002061,0.0000139,
2,14,2109,2123,0.0002415,0.0000203,
2,15,2109,2124,0.0002756,0.0000262,
2,16,2109,2125,0.0003003,0.0000284,
2,17,2109,2126,0.0003175,0.0000272,
2,18,2109,2127,0.0003342,0.0000257,
2,19,2109,2128,0.0003539,0.0000259,
2,20,2109,2129,0.0003732,0.0000266,
2,21,2109,2130,0.0003859,0.0000257,
2,22,2109,2131,0.0003897,0.0000228,
2,23,2109,2132,0.0003908,0.0000198,
2,24,2109,2133,0.0003983,0.0000186,
2,25,2109,2134,0.0004147,0.0000192,
2,26,2109,2135,0.0004348,0.0000203,
2,27,2109,2136,0.0004528,0.0000206,
2,28,2109,2137,0.0004684,0.0000212,
2,29,2109,2138,0.0004856,0.0000218,
2,30,2109,2139,0.0005091,0.0000227,
2,31,2109,2140,0.0005408,0.0000239,
2,32,2109,2141,0.0005796,0.0000251,
2,33,2109,2142,0.0006220,0.0000258,
2,34,2109,2143,0.0006665,0.0000263,
2,35,2109,2144,0.0007153,0.0000267,
2,36,2109,2145,0.0007710,0.0000282,
2,37,2109,2146,0.0008314,0.0000297,
2,38,2109,2147,0.0008908,0.0000320,
2,39,2109,2148,0.0009481,0.0000354,
2,40,2109,2149,0.0010090,0.0000398,
2,41,2109,2150,0.0010784,0.0000444,
2,0,2110,2110,0.0077994,0.0001302,
2,1,2110,2111,0.0005341,0.0000009,
2,2,2110,2112,0.0002805,0.0000007,
2,3,2110,2113,0.0001960,0.0000007,
2,4,2110,2114,0.0001520,0.0000006,
2,5,2110,2115,0.0001465,0.0000009,
2,6,2110,2116,0.0001399,0.0000012,
2,7,2110,2117,0.0001348,0.0000015,
2,8,2110,2118,0.0001336,0.0000020,
2,9,2110,2119,0.0001377,0.0000029,
2,10,2110,2120,0.0001465,0.0000042,
2,11,2110,2121,0.0001596,0.0000061,
2,12,2110,2122,0.0001783,0.0000090,
2,13,2110,2123,0.0002061,0.0000136,
2,14,2110,2124,0.0002415,0.0000198,
2,15,2110,2125,0.0002756,0.0000256,
2,16,2110,2126,0.0003003,0.0000278,
2,17,2110,2127,0.0003175,0.0000266,
2,18,2110,2128,0.0003342,0.0000252,
2,19,2110,2129,0.0003539,0.0000253,
2,20,2110,2130,0.0003732,0.0000260,
2,21,2110,2131,0.0003859,0.0000251,
2,22,2110,2132,0.0003897,0.0000223,
2,23,2110,2133,0.0003908,0.0000193,
2,24,2110,2134,0.0003983,0.0000182,
2,25,2110,2135,0.0004147,0.0000187,
2,26,2110,2136,0.0004348,0.0000197,
2,27,2110,2137,0.0004528,0.0000201,
2,28,2110,2138,0.0004684,0.0000207,
2,29,2110,2139,0.0004856,0.0000213,
2,30,2110,2140,0.0005091,0.0000222,
2,31,2110,2141,0.0005408,0.0000233,
2,32,2110,2142,0.0005796,0.0000245,
2,33,2110,2143,0.0006220,0.0000253,
2,34,2110,2144,0.0006665,0.0000257,
2,35,2110,2145,0.0007153,0.0000260,
2,36,2110,2146,0.0007710,0.0000275,
2,37,2110,2147,0.0008314,0.0000290,
2,38,2110,2148,0.0008908,0.0000313,
2,39,2110,2149,0.0009481,0.0000346,
2,40,2110,2150,0.0010090,0.0000388,
2,0,2111,2111,0.0077994,0.0001245,
2,1,2111,2112,0.0005341,0.0000009,
2,2,2111,2113,0.0002805,0.0000006,
2,3,2111,2114,0.0001960,0.0000006,
2,4,2111,2115,0.0001520,0.0000006,
2,5,2111,2116,0.0001465,0.0000008,
2,6,2111,2117,0.0001399,0.0000011,
2,7,2111,2118,0.0001348,0.0000014,
2,8,2111,2119,0.0001336,0.0000019,
2,9,2111,2120,0.0001377,0.0000028,
2,10,2111,2121,0.0001465,0.0000040,
2,11,2111,2122,0.0001596,0.0000060,
2,12,2111,2123,0.0001783,0.0000088,
2,13,2111,2124,0.0002061,0.0000132,
2,14,2111,2125,0.0002415,0.0000194,
2,15,2111,2126,0.0002756,0.0000250,
2,16,2111,2127,0.0003003,0.0000272,
2,17,2111,2128,0.0003175,0.0000260,
2,18,2111,2129,0.0003342,0.0000246,
2,19,2111,2130,0.0003539,0.0000247,
2,20,2111,2131,0.0003732,0.0000254,
2,21,2111,2132,0.0003859,0.0000245,
2,22,2111,2133,0.0003897,0.0000218,
2,23,2111,2134,0.0003908,0.0000189,
2,24,2111,2135,0.0003983,0.0000177,
2,25,2111,2136,0.0004147,0.0000182,
2,26,2111,2137,0.0004348,0.0000193,
2,27,2111,2138,0.0004528,0.0000196,
2,28,2111,2139,0.0004684,0.0000202,
2,29,2111,2140,0.0004856,0.0000207,
2,30,2111,2141,0.0005091,0.0000216,
2,31,2111,2142,0.0005408,0.0000227,
2,32,2111,2143,0.0005796,0.0000239,
2,33,2111,2144,0.0006220,0.0000247,
2,34,2111,2145,0.0006665,0.0000251,
2,35,2111,2146,0.0007153,0.0000253,
2,36,2111,2147,0.0007710,0.0000268,
2,37,2111,2148,0.0008314,0.0000283,
2,38,2111,2149,0.0008908,0.0000305,
2,39,2111,2150,0.0009481,0.0000337,
2,0,2112,2112,0.0077994,0.0001193,
2,1,2112,2113,0.0005341,0.0000008,
2,2,2112,2114,0.0002805,0.0000006,
2,3,2112,2115,0.0001960,0.0000006,
2,4,2112,2116,0.0001520,0.0000005,
2,5,2112,2117,0.0001465,0.0000008,
2,6,2112,2118,0.0001399,0.0000011,
2,7,2112,2119,0.0001348,0.0000014,
2,8,2112,2120,0.0001336,0.0000019,
2,9,2112,2121,0.0001377,0.0000027,
2,10,2112,2122,0.0001465,0.0000039,
2,11,2112,2123,0.0001596,0.0000058,
2,12,2112,2124,0.0001783,0.0000086,
2,13,2112,2125,0.0002061,0.0000129,
2,14,2112,2126,0.0002415,0.0000189,
2,15,2112,2127,0.0002756,0.0000245,
2,16,2112,2128,0.0003003,0.0000267,
2,17,2112,2129,0.0003175,0.0000255,
2,18,2112,2130,0.0003342,0.0000241,
2,19,2112,2131,0.0003539,0.0000241,
2,20,2112,2132,0.0003732,0.0000248,
2,21,2112,2133,0.0003859,0.0000240,
2,22,2112,2134,0.0003897,0.0000213,
2,23,2112,2135,0.0003908,0.0000184,
2,24,2112,2136,0.0003983,0.0000172,
2,25,2112,2137,0.0004147,0.0000177,
2,26,2112,2138,0.0004348,0.0000188,
2,27,2112,2139,0.0004528,0.0000192,
2,28,2112,2140,0.0004684,0.0000197,
2,29,2112,2141,0.0004856,0.0000202,
2,30,2112,2142,0.0005091,0.0000211,
2,31,2112,2143,0.0005408,0.0000222,
2,32,2112,2144,0.0005796,0.0000234,
2,33,2112,2145,0.0006220,0.0000240,
2,34,2112,2146,0.0006665,0.0000244,
2,35,2112,2147,0.0007153,0.0000247,
2,36,2112,2148,0.0007710,0.0000262,
2,37,2112,2149,0.0008314,0.0000277,
2,38,2112,2150,0.0008908,0.0000297,
2,0,2113,2113,0.0077994,0.0001147,
2,1,2113,2114,0.0005341,0.0000008,
2,2,2113,2115,0.0002805,0.0000006,
2,3,2113,2116,0.0001960,0.0000006,
2,4,2113,2117,0.0001520,0.0000005,
2,5,2113,2118,0.0001465,0.0000008,
2,6,2113,2119,0.0001399,0.0000010,
2,7,2113,2120,0.0001348,0.0000013,
2,8,2113,2121,0.0001336,0.0000018,
2,9,2113,2122,0.0001377,0.0000026,
2,10,2113,2123,0.0001465,0.0000038,
2,11,2113,2124,0.0001596,0.0000056,
2,12,2113,2125,0.0001783,0.0000083,
2,13,2113,2126,0.0002061,0.0000126,
2,14,2113,2127,0.0002415,0.0000185,
2,15,2113,2128,0.0002756,0.0000240,
2,16,2113,2129,0.0003003,0.0000261,
2,17,2113,2130,0.0003175,0.0000249,
2,18,2113,2131,0.0003342,0.0000235,
2,19,2113,2132,0.0003539,0.0000236,
2,20,2113,2133,0.0003732,0.0000243,
2,21,2113,2134,0.0003859,0.0000235,
2,22,2113,2135,0.0003897,0.0000208,
2,23,2113,2136,0.0003908,0.0000179,
2,24,2113,2137,0.0003983,0.0000168,
2,25,2113,2138,0.0004147,0.0000173,
2,26,2113,2139,0.0004348,0.0000184,
2,27,2113,2140,0.0004528,0.0000187,
2,28,2113,2141,0.0004684,0.0000192,
2,29,2113,2142,0.0004856,0.0000197,
2,30,2113,2143,0.0005091,0.0000206,
2,31,2113,2144,0.0005408,0.0000217,
2,32,2113,2145,0.0005796,0.0000228,
2,33,2113,2146,0.0006220,0.0000234,
2,34,2113,2147,0.0006665,0.0000238,
2,35,2113,2148,0.0007153,0.0000241,
2,36,2113,2149,0.0007710,0.0000256,
2,37,2113,2150,0.0008314,0.0000270,
2,0,2114,2114,0.0077994,0.0001102,
2,1,2114,2115,0.0005341,0.0000007,
2,2,2114,2116,0.0002805,0.0000005,
2,3,2114,2117,0.0001960,0.0000005,
2,4,2114,2118,0.0001520,0.0000005,
2,5,2114,2119,0.0001465,0.0000007,
2,6,2114,2120,0.0001399,0.0000010,
2,7,2114,2121,0.0001348,0.0000013,
2,8,2114,2122,0.0001336,0.0000017,
2,9,2114,2123,0.0001377,0.0000025,
2,10,2114,2124,0.0001465,0.0000037,
2,11,2114,2125,0.0001596,0.0000055,
2,12,2114,2126,0.0001783,0.0000081,
2,13,2114,2127,0.0002061,0.0000123,
2,14,2114,2128,0.0002415,0.0000181,
2,15,2114,2129,0.0002756,0.0000235,
2,16,2114,2130,0.0003003,0.0000256,
2,17,2114,2131,0.0003175,0.0000243,
2,18,2114,2132,0.0003342,0.0000230,
2,19,2114,2133,0.0003539,0.0000231,
2,20,2114,2134,0.0003732,0.0000238,
2,21,2114,2135,0.0003859,0.0000229,
2,22,2114,2136,0.0003897,0.0000202,
2,23,2114,2137,0.0003908,0.0000175,
2,24,2114,2138,0.0003983,0.0000164,
2,25,2114,2139,0.0004147,0.0000169,
2,26,2114,2140,0.0004348,0.0000179,
2,27,2114,2141,0.0004528,0.0000182,
2,28,2114,2142,0.0004684,0.0000187,
2,29,2114,2143,0.0004856,0.0000192,
2,30,2114,2144,0.0005091,0.0000201,
2,31,2114,2145,0.0005408,0.0000212,
2,32,2114,2146,0.0005796,0.0000222,
2,33,2114,2147,0.0006220,0.0000229,
2,34,2114,2148,0.0006665,0.0000233,
2,35,2114,2149,0.0007153,0.0000235,
2,36,2114,2150,0.0007710,0.0000249,
2,0,2115,2115,0.0077994,0.0001055,
2,1,2115,2116,0.0005341,0.0000007,
2,2,2115,2117,0.0002805,0.0000005,
2,3,2115,2118,0.0001960,0.0000005,
2,4,2115,2119,0.0001520,0.0000005,
2,5,2115,2120,0.0001465,0.0000007,
2,6,2115,2121,0.0001399,0.0000009,
2,7,2115,2122,0.0001348,0.0000012,
2,8,2115,2123,0.0001336,0.0000017,
2,9,2115,2124,0.0001377,0.0000024,
2,10,2115,2125,0.0001465,0.0000035,
2,11,2115,2126,0.0001596,0.0000053,
2,12,2115,2127,0.0001783,0.0000079,
2,13,2115,2128,0.0002061,0.0000120,
2,14,2115,2129,0.0002415,0.0000177,
2,15,2115,2130,0.0002756,0.0000230,
2,16,2115,2131,0.0003003,0.0000250,
2,17,2115,2132,0.0003175,0.0000238,
2,18,2115,2133,0.0003342,0.0000225,
2,19,2115,2134,0.0003539,0.0000226,
2,20,2115,2135,0.0003732,0.0000232,
2,21,2115,2136,0.0003859,0.0000224,
2,22,2115,2137,0.0003897,0.0000198,
2,23,2115,2138,0.0003908,0.0000170,
2,24,2115,2139,0.0003983,0.0000160,
2,25,2115,2140,0.0004147,0.0000165,
2,26,2115,2141,0.0004348,0.0000174,
2,27,2115,2142,0.0004528,0.0000177,
2,28,2115,2143,0.0004684,0.0000182,
2,29,2115,2144,0.0004856,0.0000188,
2,30,2115,2145,0.0005091,0.0000196,
2,31,2115,2146,0.0005408,0.0000206,
2,32,2115,2147,0.0005796,0.0000216,
2,33,2115,2148,0.0006220,0.0000223,
2,34,2115,2149,0.0006665,0.0000227,
2,35,2115,2150,0.0007153,0.0000229,
2,0,2116,2116,0.0077994,0.0001009,
2,1,2116,2117,0.0005341,0.0000006,
2,2,2116,2118,0.0002805,0.0000005,
2,3,2116,2119,0.0001960,0.0000005,
2,4,2116,2120,0.0001520,0.0000004,
2,5,2116,2121,0.0001465,0.0000006,
2,6,2116,2122,0.0001399,0.0000009,
2,7,2116,2123,0.0001348,0.0000012,
2,8,2116,2124,0.0001336,0.0000016,
2,9,2116,2125,0.0001377,0.0000023,
2,10,2116,2126,0.0001465,0.0000034,
2,11,2116,2127,0.0001596,0.0000051,
2,12,2116,2128,0.0001783,0.0000077,
2,13,2116,2129,0.0002061,0.0000117,
2,14,2116,2130,0.0002415,0.0000173,
2,15,2116,2131,0.0002756,0.0000225,
2,16,2116,2132,0.0003003,0.0000245,
2,17,2116,2133,0.0003175,0.0000233,
2,18,2116,2134,0.0003342,0.0000220,
2,19,2116,2135,0.0003539,0.0000221,
2,20,2116,2136,0.0003732,0.0000226,
2,21,2116,2137,0.0003859,0.0000219,
2,22,2116,2138,0.0003897,0.0000193,
2,23,2116,2139,0.0003908,0.0000166,
2,24,2116,2140,0.0003983,0.0000156,
2,25,2116,2141,0.0004147,0.0000160,
2,26,2116,2142,0.0004348,0.0000170,
2,27,2116,2143,0.0004528,0.0000173,
2,28,2116,2144,0.0004684,0.0000178,
2,29,2116,2145,0.0004856,0.0000183,
2,30,2116,2146,0.0005091,0.0000191,
2,31,2116,2147,0.0005408,0.0000201,
2,32,2116,2148,0.0005796,0.0000212,
2,33,2116,2149,0.0006220,0.0000218,
2,34,2116,2150,0.0006665,0.0000222,
2,0,2117,2117,0.0077994,0.0000967,
2,1,2117,2118,0.0005341,0.0000006,
2,2,2117,2119,0.0002805,0.0000004,
2,3,2117,2120,0.0001960,0.0000004,
2,4,2117,2121,0.0001520,0.0000004,
2,5,2117,2122,0.0001465,0.0000006,
2,6,2117,2123,0.0001399,0.0000008,
2,7,2117,2124,0.0001348,0.0000011,
2,8,2117,2125,0.0001336,0.0000015,
2,9,2117,2126,0.0001377,0.0000022,
2,10,2117,2127,0.0001465,0.0000033,
2,11,2117,2128,0.0001596,0.0000050,
2,12,2117,2129,0.0001783,0.0000075,
2,13,2117,2130,0.0002061,0.0000114,
2,14,2117,2131,0.0002415,0.0000169,
2,15,2117,2132,0.0002756,0.0000220,
2,16,2117,2133,0.0003003,0.0000240,
2,17,2117,2134,0.0003175,0.0000229,
2,18,2117,2135,0.0003342,0.0000215,
2,19,2117,2136,0.0003539,0.0000215,
2,20,2117,2137,0.0003732,0.0000221,
2,21,2117,2138,0.0003859,0.0000214,
2,22,2117,2139,0.0003897,0.0000189,
2,23,2117,2140,0.0003908,0.0000162,
2,24,2117,2141,0.0003983,0.0000151,
2,25,2117,2142,0.0004147,0.0000156,
2,26,2117,2143,0.0004348,0.0000166,
2,27,2117,2144,0.0004528,0.0000169,
2,28,2117,2145,0.0004684,0.0000174,
2,29,2117,2146,0.0004856,0.0000178,
2,30,2117,2147,0.0005091,0.0000186,
2,31,2117,2148,0.0005408,0.0000197,
2,32,2117,2149,0.0005796,0.0000207,
2,33,2117,2150,0.0006220,0.0000213,
2,0,2118,2118,0.0077994,0.0000930,
2,1,2118,2119,0.0005341,0.0000006,
2,2,2118,2120,0.0002805,0.0000004,
2,3,2118,2121,0.0001960,0.0000004,
2,4,2118,2122,0.0001520,0.0000004,
2,5,2118,2123,0.0001465,0.0000006,
2,6,2118,2124,0.0001399,0.0000008,
2,7,2118,2125,0.0001348,0.0000011,
2,8,2118,2126,0.0001336,0.0000015,
2,9,2118,2127,0.0001377,0.0000021,
2,10,2118,2128,0.0001465,0.0000032,
2,11,2118,2129,0.0001596,0.0000048,
2,12,2118,2130,0.0001783,0.0000073,
2,13,2118,2131,0.0002061,0.0000111,
2,14,2118,2132,0.0002415,0.0000165,
2,15,2118,2133,0.0002756,0.0000216,
2,16,2118,2134,0.0003003,0.0000235,
2,17,2118,2135,0.0003175,0.0000223,
2,18,2118,2136,0.0003342,0.0000210,
2,19,2118,2137,0.0003539,0.0000210,
2,20,2118,2138,0.0003732,0.0000217,
2,21,2118,2139,0.0003859,0.0000209,
2,22,2118,2140,0.0003897,0.0000184,
2,23,2118,2141,0.0003908,0.0000158,
2,24,2118,2142,0.0003983,0.0000148,
2,25,2118,2143,0.0004147,0.0000152,
2,26,2118,2144,0.0004348,0.0000162,
2,27,2118,2145,0.0004528,0.0000165,
2,28,2118,2146,0.0004684,0.0000169,
2,29,2118,2147,0.0004856,0.0000174,
2,30,2118,2148,0.0005091,0.0000182,
2,31,2118,2149,0.0005408,0.0000192,
2,32,2118,2150,0.0005796,0.0000202,
2,0,2119,2119,0.0077994,0.0000893,
2,1,2119,2120,0.0005341,0.0000005,
2,2,2119,2121,0.0002805,0.0000004,
2,3,2119,2122,0.0001960,0.0000004,
2,4,2119,2123,0.0001520,0.0000004,
2,5,2119,2124,0.0001465,0.0000006,
2,6,2119,2125,0.0001399,0.0000008,
2,7,2119,2126,0.0001348,0.0000010,
2,8,2119,2127,0.0001336,0.0000014,
2,9,2119,2128,0.0001377,0.0000021,
2,10,2119,2129,0.0001465,0.0000031,
2,11,2119,2130,0.0001596,0.0000047,
2,12,2119,2131,0.0001783,0.0000070,
2,13,2119,2132,0.0002061,0.0000108,
2,14,2119,2133,0.0002415,0.0000162,
2,15,2119,2134,0.0002756,0.0000211,
2,16,2119,2135,0.0003003,0.0000230,
2,17,2119,2136,0.0003175,0.0000218,
2,18,2119,2137,0.0003342,0.0000205,
2,19,2119,2138,0.0003539,0.0000206,
2,20,2119,2139,0.0003732,0.0000212,
2,21,2119,2140,0.0003859,0.0000204,
2,22,2119,2141,0.0003897,0.0000179,
2,23,2119,2142,0.0003908,0.0000154,
2,24,2119,2143,0.0003983,0.0000144,
2,25,2119,2144,0.0004147,0.0000149,
2,26,2119,2145,0.0004348,0.0000158,
2,27,2119,2146,0.0004528,0.0000160,
2,28,2119,2147,0.0004684,0.0000165,
2,29,2119,2148,0.0004856,0.0000170,
2,30,2119,2149,0.0005091,0.0000178,
2,31,2119,2150,0.0005408,0.0000187,
2,0,2120,2120,0.0077994,0.0000855,
2,1,2120,2121,0.0005341,0.0000005,
2,2,2120,2122,0.0002805,0.0000004,
2,3,2120,2123,0.0001960,0.0000004,
2,4,2120,2124,0.0001520,0.0000003,
2,5,2120,2125,0.0001465,0.0000005,
2,6,2120,2126,0.0001399,0.0000007,
2,7,2120,2127,0.0001348,0.0000010,
2,8,2120,2128,0.0001336,0.0000014,
2,9,2120,2129,0.0001377,0.0000020,
2,10,2120,2130,0.0001465,0.0000030,
2,11,2120,2131,0.0001596,0.0000045,
2,12,2120,2132,0.0001783,0.0000069,
2,13,2120,2133,0.0002061,0.0000106,
2,14,2120,2134,0.0002415,0.0000158,
2,15,2120,2135,0.0002756,0.0000207,
2,16,2120,2136,0.0003003,0.0000225,
2,17,2120,2137,0.0003175,0.0000214,
2,18,2120,2138,0.0003342,0.0000201,
2,19,2120,2139,0.0003539,0.0000202,
2,20,2120,2140,0.0003732,0.0000207,
2,21,2120,2141,0.0003859,0.0000199,
2,22,2120,2142,0.0003897,0.0000175,
2,23,2120,2143,0.0003908,0.0000150,
2,24,2120,2144,0.0003983,0.0000141,
2,25,2120,2145,0.0004147,0.0000145,
2,26,2120,2146,0.0004348,0.0000154,
2,27,2120,2147,0.0004528,0.0000156,
2,28,2120,2148,0.0004684,0.0000161,
2,29,2120,2149,0.0004856,0.0000166,
2,30,2120,2150,0.0005091,0.0000173,
2,0,2121,2121,0.0077994,0.0000817,
2,1,2121,2122,0.0005341,0.0000005,
2,2,2121,2123,0.0002805,0.0000003,
2,3,2121,2124,0.0001960,0.0000004,
2,4,2121,2125,0.0001520,0.0000003,
2,5,2121,2126,0.0001465,0.0000005,
2,6,2121,2127,0.0001399,0.0000007,
2,7,2121,2128,0.0001348,0.0000009,
2,8,2121,2129,0.0001336,0.0000013,
2,9,2121,2130,0.0001377,0.0000019,
2,10,2121,2131,0.0001465,0.0000029,
2,11,2121,2132,0.0001596,0.0000044,
2,12,2121,2133,0.0001783,0.0000067,
2,13,2121,2134,0.0002061,0.0000103,
2,14,2121,2135,0.0002415,0.0000154,
2,15,2121,2136,0.0002756,0.0000202,
2,16,2121,2137,0.0003003,0.0000220,
2,17,2121,2138,0.0003175,0.0000209,
2,18,2121,2139,0.0003342,0.0000197,
2,19,2121,2140,0.0003539,0.0000197,
2,20,2121,2141,0.0003732,0.0000202,
2,21,2121,2142,0.0003859,0.0000195,
2,22,2121,2143,0.0003897,0.0000171,
2,23,2121,2144,0.0003908,0.0000147,
2,24,2121,2145,0.0003983,0.0000137,
2,25,2121,2146,0.0004147,0.0000141,
2,26,2121,2147,0.0004348,0.0000150,
2,27,2121,2148,0.0004528,0.0000153,
2,28,2121,2149,0.0004684,0.0000157,
2,29,2121,2150,0.0004856,0.0000162,
2,0,2122,2122,0.0077994,0.0000783,
2,1,2122,2123,0.0005341,0.0000004,
2,2,2122,2124,0.0002805,0.0000003,
2,3,2122,2125,0.0001960,0.0000003,
2,4,2122,2126,0.0001520,0.0000003,
2,5,2122,2127,0.0001465,0.0000005,
2,6,2122,2128,0.0001399,0.0000007,
2,7,2122,2129,0.0001348,0.0000009,
2,8,2122,2130,0.0001336,0.0000012,
2,9,2122,2131,0.0001377,0.0000018,
2,10,2122,2132,0.0001465,0.0000028,
2,11,2122,2133,0.0001596,0.0000043,
2,12,2122,2134,0.0001783,0.0000065,
2,13,2122,2135,0.0002061,0.0000101,
2,14,2122,2136,0.0002415,0.0000151,
2,15,2122,2137,0.0002756,0.0000198,
2,16,2122,2138,0.0003003,0.0000216,
2,17,2122,2139,0.0003175,0.0000205,
2,18,2122,2140,0.0003342,0.0000192,
2,19,2122,2141,0.0003539,0.0000192,
2,20,2122,2142,0.0003732,0.0000197,
2,21,2122,2143,0.0003859,0.0000190,
2,22,2122,2144,0.0003897,0.0000167,
2,23,2122,2145,0.0003908,0.0000143,
2,24,2122,2146,0.0003983,0.0000133,
2,25,2122,2147,0.0004147,0.0000138,
2,26,2122,2148,0.0004348,0.0000146,
2,27,2122,2149,0.0004528,0.0000149,
2,28,2122,2150,0.0004684,0.0000153,
2,0,2123,2123,0.0077994,0.0000753,
2,1,2123,2124,0.0005341,0.0000004,
2,2,2123,2125,0.0002805,0.0000003,
2,3,2123,2126,0.0001960,0.0000003,
2,4,2123,2127,0.0001520,0.0000003,
2,5,2123,2128,0.0001465,0.0000005,
2,6,2123,2129,0.0001399,0.0000006,
2,7,2123,2130,0.0001348,0.0000009,
2,8,2123,2131,0.0001336,0.0000012,
2,9,2123,2132,0.0001377,0.0000018,
2,10,2123,2133,0.0001465,0.0000027,
2,11,2123,2134,0.0001596,0.0000042,
2,12,2123,2135,0.0001783,0.0000063,
2,13,2123,2136,0.0002061,0.0000098,
2,14,2123,2137,0.0002415,0.0000147,
2,15,2123,2138,0.0002756,0.0000194,
2,16,2123,2139,0.0003003,0.0000212,
2,17,2123,2140,0.0003175,0.0000200,
2,18,2123,2141,0.0003342,0.0000188,
2,19,2123,2142,0.0003539,0.0000188,
2,20,2123,2143,0.0003732,0.0000193,
2,21,2123,2144,0.0003859,0.0000186,
2,22,2123,2145,0.0003897,0.0000163,
2,23,2123,2146,0.0003908,0.0000139,
2,24,2123,2147,0.0003983,0.0000130,
2,25,2123,2148,0.0004147,0.0000134,
2,26,2123,2149,0.0004348,0.0000143,
2,27,2123,2150,0.0004528,0.0000145,
2,0,2124,2124,0.0077994,0.0000723,
2,1,2124,2125,0.0005341,0.0000004,
2,2,2124,2126,0.0002805,0.0000003,
2,3,2124,2127,0.0001960,0.0000003,
2,4,2124,2128,0.0001520,0.0000003,
2,5,2124,2129,0.0001465,0.0000004,
2,6,2124,2130,0.0001399,0.0000006,
2,7,2124,2131,0.0001348,0.0000008,
2,8,2124,2132,0.0001336,0.0000011,
2,9,2124,2133,0.0001377,0.0000017,
2,10,2124,2134,0.0001465,0.0000026,
2,11,2124,2135,0.0001596,0.0000040,
2,12,2124,2136,0.0001783,0.0000061,
2,13,2124,2137,0.0002061,0.0000096,
2,14,2124,2138,0.0002415,0.0000144,
2,15,2124,2139,0.0002756,0.0000190,
2,16,2124,2140,0.0003003,0.0000207,
2,17,2124,2141,0.0003175,0.0000196,
2,18,2124,2142,0.0003342,0.0000183,
2,19,2124,2143,0.0003539,0.0000184,
2,20,2124,2144,0.0003732,0.0000189,
2,21,2124,2145,0.0003859,0.0000182,
2,22,2124,2146,0.0003897,0.0000159,
2,23,2124,2147,0.0003908,0.0000136,
2,24,2124,2148,0.0003983,0.0000127,
2,25,2124,2149,0.0004147,0.0000131,
2,26,2124,2150,0.0004348,0.0000139,
2,0,2125,2125,0.0077994,0.0000691,
2,1,2125,2126,0.0005341,0.0000004,
2,2,2125,2127,0.0002805,0.0000003,
2,3,2125,2128,0.0001960,0.0000003,
2,4,2125,2129,0.0001520,0.0000003,
2,5,2125,2130,0.0001465,0.0000004,
2,6,2125,2131,0.0001399,0.0000006,
2,7,2125,2132,0.0001348,0.0000008,
2,8,2125,2133,0.0001336,0.0000011,
2,9,2125,2134,0.0001377,0.0000017,
2,10,2125,2135,0.0001465,0.0000025,
2,11,2125,2136,0.0001596,0.0000039,
2,12,2125,2137,0.0001783,0.0000060,
2,13,2125,2138,0.0002061,0.0000093,
2,14,2125,2139,0.0002415,0.0000141,
2,15,2125,2140,0.0002756,0.0000186,
2,16,2125,2141,0.0003003,0.0000203,
2,17,2125,2142,0.0003175,0.0000192,
2,18,2125,2143,0.0003342,0.0000180,
2,19,2125,2144,0.0003539,0.0000180,
2,20,2125,2145,0.0003732,0.0000185,
2,21,2125,2146,0.0003859,0.0000178,
2,22,2125,2147,0.0003897,0.0000155,
2,23,2125,2148,0.0003908,0.0000133,
2,24,2125,2149,0.0003983,0.0000124,
2,25,2125,2150,0.0004147,0.0000128,
2,0,2126,2126,0.0077994,0.0000661,
2,1,2126,2127,0.0005341,0.0000003,
2,2,2126,2128,0.0002805,0.0000003,
2,3,2126,2129,0.0001960,0.0000003,
2,4,2126,2130,0.0001520,0.0000002,
2,5,2126,2131,0.0001465,0.0000004,
2,6,2126,2132,0.0001399,0.0000005,
2,7,2126,2133,0.0001348,0.0000007,
2,8,2126,2134,0.0001336,0.0000011,
2,9,2126,2135,0.0001377,0.0000016,
2,10,2126,2136,0.0001465,0.0000024,
2,11,2126,2137,0.0001596,0.0000038,
2,12,2126,2138,0.0001783,0.0000058,
2,13,2126,2139,0.0002061,0.0000091,
2,14,2126,2140,0.0002415,0.0000138,
2,15,2126,2141,0.0002756,0.0000182,
2,16,2126,2142,0.0003003,0.0000198,
2,17,2126,2143,0.0003175,0.0000188,
2,18,2126,2144,0.0003342,0.0000176,
2,19,2126,2145,0.0003539,0.0000176,
2,20,2126,2146,0.0003732,0.0000180,
2,21,2126,2147,0.0003859,0.0000173,
2,22,2126,2148,0.0003897,0.0000152,
2,23,2126,2149,0.0003908,0.0000130,
2,24,2126,2150,0.0003983,0.0000121,
2,0,2127,2127,0.0077994,0.0000633,
2,1,2127,2128,0.0005341,0.0000003,
2,2,2127,2129,0.0002805,0.0000002,
2,3,2127,2130,0.0001960,0.0000003,
2,4,2127,2131,0.0001520,0.0000002,
2,5,2127,2132,0.0001465,0.0000004,
2,6,2127,2133,0.0001399,0.0000005,
2,7,2127,2134,0.0001348,0.0000007,
2,8,2127,2135,0.0001336,0.0000010,
2,9,2127,2136,0.0001377,0.0000015,
2,10,2127,2137,0.0001465,0.0000024,
2,11,2127,2138,0.0001596,0.0000037,
2,12,2127,2139,0.0001783,0.0000057,
2,13,2127,2140,0.0002061,0.0000089,
2,14,2127,2141,0.0002415,0.0000135,
2,15,2127,2142,0.0002756,0.0000178,
2,16,2127,2143,0.0003003,0.0000194,
2,17,2127,2144,0.0003175,0.0000184,
2,18,2127,2145,0.0003342,0.0000172,
2,19,2127,2146,0.0003539,0.0000172,
2,20,2127,2147,0.0003732,0.0000176,
2,21,2127,2148,0.0003859,0.0000170,
2,22,2127,2149,0.0003897,0.0000149,
2,23,2127,2150,0.0003908,0.0000126,
2,0,2128,2128,0.0077994,0.0000608,
2,1,2128,2129,0.0005341,0.0000003,
2,2,2128,2130,0.0002805,0.0000002,
2,3,2128,2131,0.0001960,0.0000002,
2,4,2128,2132,0.0001520,0.0000002,
2,5,2128,2133,0.0001465,0.0000004,
2,6,2128,2134,0.0001399,0.0000005,
2,7,2128,2135,0.0001348,0.0000007,
2,8,2128,2136,0.0001336,0.0000010,
2,9,2128,2137,0.0001377,0.0000015,
2,10,2128,2138,0.0001465,0.0000023,
2,11,2128,2139,0.0001596,0.0000036,
2,12,2128,2140,0.0001783,0.0000055,
2,13,2128,2141,0.0002061,0.0000087,
2,14,2128,2142,0.0002415,0.0000132,
2,15,2128,2143,0.0002756,0.0000174,
2,16,2128,2144,0.0003003,0.0000191,
2,17,2128,2145,0.0003175,0.0000180,
2,18,2128,2146,0.0003342,0.0000168,
2,19,2128,2147,0.0003539,0.0000168,
2,20,2128,2148,0.0003732,0.0000173,
2,21,2128,2149,0.0003859,0.0000166,
2,22,2128,2150,0.0003897,0.0000145,
2,0,2129,2129,0.0077994,0.0000584,
2,1,2129,2130,0.0005341,0.0000003,
2,2,2129,2131,0.0002805,0.0000002,
2,3,2129,2132,0.0001960,0.0000002,
2,4,2129,2133,0.0001520,0.0000002,
2,5,2129,2134,0.0001465,0.0000003,
2,6,2129,2135,0.0001399,0.0000005,
2,7,2129,2136,0.0001348,0.0000007,
2,8,2129,2137,0.0001336,0.0000009,
2,9,2129,2138,0.0001377,0.0000014,
2,10,2129,2139,0.0001465,0.0000022,
2,11,2129,2140,0.0001596,0.0000035,
2,12,2129,2141,0.0001783,0.0000054,
2,13,2129,2142,0.0002061,0.0000084,
2,14,2129,2143,0.0002415,0.0000129,
2,15,2129,2144,0.0002756,0.0000171,
2,16,2129,2145,0.0003003,0.0000186,
2,17,2129,2146,0.0003175,0.0000176,
2,18,2129,2147,0.0003342,0.0000164,
2,19,2129,2148,0.0003539,0.0000164,
2,20,2129,2149,0.0003732,0.0000169,
2,21,2129,2150,0.0003859,0.0000162,
2,0,2130,2130,0.0077994,0.0000559,
2,1,2130,2131,0.0005341,0.0000003,
2,2,2130,2132,0.0002805,0.0000002,
2,3,2130,2133,0.0001960,0.0000002,
2,4,2130,2134,0.0001520,0.0000002,
2,5,2130,2135,0.0001465,0.0000003,
2,6,2130,2136,0.0001399,0.0000005,
2,7,2130,2137,0.0001348,0.0000006,
2,8,2130,2138,0.0001336,0.0000009,
2,9,2130,2139,0.0001377,0.0000014,
2,10,2130,2140,0.0001465,0.0000021,
2,11,2130,2141,0.0001596,0.0000034,
2,12,2130,2142,0.0001783,0.0000052,
2,13,2130,2143,0.0002061,0.0000083,
2,14,2130,2144,0.0002415,0.0000126,
2,15,2130,2145,0.0002756,0.0000167,
2,16,2130,2146,0.0003003,0.0000182,
2,17,2130,2147,0.0003175,0.0000172,
2,18,2130,2148,0.0003342,0.0000161,
2,19,2130,2149,0.0003539,0.0000161,
2,20,2130,2150,0.0003732,0.0000165,
2,0,2131,2131,0.0077994,0.0000534,
2,1,2131,2132,0.0005341,0.0000002,
2,2,2131,2133,0.0002805,0.0000002,
2,3,2131,2134,0.0001960,0.0000002,
2,4,2131,2135,0.0001520,0.0000002,
2,5,2131,2136,0.0001465,0.0000003,
2,6,2131,2137,0.0001399,0.0000004,
2,7,2131,2138,0.0001348,0.0000006,
2,8,2131,2139,0.0001336,0.0000009,
2,9,2131,2140,0.0001377,0.0000013,
2,10,2131,2141,0.0001465,0.0000021,
2,11,2131,2142,0.0001596,0.0000033,
2,12,2131,2143,0.0001783,0.0000051,
2,13,2131,2144,0.0002061,0.0000081,
2,14,2131,2145,0.0002415,0.0000123,
2,15,2131,2146,0.0002756,0.0000163,
2,16,2131,2147,0.0003003,0.0000179,
2,17,2131,2148,0.0003175,0.0000168,
2,18,2131,2149,0.0003342,0.0000157,
2,19,2131,2150,0.0003539,0.0000157,
2,0,2132,2132,0.0077994,0.0000512,
2,1,2132,2133,0.0005341,0.0000002,
2,2,2132,2134,0.0002805,0.0000002,
2,3,2132,2135,0.0001960,0.0000002,
2,4,2132,2136,0.0001520,0.0000002,
2,5,2132,2137,0.0001465,0.0000003,
2,6,2132,2138,0.0001399,0.0000004,
2,7,2132,2139,0.0001348,0.0000006,
2,8,2132,2140,0.0001336,0.0000008,
2,9,2132,2141,0.0001377,0.0000013,
2,10,2132,2142,0.0001465,0.0000020,
2,11,2132,2143,0.0001596,0.0000032,
2,12,2132,2144,0.0001783,0.0000049,
2,13,2132,2145,0.0002061,0.0000079,
2,14,2132,2146,0.0002415,0.0000120,
2,15,2132,2147,0.0002756,0.0000160,
2,16,2132,2148,0.0003003,0.0000175,
2,17,2132,2149,0.0003175,0.0000165,
2,18,2132,2150,0.0003342,0.0000153,
2,0,2133,2133,0.0077994,0.0000492,
2,1,2133,2134,0.0005341,0.0000002,
2,2,2133,2135,0.0002805,0.0000002,
2,3,2133,2136,0.0001960,0.0000002,
2,4,2133,2137,0.0001520,0.0000002,
2,5,2133,2138,0.0001465,0.0000003,
2,6,2133,2139,0.0001399,0.0000004,
2,7,2133,2140,0.0001348,0.0000006,
2,8,2133,2141,0.0001336,0.0000008,
2,9,2133,2142,0.0001377,0.0000012,
2,10,2133,2143,0.0001465,0.0000019,
2,11,2133,2144,0.0001596,0.0000031,
2,12,2133,2145,0.0001783,0.0000048,
2,13,2133,2146,0.0002061,0.0000077,
2,14,2133,2147,0.0002415,0.0000118,
2,15,2133,2148,0.0002756,0.0000157,
2,16,2133,2149,0.0003003,0.0000172,
2,17,2133,2150,0.0003175,0.0000161,
2,0,2134,2134,0.0077994,0.0000473,
2,1,2134,2135,0.0005341,0.0000002,
2,2,2134,2136,0.0002805,0.0000002,
2,3,2134,2137,0.0001960,0.0000002,
2,4,2134,2138,0.0001520,0.0000002,
2,5,2134,2139,0.0001465,0.0000003,
2,6,2134,2140,0.0001399,0.0000004,
2,7,2134,2141,0.0001348,0.0000005,
2,8,2134,2142,0.0001336,0.0000008,
2,9,2134,2143,0.0001377,0.0000012,
2,10,2134,2144,0.0001465,0.0000019,
2,11,2134,2145,0.0001596,0.0000030,
2,12,2134,2146,0.0001783,0.0000047,
2,13,2134,2147,0.0002061,0.0000075,
2,14,2134,2148,0.0002415,0.0000115,
2,15,2134,2149,0.0002756,0.0000154,
2,16,2134,2150,0.0003003,0.0000168,
2,0,2135,2135,0.0077994,0.0000452,
2,1,2135,2136,0.0005341,0.0000002,
2,2,2135,2137,0.0002805,0.0000001,
2,3,2135,2138,0.0001960,0.0000002,
2,4,2135,2139,0.0001520,0.0000002,
2,5,2135,2140,0.0001465,0.0000002,
2,6,2135,2141,0.0001399,0.0000004,
2,7,2135,2142,0.0001348,0.0000005,
2,8,2135,2143,0.0001336,0.0000007,
2,9,2135,2144,0.0001377,0.0000011,
2,10,2135,2145,0.0001465,0.0000018,
2,11,2135,2146,0.0001596,0.0000029,
2,12,2135,2147,0.0001783,0.0000045,
2,13,2135,2148,0.0002061,0.0000073,
2,14,2135,2149,0.0002415,0.0000113,
2,15,2135,2150,0.0002756,0.0000150,
2,0,2136,2136,0.0077994,0.0000432,
2,1,2136,2137,0.0005341,0.0000002,
2,2,2136,2138,0.0002805,0.0000001,
2,3,2136,2139,0.0001960,0.0000002,
2,4,2136,2140,0.0001520,0.0000001,
2,5,2136,2141,0.0001465,0.0000002,
2,6,2136,2142,0.0001399,0.0000003,
2,7,2136,2143,0.0001348,0.0000005,
2,8,2136,2144,0.0001336,0.0000007,
2,9,2136,2145,0.0001377,0.0000011,
2,10,2136,2146,0.0001465,0.0000018,
2,11,2136,2147,0.0001596,0.0000028,
2,12,2136,2148,0.0001783,0.0000044,
2,13,2136,2149,0.0002061,0.0000071,
2,14,2136,2150,0.0002415,0.0000110,
2,0,2137,2137,0.0077994,0.0000414,
2,1,2137,2138,0.0005341,0.0000002,
2,2,2137,2139,0.0002805,0.0000001,
2,3,2137,2140,0.0001960,0.0000001,
2,4,2137,2141,0.0001520,0.0000001,
2,5,2137,2142,0.0001465,0.0000002,
2,6,2137,2143,0.0001399,0.0000003,
2,7,2137,2144,0.0001348,0.0000005,
2,8,2137,2145,0.0001336,0.0000007,
2,9,2137,2146,0.0001377,0.0000011,
2,10,2137,2147,0.0001465,0.0000017,
2,11,2137,2148,0.0001596,0.0000027,
2,12,2137,2149,0.0001783,0.0000043,
2,13,2137,2150,0.0002061,0.0000069,
2,0,2138,2138,0.0077994,0.0000398,
2,1,2138,2139,0.0005341,0.0000002,
2,2,2138,2140,0.0002805,0.0000001,
2,3,2138,2141,0.0001960,0.0000001,
2,4,2138,2142,0.0001520,0.0000001,
2,5,2138,2143,0.0001465,0.0000002,
2,6,2138,2144,0.0001399,0.0000003,
2,7,2138,2145,0.0001348,0.0000004,
2,8,2138,2146,0.0001336,0.0000007,
2,9,2138,2147,0.0001377,0.0000010,
2,10,2138,2148,0.0001465,0.0000016,
2,11,2138,2149,0.0001596,0.0000026,
2,12,2138,2150,0.0001783,0.0000042,
2,0,2139,2139,0.0077994,0.0000383,
2,1,2139,2140,0.0005341,0.0000001,
2,2,2139,2141,0.0002805,0.0000001,
2,3,2139,2142,0.0001960,0.0000001,
2,4,2139,2143,0.0001520,0.0000001,
2,5,2139,2144,0.0001465,0.0000002,
2,6,2139,2145,0.0001399,0.0000003,
2,7,2139,2146,0.0001348,0.0000004,
2,8,2139,2147,0.0001336,0.0000006,
2,9,2139,2148,0.0001377,0.0000010,
2,10,2139,2149,0.0001465,0.0000016,
2,11,2139,2150,0.0001596,0.0000026,
2,0,2140,2140,0.0077994,0.0000366,
2,1,2140,2141,0.0005341,0.0000001,
2,2,2140,2142,0.0002805,0.0000001,
2,3,2140,2143,0.0001960,0.0000001,
2,4,2140,2144,0.0001520,0.0000001,
2,5,2140,2145,0.0001465,0.0000002,
2,6,2140,2146,0.0001399,0.0000003,
2,7,2140,2147,0.0001348,0.0000004,
2,8,2140,2148,0.0001336,0.0000006,
2,9,2140,2149,0.0001377,0.0000010,
2,10,2140,2150,0.0001465,0.0000015,
2,0,2141,2141,0.0077994,0.0000350,
2,1,2141,2142,0.0005341,0.0000001,
2,2,2141,2143,0.0002805,0.0000001,
2,3,2141,2144,0.0001960,0.0000001,
2,4,2141,2145,0.0001520,0.0000001,
2,5,2141,2146,0.0001465,0.0000002,
2,6,2141,2147,0.0001399,0.0000003,
2,7,2141,2148,0.0001348,0.0000004,
2,8,2141,2149,0.0001336,0.0000006,
2,9,2141,2150,0.0001377,0.0000009,
2,0,2142,2142,0.0077994,0.0000335,
2,1,2142,2143,0.0005341,0.0000001,
2,2,2142,2144,0.0002805,0.0000001,
2,3,2142,2145,0.0001960,0.0000001,
2,4,2142,2146,0.0001520,0.0000001,
2,5,2142,2147,0.0001465,0.0000002,
2,6,2142,2148,0.0001399,0.0000003,
2,7,2142,2149,0.0001348,0.0000004,
2,8,2142,2150,0.0001336,0.0000006,
2,0,2143,2143,0.0077994,0.0000322,
2,1,2143,2144,0.0005341,0.0000001,
2,2,2143,2145,0.0002805,0.0000001,
2,3,2143,2146,0.0001960,0.0000001,
2,4,2143,2147,0.0001520,0.0000001,
2,5,2143,2148,0.0001465,0.0000002,
2,6,2143,2149,0.0001399,0.0000002,
2,7,2143,2150,0.0001348,0.0000004,
2,0,2144,2144,0.0077994,0.0000310,
2,1,2144,2145,0.0005341,0.0000001,
2,2,2144,2146,0.0002805,0.0000001,
2,3,2144,2147,0.0001960,0.0000001,
2,4,2144,2148,0.0001520,0.0000001,
2,5,2144,2149,0.0001465,0.0000002,
2,6,2144,2150,0.0001399,0.0000002,
2,0,2145,2145,0.0077994,0.0000296,
2,1,2145,2146,0.0005341,0.0000001,
2,2,2145,2147,0.0002805,0.0000001,
2,3,2145,2148,0.0001960,0.0000001,
2,4,2145,2149,0.0001520,0.0000001,
2,5,2145,2150,0.0001465,0.0000002,
2,0,2146,2146,0.0077994,0.0000283,
2,1,2146,2147,0.0005341,0.0000001,
2,2,2146,2148,0.0002805,0.0000001,
2,3,2146,2149,0.0001960,0.0000001,
2,4,2146,2150,0.0001520,0.0000001,
2,0,2147,2147,0.0077994,0.0000272,
2,1,2147,2148,0.0005341,0.0000001,
2,2,2147,2149,0.0002805,0.0000001,
2,3,2147,2150,0.0001960,0.0000001,
2,0,2148,2148,0.0077994,0.0000261,
2,1,2148,2149,0.0005341,0.0000001,
2,2,2148,2150,0.0002805,0.0000001,
2,0,2149,2149,0.0077994,0.0000251,
2,1,2149,2150,0.0005341,0.0000001,
2,0,2150,2150,0.0077994,0.0000240,